job_id,tasks_num_of_single_job,task_generation_time,total_time,complation_time,complation_time_ordered,shortened_completion_time
0,88,389,41300,1391,1393,-2
1,85,939,40250,2942,1992,950
2,87,1396,39900,3438,2993,445
3,88,1423,41750,3492,3442,50
4,84,2524,39300,4526,4444,82
5,87,2572,39900,5443,5524,-81
6,82,2635,36950,5046,5944,-898
7,80,2851,37750,5944,6394,-450
8,80,3415,36850,6578,6027,551
9,80,4744,37750,8127,7949,178
10,85,4944,38900,7942,10442,-2500
11,86,5236,38500,8542,10992,-2450
12,90,5354,42300,9082,8444,638
13,85,5682,38450,9543,10527,-984
14,84,6379,37050,10501,10028,473
15,81,6600,36900,11001,10528,473
16,87,7069,39450,11054,12232,-1178
17,90,7373,40500,11582,13005,-1423
18,90,8168,43650,12529,12496,33
19,87,9410,39450,12680,12998,-318
20,83,10437,37000,13594,13448,146
21,87,11018,39900,14082,14445,-363
22,89,11283,41800,14582,15445,-863
23,86,12335,38950,15582,15948,-366
24,81,12776,36900,16692,16101,591
25,89,12917,38650,17100,16629,471
26,85,13011,40700,16785,16549,236
27,84,15208,37950,18099,17638,461
28,82,16170,36500,18134,18500,-366
29,85,16873,38900,18684,18681,3
30,83,17399,37000,19342,18901,441
31,88,18137,39500,19455,19375,80
32,81,18915,37350,19958,20141,-183
33,90,19872,40500,21928,20919,1009
34,80,19942,37750,22977,22947,30
35,90,19976,41850,22925,24878,-1953
36,86,20110,39850,23873,24947,-1074
37,80,20113,36850,23424,23521,-97
38,82,20734,37400,25377,24469,908
39,90,20861,41400,25929,25926,3
40,83,22780,37450,26377,26427,-50
41,84,22985,37500,26877,27875,-998
42,80,23179,36400,27996,28375,-379
43,84,23416,36600,28496,28019,477
44,88,23449,40850,29477,29519,-42
45,89,23880,41350,30477,29522,955
46,83,24375,37450,31531,31069,462
47,84,24782,36600,32131,31421,710
48,88,24987,39500,30112,31431,-1319
49,86,25065,39400,30079,31929,-1850
50,81,25537,38250,32030,31571,459
51,82,25665,34700,32546,33621,-1075
52,87,26304,41700,33546,35121,-1575
53,88,26747,39500,34547,37076,-2529
54,80,27398,37750,36079,40171,-4092
55,84,27876,38400,37079,42576,-5497
56,83,27890,38800,37547,44523,-6976
57,80,27900,36400,36076,45674,-9598
58,87,28096,39900,37026,46493,-9467
59,87,28288,40800,38098,46671,-8573
60,82,28391,36950,38581,47171,-8590
61,80,28410,36400,38679,47576,-8897
62,90,28504,41400,38729,39450,-721
63,89,28644,39100,39972,41950,-1978
64,90,28760,41400,40577,44684,-4107
65,81,29089,36000,40646,46950,-6304
66,89,30347,39100,43146,47950,-4804
67,90,30654,40950,49633,50186,-553
68,82,30660,36950,49696,50500,-804
69,80,30685,35500,49697,47733,1964
70,83,31216,38350,51400,48755,2645
71,87,31314,40800,51633,50305,1328
72,83,31687,38800,51696,52305,-609
73,80,31743,35050,48537,52750,-4213
74,83,32446,37450,51196,46118,5078
75,81,32698,38700,53196,47976,5220
76,85,33408,37550,47135,50976,-3841
77,86,33477,38950,47635,52134,-4499
78,87,33730,38550,47830,54476,-6646
79,90,34614,41400,49191,56184,-6993
80,85,34729,38900,49226,49029,197
81,81,34836,37800,47682,48743,-1061
82,81,35255,37800,48479,49793,-1314
83,81,35397,35550,49080,50771,-1691
84,85,36243,38450,49138,51278,-2140
85,82,39706,39200,50231,52278,-2047
86,84,40159,36600,51231,52293,-1062
87,85,43055,40250,51688,52675,-987
88,85,43311,39800,51583,53824,-2241
89,82,43478,36950,53133,54363,-1230
90,82,45925,38300,53529,56080,-2551
91,83,46328,36550,54183,56232,-2049
92,81,47191,36900,55183,55529,-346
93,89,47968,41800,56902,56486,416
94,83,48037,36550,57183,58986,-1803
95,85,48499,37550,57683,59387,-1704
96,84,48906,37950,59739,56543,3196
97,85,48933,35300,58180,57130,1050
98,85,48990,39800,59296,57725,1571
99,85,49022,39350,60296,59284,1012
100,85,51823,39800,59630,60183,-553
101,90,52616,39600,61680,62066,-386
102,87,53088,40350,63134,62630,504
103,82,53155,36950,63931,61684,2247
104,85,53336,38000,64433,62684,1749
105,85,53786,36650,62002,64684,-2682
106,84,54271,39750,62346,65028,-2682
107,83,54721,39700,62296,63378,-1082
108,90,55606,40950,63551,63943,-392
109,86,55783,38500,63846,64133,-287
110,86,56862,38950,64291,65380,-1089
111,82,56896,36050,63485,66380,-2895
112,87,57544,40800,64787,65616,-829
113,86,57765,38050,65885,65737,148
114,88,60450,38150,66385,67182,-797
115,88,61258,41750,66983,67768,-785
116,86,63430,39400,67552,69237,-1685
117,82,63688,37850,68552,67930,622
118,83,64037,37450,69290,68577,713
119,87,64669,39000,69404,69077,327
120,90,66204,42300,69790,69625,165
121,80,66873,35050,70404,69930,474
122,81,68034,37800,70840,70533,307
123,90,69195,40950,71406,71533,-127
124,85,69869,39350,72698,71439,1259
125,90,70050,39150,73748,76374,-2626
126,81,70141,38250,73456,73132,324
127,86,70447,39400,74900,76533,-1633
128,87,70522,40800,75900,78147,-2247
129,86,70606,40300,75423,76247,-824
130,88,71037,37700,75703,75786,-83
131,85,71072,40250,75591,76737,-1146
132,87,71505,38550,76423,77873,-1450
133,89,71983,37750,77875,77876,-1
134,82,72261,36050,78675,77875,800
135,89,72632,41350,78254,79975,-1721
136,88,73573,39950,80374,82124,-1750
137,82,73851,37400,80874,84624,-3750
138,89,74659,39100,79693,85426,-5733
139,83,75078,38350,81350,79848,1502
140,82,75337,37850,82350,81423,927
141,81,76150,37350,82948,82923,25
142,88,76466,40400,86072,82926,3146
143,84,77174,38850,83023,83576,-553
144,88,77322,40850,83620,83579,41
145,89,77485,39100,84077,84579,-502
146,86,77534,39400,84526,85579,-1053
147,85,78548,40250,87024,87861,-837
148,80,79196,35950,85477,87489,-2012
149,87,79635,38100,86031,85577,454
150,84,79789,36150,87076,86475,601
151,89,80515,38650,87829,87629,200
152,89,81138,40450,88627,89631,-1004
153,90,81346,40950,89308,88884,424
154,85,82332,38450,91122,89776,1346
155,81,83704,36900,92308,89474,2834
156,85,84438,38000,93808,92139,1669
157,81,84569,33750,91679,95189,-3510
158,85,85025,38900,91477,97242,-5765
159,81,85363,35100,92233,97739,-5506
160,87,86300,39450,92733,94777,-2044
161,88,86506,39950,94177,91482,2695
162,88,86647,40850,94580,93276,1304
163,80,87839,36400,93726,95238,-1512
164,84,88310,37950,94711,94041,670
165,88,89172,40400,96211,95484,727
166,88,89691,41300,95628,96532,-904
167,85,90025,37100,96253,97837,-1584
168,85,90084,38450,97803,99032,-1229
169,87,90130,40800,98071,96974,1097
170,82,90668,36500,98125,98354,-229
171,89,90753,39100,98934,99326,-392
172,85,90786,38450,99908,100086,-178
173,81,91025,35550,100779,101086,-307
174,82,92353,37850,101332,101337,-5
175,84,93001,36600,102859,102745,114
176,84,93015,37050,102878,104339,-1461
177,85,93275,39800,106579,105295,1284
178,83,94025,35200,102054,103516,-1462
179,85,94365,38450,102571,105105,-2534
180,86,95867,38050,103277,105454,-2177
181,90,96564,42750,104282,105609,-1327
182,86,96761,36700,103736,105582,-1846
183,83,97338,39250,104130,106586,-2456
184,84,97561,35700,105079,104571,508
185,83,98538,37450,105859,106841,-982
186,84,99155,37950,107781,108391,-610
187,81,100163,36900,106814,110891,-4077
188,88,100565,36800,106632,112995,-6363
189,90,101267,40500,108832,115091,-6259
190,87,102330,39450,110234,117995,-7761
191,85,102743,40700,108827,109477,-650
192,87,102943,39450,109282,111878,-2596
193,84,104436,38400,111930,113878,-1948
194,84,104525,38850,111877,110477,1400
195,86,104669,38050,112655,111159,1496
196,81,105025,37800,112932,111084,1848
197,86,105099,38500,113281,112078,1203
198,81,105819,37350,111742,112636,-894
199,82,106416,38300,112378,113837,-1459
200,80,106819,34600,113782,115184,-1402
201,85,107499,40700,114534,115684,-1150
202,80,108982,36850,114283,115121,-838
203,89,109101,41800,115564,117128,-1564
204,85,109122,37550,116875,118017,-1142
205,90,109601,43200,117877,119017,-1140
206,85,110318,39800,119377,121446,-2069
207,90,110416,41850,119937,123946,-4009
208,81,110530,34650,117671,126091,-8420
209,85,110802,39350,118699,121443,-2744
210,80,111143,37300,120481,121939,-1458
211,86,112092,39850,119932,122734,-2802
212,86,112272,36250,120036,124178,-4142
213,88,112720,40400,120437,119094,1343
214,87,113173,39900,122482,122045,437
215,80,113195,35050,122927,123644,-717
216,90,113472,39600,124257,126694,-2437
217,85,113928,37550,125257,130145,-4888
218,82,114660,38750,126027,133645,-7618
219,87,115066,38550,126937,136195,-9258
220,88,115453,41300,127937,136695,-8758
221,82,115588,37400,128027,129660,-1633
222,86,116104,38500,124980,124648,332
223,89,116211,40000,126719,125439,1280
224,86,116246,37600,128062,128586,-524
225,90,116405,37350,129883,129137,746
226,82,116970,38300,129031,128493,538
227,80,117062,34600,129531,129434,97
228,82,118152,34700,129506,130738,-1232
229,86,119472,40300,131901,130934,967
230,80,119935,36400,133223,128324,4899
231,80,120177,36850,133971,129921,4050
232,88,121997,39500,134851,131238,3613
233,87,122233,41250,134006,132228,1778
234,82,122442,37850,136821,133728,3093
235,82,122460,35150,136506,134288,2218
236,86,123969,39850,136487,135288,1199
237,86,124319,38950,136179,136288,-109
238,90,125081,41400,133031,136978,-3947
239,88,125758,40400,136588,137543,-955
240,83,126863,37000,145884,138034,7850
241,84,126958,38850,138588,136421,2167
242,82,127515,38300,136681,138847,-2166
243,90,127607,41400,136957,140397,-3440
244,85,128894,39350,137731,142897,-5166
245,80,129815,35050,138231,144195,-5964
246,82,130074,37850,139231,148047,-8816
247,87,130404,38100,140681,150195,-9514
248,81,131273,36000,141731,152245,-10514
249,80,132299,38200,144057,155697,-11640
250,85,132321,38900,144181,158747,-14566
251,84,133087,35700,144731,161297,-16566
252,82,133456,37400,145181,141090,4091
253,86,133831,38950,143273,142090,1183
254,90,134021,41400,143873,143007,866
255,89,134851,39100,147283,143653,3630
256,87,134927,40350,147688,143939,3749
257,83,135184,37900,148283,144345,3938
258,85,135484,37550,150383,144829,5554
259,87,135658,41250,153238,145584,7654
260,90,136098,41400,155207,147052,8155
261,82,136204,36950,155331,149202,6129
262,85,136376,37550,149401,150651,-1250
263,80,136425,35050,149793,151499,-1706
264,87,136569,39450,149002,152095,-3093
265,84,136991,37050,149923,148960,963
266,81,137115,36000,151101,151010,91
267,80,137542,37750,152502,152665,-163
268,87,138222,40350,153014,153584,-570
269,80,138256,35050,152923,153981,-1058
270,89,139055,39550,153105,156010,-2905
271,84,139685,39300,153054,156510,-3456
272,88,139961,39050,153981,149398,4583
273,90,140107,40950,155101,151471,3630
274,85,140423,39350,155660,153634,2026
275,87,140854,40800,156601,156897,-296
276,90,140952,43650,157101,158897,-1796
277,87,141031,38550,158332,161947,-3615
278,85,144181,39800,160832,164294,-3462
279,90,144605,43200,163573,167844,-4271
280,90,144754,40500,160735,169944,-9209
281,87,145215,40800,160453,170497,-10044
282,80,145980,34150,161453,161430,23
283,81,146019,37350,162553,162595,-42
284,81,146174,37350,163553,163430,123
285,82,146700,37400,164000,164341,-341
286,90,146832,42300,163438,165595,-2157
287,81,147096,35100,167086,166784,302
288,83,147202,37900,168136,167645,491
289,87,147477,39450,170088,163252,6836
290,80,147577,36850,163999,164547,-548
291,83,148745,36550,164762,167852,-3090
292,81,149101,36900,165762,168852,-3090
293,88,149367,39500,166812,166115,697
294,84,149532,37950,167999,168341,-342
295,87,149857,38550,168549,169530,-981
296,87,150368,39450,166593,170341,-3748
297,86,150549,38500,167431,172245,-4814
298,80,150690,35950,168431,172792,-4361
299,82,151083,36500,169284,173292,-4008
300,80,151305,37300,170693,172848,-2155
301,81,154320,35550,171835,173848,-2013
302,82,155457,36050,172931,177348,-4417
303,90,156389,42750,176334,181348,-5014
304,85,156477,37550,175335,182348,-7013
305,81,156487,38700,176407,173847,2560
306,89,156589,39100,176834,175747,1087
307,88,156954,40850,173173,176549,-3376
308,81,157567,36000,176414,177347,-933
309,83,157586,37000,176551,177384,-833
310,83,157603,36100,176199,176943,-744
311,80,158250,36850,178088,178388,-300
312,84,158391,38850,179588,180938,-1350
313,80,158591,35950,182389,183488,-1099
314,83,158626,37900,185439,185548,-109
315,80,159771,36850,188088,181334,6754
316,80,159985,38650,190588,182292,8296
317,85,160269,36650,192607,182845,9762
318,83,160478,38800,193984,183443,10541
319,90,161635,40050,194637,184345,10292
320,81,161892,36900,195138,185280,9858
321,86,161971,39400,195659,185950,9709
322,88,162069,39050,196138,187502,8636
323,83,162136,37900,181731,188445,-6714
324,85,162216,38900,183914,189330,-5416
325,87,162230,39900,183731,189880,-6149
326,84,162597,37050,186414,190993,-4579
327,89,162686,40000,186260,191880,-5620
328,83,163672,39250,188464,192880,-4416
329,87,163702,38550,188231,188046,185
330,87,164910,40350,189231,190046,-815
331,90,165271,39600,190014,192747,-2733
332,90,166042,39600,190652,184332,6320
333,89,166946,40900,191514,186801,4713
334,80,168117,37300,192651,189848,2803
335,81,168746,38250,194360,192348,2012
336,85,168795,39350,194564,195301,-737
337,86,169217,39400,195614,198348,-2734
338,83,169265,37900,196152,200851,-4699
339,84,169856,36150,196164,204401,-8237
340,81,169877,37350,192485,206498,-14013
341,86,170144,41200,193640,208401,-14761
342,87,170857,38100,194098,209098,-15000
343,90,170857,42300,194457,211951,-17494
344,86,170885,37150,194327,214198,-19871
345,88,171354,40850,195729,216198,-20469
346,82,171538,37400,196457,218248,-21791
347,83,172584,37000,196652,219051,-22399
348,87,172937,41250,197652,193707,3945
349,84,173668,40650,198233,195490,2743
350,84,173708,36600,198495,197429,1066
351,83,175293,37000,199495,199648,-153
352,86,175729,39400,201161,202014,-853
353,84,175780,38850,202084,204540,-2456
354,89,176032,40450,203054,207540,-4486
355,83,176242,39700,204403,211298,-6895
356,84,176413,37500,205305,213798,-8493
357,85,176580,39350,206305,215298,-8993
358,83,176758,36550,206804,217398,-10594
359,83,179206,38350,207305,220398,-13093
360,86,180433,40750,208285,221140,-12855
361,81,181943,36900,213328,205457,7871
362,88,182025,39950,213828,206354,7474
363,85,182561,37550,215835,206854,8981
364,81,182683,33750,217378,207354,10024
365,83,182696,38350,219378,208752,10626
366,83,182854,38350,222564,211302,11262
367,80,183279,34150,224464,211802,12662
368,81,183321,35100,224637,207630,17007
369,90,183485,40500,225637,209195,16442
370,89,183518,40900,226214,210134,16080
371,88,183684,42650,227214,211630,15584
372,83,184844,39700,227637,212130,15507
373,82,185194,35600,226528,209428,17100
374,89,185709,40900,228216,210369,17847
375,86,185926,39850,229253,210538,18715
376,80,186077,37750,230528,209172,21356
377,89,186469,39100,232028,210172,21856
378,88,186564,39500,213316,209021,4295
379,80,187340,35500,213829,212071,1758
380,81,187911,36450,212743,213947,-1204
381,90,188718,40050,213243,214399,-1156
382,89,189189,38650,215195,214292,903
383,90,190132,41400,217383,215045,2338
384,89,190168,38200,217343,216764,579
385,87,190443,38550,219734,218264,1470
386,82,190449,37400,219883,220482,-599
387,84,190549,38850,221195,222264,-1069
388,83,190994,37450,222433,224032,-1599
389,90,191072,42300,222415,225469,-3054
390,88,191179,40850,223195,226433,-3238
391,90,192315,40050,224915,227080,-2165
392,87,193727,38550,225933,227433,-1500
393,80,194438,35950,226784,228314,-1530
394,81,194926,36900,227245,228814,-1569
395,83,195452,35650,228993,227330,1663
396,82,195542,37850,228915,228442,473
397,86,196325,38950,229965,229195,770
398,82,197241,33800,231965,230036,1929
399,88,197289,40850,232033,231536,497
400,83,197869,37900,232965,232380,585
401,81,199131,37350,235493,232992,2501
402,85,199164,40250,235534,234380,1154
403,82,199514,37400,236533,234992,1541
404,86,199614,38950,237083,236153,930
405,86,199926,38500,237295,239153,-1858
406,81,200030,36000,228590,240586,-11996
407,87,200147,39900,231154,244636,-13482
408,81,200242,34200,231448,246753,-15305
409,83,201206,40150,231590,247786,-16196
410,80,201954,36850,227692,229301,-1609
411,84,202013,37500,228742,231651,-2909
412,84,202132,36150,231342,234651,-3309
413,90,202358,41850,233392,236301,-2909
414,90,202934,39600,237795,238201,-406
415,85,203002,38450,238017,241351,-3334
416,82,203141,37850,238517,242351,-3834
417,83,203587,38350,239440,244451,-5011
418,88,204439,39050,240602,247401,-6799
419,87,204944,41700,242935,248901,-5966
420,85,205299,38450,246535,252101,-5566
421,82,205462,38300,249152,254401,-5249
422,87,205874,40350,251535,255445,-3910
423,84,207433,39300,254035,256742,-2707
424,87,207977,39900,257652,257451,201
425,88,208176,39950,257635,258751,-1116
426,82,209666,37400,238154,249757,-11603
427,88,211110,39500,239545,250440,-10895
428,80,211365,35950,240666,252940,-12274
429,84,211619,38850,241704,237569,4135
430,80,212455,38650,242953,238635,4318
431,83,212712,37450,245254,239490,5764
432,89,212734,40450,246053,240583,5470
433,82,212833,39650,245916,241490,4426
434,81,213766,36900,247366,241990,5376
435,87,213902,40350,248525,243119,5406
436,80,213932,36850,250216,244119,6097
437,88,214178,40400,249804,245040,4764
438,88,214288,40850,250466,245683,4783
439,85,214400,38900,251416,246540,4876
440,90,214575,41400,252416,242295,10121
441,81,215784,36900,252283,243542,8741
442,83,216189,38350,253195,244542,8653
443,83,217353,36100,253784,245680,8104
444,83,218554,38350,255167,248204,6963
445,86,219071,38950,256333,251204,5129
446,89,220339,41800,258333,253254,5079
447,80,220415,37750,258597,256754,1843
448,83,222073,37900,258834,256730,2104
449,83,222876,37450,259745,252207,7538
450,81,223545,39150,260738,254514,6224
451,89,223725,36850,263878,256357,7521
452,82,224466,38750,266738,259502,7236
453,84,224729,39300,268428,264357,4071
454,87,225256,39450,269428,267357,2071
455,87,225737,41250,263767,269552,-5785
456,90,226298,38700,250929,273552,-22623
457,80,226709,35500,252112,278507,-26395
458,85,226983,38900,253207,280557,-27350
459,86,227288,38500,254207,282057,-27850
460,84,227444,39750,255673,284602,-28929
461,82,227447,37400,255662,284607,-28945
462,84,228999,37500,258840,264102,-5262
463,84,229045,37500,259544,259203,341
464,85,229157,39350,262544,260203,2341
465,87,229234,41250,263044,261559,1485
466,81,230076,32850,264936,262001,2935
467,85,230260,36650,265885,263001,2884
468,85,230466,37100,265390,263551,1839
469,85,231284,39800,260106,264347,-4241
470,90,232727,40950,264766,265398,-632
471,80,232766,35500,264678,266501,-1823
472,84,233757,36600,266316,270106,-3790
473,88,235292,40850,268316,273436,-5120
474,86,235371,40300,270728,275106,-4378
475,87,235690,39900,272029,276656,-4627
476,86,236157,37150,273307,279156,-5849
477,86,236643,38950,275329,281206,-5877
478,80,236734,37750,275364,284706,-9342
479,80,236970,35950,275829,286806,-10977
480,89,237263,39100,274828,288306,-13478
481,89,238630,40900,275970,273445,2525
482,84,239043,35700,276529,274232,2297
483,84,239366,37950,276970,274497,2473
484,82,241123,37850,278828,275495,3333
485,87,241365,39450,280590,276442,4148
486,86,241616,38500,282485,277232,5253
487,82,241775,38300,283485,278545,4940
488,88,242526,40400,284345,279545,4800
489,86,242749,35800,285395,280232,5163
490,83,243394,37000,285895,279140,6755
491,89,244013,42700,287917,281003,6914
492,87,244092,42150,288588,283837,4751
493,83,244157,38350,288917,286337,2580
494,83,244336,39250,289895,287464,2431
495,83,245020,37450,290549,272301,18248
496,86,247958,39400,291985,274301,17684
497,83,248002,35650,292049,276704,15345
498,86,248171,38950,293188,279304,13884
499,90,248667,41850,293995,281351,12644
500,83,249576,39700,294495,283851,10644
501,83,249605,37900,285590,286804,-1214
502,88,250808,38600,289090,288304,786
503,82,252127,38750,291096,289304,1792
504,84,252696,40650,292646,291804,842
505,87,253013,39450,295188,294304,884
506,82,253511,37850,295995,290151,5844
507,81,253554,38250,297485,292151,5334
508,86,253853,37600,298051,294201,3850
509,87,254456,42150,298188,296201,1987
510,81,255471,34650,298487,299201,-714
511,85,255531,35750,299117,301370,-2253
512,80,255793,35950,299646,303851,-4205
513,83,255813,37450,299690,305970,-6280
514,84,256190,38850,286339,309001,-22662
515,80,257089,38650,286256,310001,-23745
516,83,257380,39700,287341,311501,-24160
517,81,257821,37350,289078,313001,-23923
518,83,258354,38800,292078,316501,-24423
519,82,258537,36950,292341,319020,-26679
520,86,258673,38050,291290,322001,-30711
521,86,259111,38950,292550,292599,-49
522,90,259267,39600,294790,293259,1531
523,89,259315,39550,294806,293949,857
524,80,259681,34600,297597,294449,3148
525,90,259700,42750,297190,295234,1956
526,83,259717,37900,297690,295795,1895
527,84,260796,37500,299597,296847,2750
528,84,260832,37950,299740,297847,1893
529,88,260914,40400,300240,298847,1393
530,85,261552,38450,296220,299795,-3575
531,83,262712,38800,297079,300795,-3716
532,90,263134,41400,298906,301932,-3026
533,83,263162,38800,298720,302932,-4212
534,81,263634,35550,299307,304440,-5133
535,82,264020,34700,299781,304847,-5066
536,87,264039,41700,300579,305932,-5353
537,82,264394,39200,298639,306932,-8293
538,84,264596,37500,299406,307542,-8136
539,81,264703,36000,300105,308490,-8385
540,88,264978,42200,301555,301353,202
541,80,265026,37300,301647,301853,-206
542,90,265719,42300,303200,302099,1101
543,81,265778,36000,303342,301635,1707
544,81,266831,36000,304697,304633,64
545,86,267027,38500,305506,306133,-627
546,87,270226,41250,307619,308556,-937
547,82,270453,36050,310669,310556,113
548,85,270861,37550,313169,311633,1536
549,83,271565,37000,315769,314606,1163
550,81,273105,35100,316769,316606,163
551,85,273287,41600,310237,318106,-7869
552,90,273725,40950,311890,320606,-8716
553,90,273735,39600,311837,322656,-10819
554,87,274385,39900,312595,323156,-10561
555,86,275671,39400,313269,322256,-8987
556,83,275676,38800,313887,324639,-10752
557,84,276409,37950,314887,325756,-10869
558,88,277529,40400,316145,327641,-11496
559,88,277715,40400,316645,327988,-11343
560,86,277783,39400,317645,328204,-10559
561,88,278114,40850,318201,330903,-12702
562,90,278251,38250,319201,334304,-15103
563,80,278398,36400,321940,336804,-14864
564,80,278418,34600,322201,338804,-16603
565,81,278451,35100,321701,341553,-19852
566,88,278950,38600,323201,342804,-19603
567,81,279121,37350,325201,345354,-20153
568,81,279161,37350,325540,347553,-22013
569,81,279880,37350,326540,349854,-23314
570,84,280447,36150,327487,316759,10728
571,88,280704,38600,328245,318255,9990
572,87,283546,40350,329245,318655,10590
573,80,284134,37300,330040,319655,10385
574,83,285363,37000,330745,320655,10090
575,89,286458,39550,319950,321755,-1805
576,90,286475,40500,320806,322801,-1995
577,87,287072,38100,321592,324349,-2757
578,81,287458,34650,323092,325455,-2363
579,84,287545,38400,323000,326155,-3155
580,83,288458,39250,324306,326909,-2603
581,80,288604,35500,324592,327851,-3259
582,85,289532,38000,325599,328409,-2810
583,89,289634,43150,327099,329455,-2356
584,87,289728,38550,329299,330901,-1602
585,87,289785,38550,329490,331455,-1965
586,87,289823,39450,333299,321699,11600
587,80,289889,35500,333799,323141,10658
588,83,290222,38800,335040,324699,10341
589,81,291129,36450,335799,325699,10100
590,88,292706,41300,338090,327141,10949
591,80,293884,35950,339799,327199,12600
592,84,295008,37050,333599,325271,8328
593,82,295229,36500,333906,326045,7861
594,84,295823,38850,331554,326956,4598
595,84,296577,37500,330239,329943,296
596,82,297016,38300,331268,331456,-188
597,87,297132,38550,332557,332155,402
598,83,297380,38350,333557,332955,602
599,85,297510,37550,335716,333901,1815
600,85,297512,38450,335739,334505,1234
601,84,297696,38400,336408,333456,2952
602,82,298137,36950,337239,335956,1283
603,80,298185,35500,337908,337456,452
604,81,298321,38250,339757,339093,664
605,89,298323,41350,340266,336390,3876
606,85,298552,38450,342087,338566,3521
607,88,299103,37700,343857,340666,3191
608,85,300507,38900,344857,343716,1141
609,89,301188,39100,337749,344490,-6741
610,88,301314,39500,338749,347990,-9241
611,80,301861,34600,339749,350316,-10567
612,90,302842,42750,340458,352040,-11582
613,82,303198,36050,341601,353640,-12039
614,81,305203,37800,342625,354640,-12015
615,81,305777,33750,342952,355516,-12564
616,87,306619,38550,342569,358240,-15671
617,89,307104,40450,343690,360066,-16376
618,89,307150,40450,344945,362290,-17345
619,88,307210,39050,344737,365642,-20905
620,83,308912,37000,346203,366835,-20632
621,89,309435,39550,346945,367816,-20871
622,87,309538,40350,347995,369816,-21821
623,83,309805,35200,348753,349651,-898
624,86,311242,38500,351269,350441,828
625,86,311302,37600,350995,351688,-693
626,84,311557,40650,352253,352744,-491
627,87,311781,40350,352790,353688,-898
628,86,311924,39850,353995,354736,-741
629,87,312128,39450,354995,355744,-749
630,87,312342,39450,355803,357201,-1398
631,89,313211,40000,356887,357744,-857
632,90,313666,39150,358319,355395,2924
633,86,314104,40750,359545,356395,3150
634,80,315124,35050,360340,356942,3398
635,86,315471,39850,361319,357495,3824
636,81,315855,39600,361545,357995,3550
637,85,316579,41150,357461,358734,-1273
638,82,317763,38750,359506,358313,1193
639,81,318072,38700,361961,359105,2856
640,86,319227,38050,357001,359913,-2912
641,83,319319,37450,357354,360413,-3059
642,86,319927,40300,357849,361151,-3302
643,84,320239,39300,358494,362413,-3919
644,86,320516,40300,359549,363151,-3602
645,87,320621,39900,359132,364505,-5373
646,84,320640,37950,359170,363010,-3840
647,84,320892,37500,360483,365907,-5424
648,81,322171,36900,361063,367907,-6844
649,90,322641,39150,362999,369907,-6908
650,82,323107,36950,364793,373457,-8664
651,90,323215,43200,367793,363504,4289
652,85,323935,35300,370049,365206,4843
653,89,324052,41800,374343,368206,6137
654,86,324226,40750,377149,370104,7045
655,86,324379,38500,378649,372604,6045
656,90,324421,41400,380649,374856,5793
657,81,324669,38700,384649,376856,7793
658,80,324726,35950,384343,378906,5437
659,84,324770,36600,386199,381456,4743
660,90,325614,39600,388840,383456,5384
661,90,326450,40500,389853,384456,5397
662,87,326648,41250,390747,386854,3893
663,90,326980,42300,391371,390006,1365
664,81,327719,37800,390199,392904,-2705
665,80,328311,34600,392353,394904,-2551
666,89,328457,39550,392392,397954,-5562
667,86,328890,38950,392799,400606,-7807
668,87,328971,38100,386857,404054,-17197
669,88,329357,39950,389407,406104,-16697
670,89,331759,41800,391907,409606,-17699
671,89,331935,40450,395957,412104,-16147
672,83,331964,38800,396089,415146,-19057
673,82,333200,36050,397457,416034,-18577
674,82,333834,35600,399139,416584,-17445
675,84,334052,36150,402107,417154,-15047
676,88,334082,41300,369345,419706,-50361
677,85,334121,39350,369845,420206,-50361
678,80,334134,36400,368845,374343,-5498
679,80,334667,36400,371895,375251,-3356
680,89,335469,39100,374495,375694,-1199
681,87,336033,40350,377991,376988,1003
682,90,336482,39150,379995,377586,2409
683,84,336634,39300,382491,379703,2788
684,86,336794,38500,384495,383873,622
685,82,336911,38750,374043,386373,-12330
686,90,337037,41850,376543,388873,-12330
687,83,338236,37900,379384,391373,-11989
688,81,338378,37800,382512,393703,-11191
689,88,338849,39050,383557,388692,-5135
690,89,339367,39550,385012,390153,-5141
691,88,339433,38150,384566,391192,-6626
692,86,339666,37600,385557,392192,-6635
693,90,339968,42750,385384,393297,-7913
694,89,340806,40000,386468,394153,-7685
695,90,341032,40500,387384,389936,-2552
696,89,341486,39550,385453,394436,-8983
697,81,342609,36900,386453,396158,-9705
698,87,344450,40350,387722,397936,-10214
699,83,345402,36550,388453,399986,-11533
700,88,345855,40400,389953,403158,-13205
701,89,346171,40900,390899,404536,-13637
702,84,346204,38400,391860,389949,1911
703,86,347393,38050,392872,390905,1967
704,82,347560,36950,393872,391051,2821
705,87,348725,38100,394872,391905,2967
706,83,349061,40150,397003,392905,4098
707,88,349147,39050,397360,390739,6621
708,87,349730,39900,398003,391592,6411
709,84,350511,37950,399103,396059,3044
710,82,351141,37850,399906,399109,797
711,81,352318,36900,400603,401609,-1006
712,90,352531,38700,401360,403609,-2249
713,89,353307,39550,402406,405742,-3336
714,90,353478,41850,403653,407742,-4089
715,89,353648,40000,403999,408759,-4760
716,83,354218,37900,404499,411359,-6860
717,88,354266,39050,405922,397036,8886
718,84,354353,38850,405906,397749,8157
719,87,354585,39900,406406,398749,7657
720,83,354600,38800,402772,400039,2733
721,88,354890,41300,404772,400955,3817
722,81,355053,38250,408034,402086,5948
723,84,355579,38850,410534,403989,6545
724,85,356097,39800,411963,404539,7424
725,84,356166,37500,412185,406039,6146
726,89,357488,41350,412463,407455,5008
727,82,357955,37400,413124,408955,4169
728,82,358922,36500,413422,409955,3467
729,80,359771,35050,408670,410736,-2066
730,84,360728,37500,409659,414057,-4398
731,82,362644,36950,410243,416213,-5970
732,88,362764,38150,410720,419213,-8493
733,84,362954,39750,411793,420603,-8810
734,82,363046,35600,412512,420859,-8347
735,90,363158,42300,413720,421707,-7987
736,84,364029,37500,414843,417739,-2896
737,88,365711,40400,416062,418955,-2893
738,90,365891,40950,416893,413394,3499
739,88,366578,39950,417968,414303,3665
740,83,366842,37450,418759,415803,2956
741,90,367416,38700,419662,416997,2665
742,86,367459,39400,420468,418494,1974
743,83,368234,38350,421543,419803,1740
744,90,368301,36900,422320,420997,1323
745,81,368910,36450,422968,421994,974
746,90,369637,40050,423968,423103,865
747,85,370208,39800,425273,424260,1013
748,89,370257,40900,425342,426810,-1468
749,87,370467,40800,426140,429706,-3566
750,86,371715,38950,427690,430860,-3170
751,82,371990,37400,428503,431706,-3203
752,87,372234,39000,429823,433960,-4137
753,88,372332,39950,430392,434960,-4568
754,81,372695,34650,431690,437460,-5770
755,87,372826,39900,433392,440460,-7068
756,87,372884,39000,433740,442306,-8566
757,80,373408,35950,423045,442806,-19761
758,87,373870,39000,423643,434697,-11054
759,81,374747,35550,418053,435797,-17744
760,87,374892,39000,419012,436697,-17685
761,80,375380,36850,421658,438094,-16436
762,81,375570,36900,422708,439326,-16618
763,82,375817,36050,424191,441376,-17185
764,87,377098,39900,427741,443503,-15762
765,84,377243,39300,430207,446003,-15796
766,85,377328,38900,432741,446976,-14235
767,87,377859,39000,434449,449003,-14554
768,86,378314,41200,434956,450436,-15480
769,86,378502,38500,435456,451503,-16047
770,84,378826,36600,436506,452053,-15547
771,85,379267,38900,437746,429448,8298
772,87,379269,41700,438846,430448,8398
773,89,379360,41350,439006,431184,7822
774,80,379735,34150,439896,431948,7948
775,82,380100,36950,440499,433445,7054
776,84,380271,37950,442499,435109,7390
777,82,380537,36500,440341,437544,2797
778,88,381488,39950,443341,438159,5182
779,88,381910,41750,446457,439709,6748
780,85,383276,35750,448491,442309,6182
781,81,383569,37350,449491,446809,2682
782,87,383780,41700,438224,449309,-11085
783,90,384087,40050,439224,450809,-11585
784,80,384842,37300,439862,453744,-13882
785,90,385822,40950,441306,454909,-13603
786,84,385887,38850,442953,457294,-14341
787,84,385896,39300,442806,458009,-15203
788,85,386054,38900,443799,461009,-17210
789,90,386727,41400,444503,462394,-17891
790,88,387537,39500,444724,464894,-20170
791,87,389311,38550,434603,466790,-32187
792,86,389554,39400,435892,467601,-31709
793,89,391019,40450,436740,468101,-31361
794,88,391961,41300,438392,469138,-30746
795,81,393539,37800,439740,469259,-29519
796,85,393789,40700,440399,472544,-32145
797,88,394408,39050,441499,439460,2039
798,81,394981,37800,442442,440236,2206
799,90,395275,37800,443290,438889,4401
800,80,395751,35950,444290,439886,4404
801,90,396009,38700,445999,440939,5060
802,86,396101,40750,446123,442289,3834
803,83,397464,37000,446992,443101,3891
804,90,397656,40500,447992,444355,3637
805,85,398676,38900,448853,445101,3752
806,85,399317,37550,449853,446356,3497
807,89,399467,40000,450940,449906,1034
808,88,400202,42650,452042,452707,-665
809,82,402166,36950,452940,454506,-1566
810,82,402918,37850,453623,456757,-3134
811,85,402939,38450,454542,460307,-5765
812,80,403253,37750,455599,462807,-7208
813,88,403588,36800,456592,464556,-7964
814,87,405443,39900,458099,467106,-9007
815,88,407464,36800,458823,469407,-10584
816,90,408068,41400,459403,471907,-12504
817,83,408418,38800,460640,472907,-12267
818,87,408788,39450,461640,473393,-11753
819,90,408879,41400,462903,476393,-13490
820,84,409201,36600,463523,478565,-15042
821,89,409252,39550,464240,480643,-16403
822,86,410379,37150,466573,482565,-15992
823,84,410458,37950,466903,484843,-17940
824,82,411704,38300,467740,486565,-18825
825,90,412603,41400,468699,487843,-19144
826,85,413040,39800,450068,491115,-41047
827,80,413624,37300,453418,492253,-38835
828,86,413739,38050,454376,493457,-39081
829,81,413940,35100,456051,494253,-38202
830,89,413942,40450,455958,495057,-39099
831,87,414124,39450,456553,496253,-39700
832,80,414480,35950,458536,497403,-38867
833,81,414898,38700,460362,498607,-38245
834,85,416244,40250,462061,499705,-37644
835,88,416248,39050,462493,499817,-37324
836,86,416582,40300,462993,495493,-32500
837,90,416985,41850,462616,498993,-36377
838,84,417431,38400,464699,501665,-36966
839,85,419721,39800,471799,503543,-31744
840,90,419721,41850,469049,507165,-38116
841,83,419755,37900,472099,509165,-37066
842,85,421138,39350,474299,512793,-38494
843,82,421500,36050,475299,475793,-494
844,85,421754,35300,477799,476943,856
845,82,421945,37400,479299,479043,256
846,81,423924,35100,480299,480422,-123
847,87,423939,39450,483799,482643,1156
848,81,424353,38250,484849,484922,-73
849,87,424682,40350,487349,487193,156
850,88,426026,42200,489349,490922,-1573
851,88,426223,39950,492349,494422,-2073
852,86,426586,38950,493899,498293,-4394
853,89,428713,40900,498049,501522,-3473
854,82,428737,36050,497549,503622,-6073
855,84,429299,37950,499899,505122,-5223
856,83,429843,37900,502649,506622,-3973
857,84,430034,35250,504599,509493,-4894
858,87,430427,37650,507199,511272,-4073
859,83,431337,38800,509249,512322,-3073
860,83,431567,37000,512349,487239,25110
861,90,431581,41400,512249,488338,23911
862,85,431981,39800,514399,488739,25660
863,81,432503,35550,516349,489239,27110
864,86,433306,38050,520899,490005,30894
865,86,433324,38500,520499,491041,29458
866,89,433441,38650,482158,491605,-9447
867,81,433447,37350,483301,492339,-9038
868,83,433643,37450,483152,492838,-9686
869,83,433646,37450,482143,493839,-11696
870,82,433669,36050,482872,494751,-11879
871,85,433880,38900,484652,495541,-10889
872,89,434528,41350,487702,495751,-8049
873,80,434683,37300,489422,494886,-5464
874,83,434932,38800,490702,496144,-5442
875,89,434968,40450,492422,497448,-5026
876,82,434987,35150,494252,498386,-4134
877,87,435016,39000,489408,499194,-9786
878,86,435028,37600,490461,499386,-8925
879,81,435352,36450,491522,477897,13625
880,88,435573,39950,493022,478397,14625
881,83,435830,39250,494076,479301,14775
882,86,436283,39850,494912,480788,14124
883,85,436987,40250,495561,482759,12802
884,89,438019,40900,496561,485966,10595
885,80,438028,36400,499572,488466,11106
886,89,438101,40450,499611,491516,8095
887,86,438639,40300,500912,493016,7896
888,84,438649,38400,500843,497016,3827
889,86,438863,39400,502412,500516,1896
890,81,439307,37800,503661,502266,1395
891,86,439447,38950,504343,503859,484
892,87,439894,40800,505462,503566,1896
893,88,441311,40400,506462,501728,4734
894,85,442166,39350,506962,502853,4109
895,87,442179,39450,507226,504853,2373
896,83,442807,39250,494097,507328,-13231
897,88,442954,38150,496147,509328,-13181
898,81,443322,36900,500996,511328,-10332
899,89,443330,39550,501697,513553,-11856
900,81,443501,37800,503496,514328,-10832
901,83,444527,38800,495092,510707,-15615
902,88,444817,41300,496642,514109,-17467
903,84,445079,39750,497923,517109,-19186
904,90,445312,41400,499099,521109,-22010
905,88,445614,39950,500473,523609,-23136
906,85,445690,38900,500542,524307,-23765
907,85,446203,36650,501099,526609,-25510
908,87,446482,39450,503042,529307,-26265
909,80,446520,36400,503242,531159,-27917
910,87,446982,41250,505591,533159,-27568
911,83,447102,37900,507862,536857,-28995
912,85,447507,38000,511091,538357,-27266
913,88,448229,37250,513591,540957,-27366
914,81,448313,37350,514798,541895,-27097
915,90,448976,42300,515808,542848,-27040
916,81,449043,37800,516558,543348,-26790
917,82,449383,36950,517558,544449,-26891
918,80,449523,36400,518558,544999,-26441
919,85,449737,36650,519558,545398,-25840
920,88,451381,39950,520446,546138,-25692
921,83,451809,36550,521551,546999,-25448
922,82,451960,36050,522348,543759,-21411
923,81,452017,36450,523046,546007,-22961
924,89,452268,38650,524058,547794,-23736
925,80,452618,35500,524908,548499,-23591
926,83,453140,35650,526348,548945,-22597
927,86,453353,37150,526958,549607,-22649
928,84,454291,37050,528096,551107,-23011
929,90,454665,40050,529101,516095,13006
930,85,456370,38450,530458,517046,13412
931,81,457132,37800,531348,517849,13499
932,84,457272,38400,532101,518646,13455
933,90,459184,39600,532348,520355,11993
934,81,459781,38700,525505,521355,4150
935,81,459895,36900,526508,522097,4411
936,86,460005,38950,528526,520111,8415
937,81,460034,37800,528508,523494,5014
938,81,461724,37800,529901,525661,4240
939,84,463058,37500,531401,529161,2240
940,89,463154,37750,531168,530211,957
941,83,464274,36100,533308,533044,264
942,84,464311,37950,533348,534261,-913
943,87,464453,36750,535751,525101,10650
944,90,464466,42300,535796,526038,9758
945,86,464850,40300,536808,526991,9817
946,90,465783,41400,537751,528289,9462
947,83,465848,35650,537808,529538,8270
948,83,466158,37000,535841,529751,6090
949,86,466389,39400,538296,529957,8339
950,80,466632,35950,538850,530889,7961
951,84,466904,37950,539510,531751,7759
952,83,467028,36550,540012,533041,6971
953,87,467806,38550,529260,534113,-4853
954,89,468273,40450,531549,537458,-5909
955,80,468307,37750,531655,540113,-8458
956,80,468535,35950,532358,542008,-9650
957,81,468687,36450,530644,544163,-13519
958,84,468946,37050,532126,546058,-13932
959,82,469080,37400,534792,548163,-13371
960,82,469086,36950,533644,551663,-18019
961,82,469095,37400,535144,553663,-18519
962,81,469944,36900,536203,556163,-19960
963,84,470074,38400,537203,558808,-21605
964,85,471051,38450,537773,559808,-22035
965,83,471510,38350,538203,561663,-23460
966,90,471921,41400,540549,564213,-23664
967,85,472001,39800,540773,541767,-994
968,80,472759,38200,541703,542403,-700
969,90,473778,43650,543049,543403,-354
970,85,474087,39350,544049,544007,42
971,85,474639,40250,545049,544817,232
972,83,474918,37900,545892,546205,-313
973,82,475194,36500,546892,547205,-313
974,84,476167,41550,548099,548453,-354
975,85,477194,39800,548823,549055,-232
976,81,477649,36000,551203,543039,8164
977,80,477709,37300,552149,535298,16851
978,89,477765,40000,552203,536244,15959
979,87,478039,41250,553323,537036,16287
980,87,478434,39900,554203,537848,16355
981,88,478568,38600,555444,538949,16495
982,82,478593,39650,556873,540086,16787
983,84,479727,36150,557803,541278,16525
984,84,480533,38400,558444,542806,15638
985,86,480654,37150,558803,545306,13497
986,84,480944,36150,554826,545928,8898
987,86,481796,38500,555824,548806,7018
988,86,482433,41650,556324,551428,4896
989,83,482614,38350,556826,553928,2898
990,83,482922,37450,558012,555856,2156
991,82,483494,38300,558549,557428,1121
992,85,483689,36650,559874,560956,-1082
993,80,483711,35050,562049,563428,-1379
994,84,483744,37950,562996,565428,-2432
995,86,483799,39400,562026,567206,-5180
996,85,483814,37550,562599,568528,-5929
997,88,484780,39950,553716,571578,-17862
998,89,485288,40000,554715,573256,-18541
999,90,485425,40950,555715,576628,-20913
1000,83,485426,38800,556065,579128,-23063
1001,88,487339,39500,547338,581128,-33790
1002,88,487874,39050,548274,582728,-34454
1003,83,488594,37000,549326,583906,-34580
1004,86,489689,39850,550849,586006,-35157
1005,89,489751,40450,556551,587556,-31005
1006,86,489843,39400,556849,589378,-32529
1007,89,490015,40900,561601,592378,-30777
1008,88,490098,39950,561849,594639,-32790
1009,84,490714,37050,564849,596091,-31242
1010,84,490877,36150,567399,596701,-29302
1011,87,491271,41250,570251,598140,-27889
1012,87,491392,39450,573449,598701,-25252
1013,86,492750,38500,575801,599140,-23339
1014,88,492861,42200,577999,598606,-20607
1015,90,493315,44100,580801,602106,-21305
1016,86,494034,39850,584301,604478,-20177
1017,84,494490,36150,587351,606528,-19177
1018,88,496341,40400,589549,564344,25205
1019,88,496561,39950,594451,565401,29050
1020,81,496620,36450,596549,566298,30251
1021,89,496669,39100,597001,567240,29761
1022,87,497107,39900,598549,568348,30201
1023,84,497486,37950,601049,569045,32004
1024,85,498621,38900,603049,570340,32709
1025,90,498992,40050,605201,570898,34303
1026,82,499891,37850,607701,571898,35803
1027,87,500094,39000,610099,572940,37159
1028,81,500105,35100,610394,573901,36493
1029,88,500285,40850,611649,574898,36751
1030,82,500424,36950,573903,575440,-1537
1031,84,500640,38850,574568,575948,-1380
1032,81,502406,35550,575568,577044,-1476
1033,80,502843,37750,577108,578245,-1137
1034,88,503239,39050,578061,579044,-983
1035,85,503356,41150,579158,579551,-393
1036,84,503513,38400,581158,580498,660
1037,83,503555,39250,581226,581540,-314
1038,80,504602,35500,582668,582051,617
1039,88,505330,40400,583668,582745,923
1040,85,505988,38900,584208,583540,668
1041,87,506111,38100,586276,584101,2175
1042,89,506145,42250,586161,585040,1121
1043,83,506395,37450,587403,585745,1658
1044,82,506647,38300,588318,586644,1674
1045,86,508060,40300,589258,587644,1614
1046,88,508530,39950,590308,588540,1768
1047,85,508722,39800,591308,589651,1657
1048,85,509517,38900,592453,590040,2413
1049,83,509989,39700,592953,590745,2208
1050,86,509996,38500,593553,591651,1902
1051,88,510343,39050,594808,592744,2064
1052,86,510851,40750,596103,593590,2513
1053,80,511256,36850,597211,595596,1615
1054,81,511384,37350,598808,595598,3210
1055,81,511872,37350,599426,596651,2775
1056,88,512465,39500,599926,597598,2328
1057,90,513245,40050,601311,598244,3067
1058,83,513914,37900,602476,599244,3232
1059,87,514459,40800,604476,599845,4631
1060,89,514492,40000,604358,600598,3760
1061,85,515085,37100,605153,601648,3505
1062,80,515338,37750,606408,602345,4063
1063,85,515640,37100,606968,602895,4073
1064,89,517026,40450,607911,604190,3721
1065,83,517445,36550,608018,604844,3174
1066,88,517556,42650,595601,605751,-10150
1067,87,517707,36750,596355,606751,-10396
1068,88,518031,39950,598112,607751,-9639
1069,81,518122,36450,597905,608495,-10590
1070,86,519623,39850,598608,609198,-10590
1071,85,519679,39800,589276,610190,-20914
1072,90,520407,40050,590276,611248,-20972
1073,81,521586,38700,591478,611801,-20323
1074,88,522320,39500,592661,595091,-2430
1075,85,523951,37550,593478,595984,-2506
1076,86,524123,39850,594276,596984,-2708
1077,88,524822,42200,595162,597984,-2822
1078,84,525755,38850,596161,598627,-2466
1079,83,525973,40150,597712,599548,-1836
1080,83,526021,38800,598211,600548,-2337
1081,88,526190,41750,599261,601548,-2287
1082,84,526312,37050,599849,602557,-2708
1083,85,526985,38900,600761,603657,-2896
1084,87,527086,39000,604454,604457,-3
1085,80,527102,34600,603475,605098,-1623
1086,81,528565,36900,606454,606317,137
1087,90,528659,38250,610008,607157,2851
1088,83,528659,35200,610018,607957,2061
1089,85,529243,42050,611405,609057,2348
1090,86,529458,41650,612476,610057,2419
1091,82,529470,38300,613008,611293,1715
1092,84,530410,38400,610004,612793,-2789
1093,88,530882,40400,611725,613377,-1652
1094,87,530921,37650,614225,614198,27
1095,85,532404,36200,616225,614893,1332
1096,85,533315,38000,618504,615886,2618
1097,90,533560,40500,620225,616903,3322
1098,85,533795,36650,616616,617807,-1191
1099,85,534048,38900,617813,618503,-690
1100,84,534637,39750,619616,618507,1109
1101,87,534729,39000,620846,614240,6606
1102,84,534806,38850,621152,615398,5754
1103,89,535069,39550,624396,616240,8156
1104,81,535241,38250,630152,614662,15490
1105,81,535309,36900,630446,615712,14734
1106,88,535321,39050,630652,618262,12390
1107,82,536414,38750,633946,621262,12684
1108,80,536683,36850,635202,623262,11940
1109,82,537070,36050,637202,616070,21132
1110,86,537103,39850,639946,617759,22187
1111,84,537256,37950,644752,619809,24943
1112,86,537257,39400,645046,621220,23826
1113,80,537364,35950,646252,613301,32951
1114,82,539029,36500,649252,614691,34561
1115,82,539446,36500,650281,618211,32070
1116,81,539811,38700,651708,621213,30495
1117,83,539935,38350,652781,623213,29568
1118,85,540285,38000,653208,624911,28297
1119,80,540590,37300,653959,627411,26548
1120,88,541341,39500,654196,629961,24235
1121,88,541490,39500,655196,632263,22933
1122,85,541790,40700,616318,633061,-16743
1123,80,541855,36400,618464,622398,-3934
1124,87,541900,39450,619318,622496,-3178
1125,82,542607,36950,620863,624224,-3361
1126,81,543154,37350,622065,626224,-4159
1127,82,543177,35600,623565,627724,-4159
1128,81,545072,36450,626663,629646,-2983
1129,87,545113,40350,626666,631646,-4980
1130,87,545119,35400,626913,628140,-1227
1131,80,545169,37750,627115,629051,-1936
1132,90,545815,40050,627163,629640,-2477
1133,87,546437,39450,624514,631101,-6587
1134,88,546620,39500,627668,631841,-4173
1135,83,546646,39250,628115,633141,-5026
1136,86,546765,38050,628963,634140,-5177
1137,82,548225,38750,629170,635141,-5971
1138,83,548671,37000,632874,636140,-3266
1139,86,548677,38500,632594,637059,-4465
1140,82,549136,38750,635594,638441,-2847
1141,82,549384,36950,640474,640151,323
1142,88,549465,37700,641024,641559,-535
1143,83,549744,38350,643094,642701,393
1144,87,550883,40350,645594,643691,1903
1145,81,551200,36000,647594,644690,2904
1146,87,552440,39450,650074,645691,4383
1147,85,553352,38900,653174,647091,6083
1148,90,553353,40950,653674,648191,5483
1149,84,554631,38400,655319,648790,6529
1150,88,555175,38150,657174,649659,7515
1151,89,556365,41800,657793,650401,7392
1152,86,557720,39400,657224,651401,5823
1153,84,557897,38850,658293,652940,5353
1154,85,558259,39800,658388,653691,4697
1155,82,558680,36500,658821,654451,4370
1156,80,558835,34150,644420,655451,-11031
1157,87,559599,41250,646761,656940,-10179
1158,81,559662,35100,646908,657759,-10851
1159,83,560505,40150,648055,658951,-10896
1160,83,560765,39250,649555,660891,-11336
1161,82,561393,36500,649970,662359,-12389
1162,84,562218,36600,650761,663241,-12480
1163,83,562429,37450,651311,664551,-13240
1164,87,562534,36750,652476,665941,-13465
1165,82,562870,37850,653908,667040,-13132
1166,89,563438,40450,654908,667909,-13001
1167,85,563803,40250,655958,668941,-12983
1168,83,563936,39700,656970,669441,-12471
1169,80,565265,35050,658476,669991,-11515
1170,90,565854,43200,659461,670291,-10830
1171,86,566178,38500,660958,647301,13657
1172,85,567811,38450,662570,647745,14825
1173,89,567816,39100,664008,648648,15360
1174,82,568710,36950,665070,649245,15825
1175,89,569134,39550,666158,650295,15863
1176,80,569218,36400,667158,651990,15168
1177,87,569593,39450,668026,652948,15078
1178,89,570377,41800,669158,654148,15010
1179,82,570580,38300,670526,655666,14860
1180,80,571506,35050,670658,657691,12967
1181,80,571518,36400,671658,658691,12967
1182,83,572223,37000,672576,661691,10885
1183,86,572562,39400,673576,663691,9885
1184,80,572803,34150,674211,665691,8520
1185,81,572835,38700,675258,669191,6067
1186,88,573458,41300,676720,672191,4529
1187,82,574304,37400,677711,674966,2745
1188,80,574531,35950,678820,677691,1129
1189,85,575041,37100,679358,678241,1117
1190,87,575472,39000,680870,664848,16022
1191,89,576093,41350,682126,666048,16078
1192,83,576570,38350,682858,666348,16510
1193,89,576905,41350,684355,667240,17115
1194,89,577613,41350,686176,667551,18625
1195,85,577628,39350,685855,668551,17304
1196,88,579321,39050,675523,669598,5925
1197,82,579689,39200,676023,670740,5283
1198,81,579940,38250,662514,672098,-9584
1199,90,581113,39600,663078,673098,-10020
1200,86,581184,38950,663651,676608,-12957
1201,83,582216,37900,664628,679658,-15030
1202,88,582692,39500,666563,682278,-15715
1203,80,582696,36400,666251,684378,-18127
1204,83,583281,37000,667113,686858,-19745
1205,82,583855,37850,668570,689428,-20858
1206,88,584806,39500,669965,691978,-22013
1207,80,585580,35500,671117,693478,-22361
1208,80,586271,35050,672015,695008,-22993
1209,82,586466,38750,672813,697528,-24715
1210,86,586702,38050,674117,699678,-25561
1211,81,587138,38250,674913,701508,-26595
1212,84,588031,36150,676065,703058,-26993
1213,87,588573,39900,678065,704778,-26713
1214,84,588580,37950,678220,706158,-27938
1215,83,588951,39250,679220,709378,-30158
1216,81,589087,37800,680220,712708,-32488
1217,86,589229,39400,682220,713208,-30988
1218,89,589234,41350,682463,685820,-3357
1219,80,589367,37300,683065,688862,-5797
1220,89,589761,41350,685513,690862,-5349
1221,90,589806,38700,685220,692870,-7650
1222,90,589887,41400,686717,694912,-8195
1223,82,590799,36050,688113,697420,-9307
1224,90,591442,42300,688713,698962,-10249
1225,89,591855,40900,690115,700920,-10805
1226,85,592194,36200,690615,704062,-13447
1227,87,592320,39450,691717,707020,-15303
1228,84,593187,38850,692717,710070,-17353
1229,86,593429,39850,694113,712120,-18007
1230,81,593608,38250,695270,714170,-18900
1231,89,593784,43600,695713,716612,-20899
1232,89,594096,40450,693801,718662,-24861
1233,87,594792,40350,694478,720162,-25684
1234,80,594833,38200,694978,723162,-28184
1235,82,595065,38300,695928,726762,-30834
1236,84,595718,38850,697213,729262,-32049
1237,87,597129,39450,696256,731320,-35064
1238,89,597249,39550,700025,701759,-1734
1239,87,597352,39900,704675,702503,2172
1240,85,597390,36200,705175,703611,1564
1241,85,599001,38450,706175,706111,64
1242,87,599616,39900,705058,708366,-3308
1243,85,600226,37550,705412,710866,-5454
1244,80,600282,36850,706298,711866,-5568
1245,80,601255,35950,706912,714211,-7299
1246,86,601312,38950,708058,716711,-8653
1247,87,601993,42150,709298,718866,-9568
1248,88,602152,39050,709798,720866,-11068
1249,90,602580,40050,710912,723466,-12554
1250,83,602946,37900,712255,725966,-13711
1251,80,603137,37750,713162,727861,-14699
1252,89,603514,40900,714298,729466,-15168
1253,84,603685,39300,715298,730286,-14988
1254,84,603787,36600,715755,731091,-15336
1255,83,604634,37900,716662,731591,-14929
1256,88,604790,38150,717712,732516,-14804
1257,89,605243,40450,718712,732593,-13881
1258,83,605511,38350,719405,694392,25013
1259,87,606062,39900,720405,695392,25013
1260,90,606299,42750,721612,696844,24768
1261,82,606556,37850,722812,697442,25370
1262,82,606741,38750,724112,698349,25763
1263,83,607791,35650,724455,699349,25106
1264,85,608555,38450,725455,699899,25556
1265,81,608807,38700,726612,702049,24563
1266,90,609806,42300,727455,704549,22906
1267,89,613067,40450,728112,707649,20463
1268,81,613510,37350,728808,708918,19890
1269,88,613515,41300,729555,713018,16537
1270,85,614256,38900,730362,714068,16294
1271,82,615603,37400,731548,716118,15430
1272,85,615791,38450,732662,718718,13944
1273,81,616236,37350,733362,721249,12113
1274,85,616281,38000,734662,709401,25261
1275,85,616821,39350,736362,703811,32551
1276,88,616899,40400,736212,704861,31351
1277,81,617085,36900,737212,705390,31822
1278,82,617797,38750,738362,706851,31511
1279,84,618006,37500,739762,707491,32271
1280,90,618178,40500,740155,708490,31665
1281,87,618544,40350,741198,709191,32007
1282,86,619020,40300,742462,709691,32771
1283,89,620003,42250,743698,711491,32207
1284,85,620517,38000,744408,712190,32218
1285,82,621061,37400,745655,713001,32654
1286,83,621335,36550,746312,713741,32571
1287,88,624417,40400,747012,715491,31521
1288,87,624786,39900,748198,716991,31207
1289,80,625118,35050,749562,717511,32051
1290,83,625747,38800,751155,718690,32465
1291,82,625806,39200,751362,719341,32021
1292,90,626152,37800,752198,720041,32157
1293,86,626706,39850,753698,720601,33097
1294,81,626905,38250,754698,721341,33357
1295,87,627354,41700,755698,722561,33137
1296,89,628186,41800,756762,724341,32421
1297,89,628742,41800,757762,725561,32201
1298,81,630375,37800,759312,726541,32771
1299,85,630805,39350,760198,727790,32408
1300,83,632035,37900,761108,729041,32067
1301,83,632254,35650,762198,730319,31879
1302,83,632870,38800,763412,732319,31093
1303,82,633437,36950,763912,733819,30093
1304,86,634261,37600,764755,736919,27836
1305,80,635085,37300,766012,738241,27771
1306,81,635111,36450,766512,739791,26721
1307,81,635453,37350,767912,742969,24943
1308,86,635604,39850,768412,745519,22893
1309,80,635930,37750,769158,747569,21589
1310,87,635951,40350,770198,749291,20907
1311,82,636214,38750,771062,751219,19843
1312,81,637030,36900,772198,753719,18479
1313,87,637084,38550,772658,756841,15817
1314,80,637367,38200,737315,759319,-22004
1315,84,637564,40200,739508,761819,-22311
1316,88,637576,39500,739670,764869,-25199
1317,80,637699,35950,740670,767369,-26699
1318,82,638410,37400,742496,770369,-27873
1319,83,638450,36100,742996,771449,-28453
1320,86,639349,39400,742376,772803,-30427
1321,90,639977,41850,743876,773803,-29927
1322,85,640005,39350,743865,774399,-30534
1323,89,640635,40450,745376,775449,-30073
1324,88,640955,38600,747405,776652,-29247
1325,87,640981,40350,747415,777949,-30534
1326,83,641537,34750,748405,778949,-30544
1327,86,641672,38500,748926,779855,-30929
1328,88,641867,40850,750208,781152,-30944
1329,81,642209,38250,750915,782152,-31237
1330,84,642703,37500,752405,782855,-30450
1331,84,643592,40200,753415,784303,-30888
1332,82,643745,36050,755465,784652,-29187
1333,82,643830,39200,755976,774969,-18993
1334,85,643855,38000,756258,777691,-21433
1335,89,644629,41350,757455,780191,-22736
1336,87,645080,39450,758955,783019,-24064
1337,81,645092,36000,758476,785669,-27193
1338,90,645503,40500,759258,787669,-28411
1339,80,645845,35500,760026,790841,-30815
1340,82,645959,38300,761465,792341,-30876
1341,82,646098,39200,762470,794341,-31871
1342,83,646337,38350,764076,796341,-32265
1343,81,646435,36900,764258,798769,-34511
1344,86,647168,38500,765176,801769,-36593
1345,81,648168,36900,765676,803769,-38093
1346,90,648228,40050,767555,804819,-37264
1347,82,648315,37400,768470,754640,13830
1348,86,648411,38950,768358,755597,12761
1349,80,649210,34600,769908,756597,13311
1350,90,650457,42750,770726,757597,13129
1351,84,650592,38400,772226,759258,12968
1352,89,651487,43150,773226,761781,11445
1353,88,653208,39950,774276,764781,9495
1354,87,653466,40350,775055,767258,7797
1355,81,653996,37350,775826,769758,6068
1356,80,654527,35950,776170,770431,5739
1357,82,654536,36950,766163,772308,-6145
1358,89,655275,40450,766671,776081,-9410
1359,86,655659,41200,768320,778808,-10488
1360,85,655925,38900,768717,781358,-12641
1361,82,656978,36950,769663,784131,-14468
1362,88,657196,39500,772267,786831,-14564
1363,84,657223,37950,772320,787858,-15538
1364,83,657287,38350,772217,790358,-18141
1365,84,657845,40200,773217,792881,-19664
1366,87,658173,37650,773671,795358,-21687
1367,82,658398,36500,774217,799381,-25164
1368,85,658888,39800,775217,802881,-27664
1369,82,659028,36050,775263,805458,-30195
1370,81,659548,38700,774328,807458,-33130
1371,88,660143,38150,774953,811431,-36478
1372,82,661037,37400,775378,814108,-38730
1373,83,661642,37450,755044,816531,-61487
1374,81,661820,36450,756044,819531,-63487
1375,80,663403,35050,757044,822531,-65487
1376,85,663687,36650,757855,824581,-66726
1377,89,664283,40450,758855,826258,-67403
1378,89,664650,40900,759025,828081,-69056
1379,84,664863,38400,759046,830258,-71212
1380,85,665285,40250,760096,834681,-74585
1381,81,665573,34200,760525,836258,-75733
1382,85,665801,39800,763309,839331,-76022
1383,86,667272,38050,765225,841308,-76083
1384,84,667436,39300,768509,844381,-75872
1385,83,667976,37900,771109,846881,-75772
1386,86,669272,39400,774225,849381,-75156
1387,85,669574,39800,776825,852381,-75556
1388,81,670409,36000,778109,853931,-75822
1389,90,670702,41850,779975,856408,-76433
1390,86,671063,38050,781475,858408,-76933
1391,84,672309,37050,789309,860008,-70699
1392,82,672345,36500,787259,862481,-75222
1393,85,672358,40250,790309,863981,-73672
1394,82,673345,36950,796025,865608,-69583
1395,86,673384,39850,795809,868108,-72299
1396,85,673633,39800,798809,870608,-71799
1397,89,674005,41350,801309,872658,-71349
1398,82,674203,36950,804175,874658,-70483
1399,81,674310,37800,805859,878031,-72172
1400,89,674634,40900,808225,881031,-72806
1401,89,675156,39550,810409,883708,-73299
1402,88,675256,39950,811909,776578,35331
1403,89,675276,42700,816409,777867,38542
1404,88,675294,39500,816825,778543,38282
1405,90,675398,41850,818409,780043,38366
1406,90,675630,39600,820325,780593,39732
1407,80,675757,35500,822875,781302,41573
1408,87,676066,34950,823375,782067,41308
1409,82,676527,36950,780418,783336,-2918
1410,80,677693,36850,780453,784802,-4349
1411,84,677744,36600,781633,786093,-4460
1412,83,678476,40600,782466,786593,-4127
1413,86,678628,38500,783466,787836,-4370
1414,82,679132,37850,786149,788093,-1944
1415,83,679892,36100,788649,790220,-1571
1416,85,680038,38900,793149,793199,-50
1417,89,680069,40900,793514,795199,-1685
1418,89,680224,40000,797764,798199,-435
1419,80,680236,36850,798199,800820,-2621
1420,89,681670,40900,800314,803870,-3556
1421,81,681814,35550,802249,805870,-3621
1422,89,682953,39550,803864,808349,-4485
1423,88,683348,40850,804914,810970,-6056
1424,83,683782,38800,809749,813520,-3771
1425,83,683839,36550,809914,817449,-7535
1426,81,685782,38700,812749,820949,-8200
1427,83,687305,39250,815799,823120,-7321
1428,83,688181,35200,817464,825170,-7706
1429,82,690081,38750,817849,827649,-9800
1430,89,690414,40900,779549,830220,-50671
1431,87,690620,39000,780549,833249,-52700
1432,87,691262,39900,781549,834749,-53200
1433,84,691715,38400,782341,836770,-54429
1434,87,691960,40800,783581,840749,-57168
1435,80,692073,36400,784581,842749,-58168
1436,87,692298,38100,785487,844870,-59383
1437,80,692858,36850,786599,846299,-59700
1438,86,694375,40750,787599,848849,-61250
1439,86,696477,38500,788440,798670,-10230
1440,82,696792,37400,790537,801720,-11183
1441,88,696801,40400,790599,804770,-14171
1442,89,697726,41800,791599,806820,-15221
1443,85,698457,40700,792599,809370,-16771
1444,83,698991,34750,793649,811870,-18221
1445,82,699455,38750,794181,814496,-20315
1446,80,700047,33250,795440,816470,-21030
1447,82,700587,35150,796037,818970,-22933
1448,81,700943,39150,797490,821470,-23980
1449,89,701093,40900,799199,823970,-24771
1450,85,702899,40250,800281,826046,-25765
1451,88,703099,41750,800781,828546,-27765
1452,90,703229,39600,802781,831546,-28765
1453,89,703316,41350,802641,834046,-31405
1454,85,704052,37550,803141,836570,-33429
1455,86,704111,38500,802425,840046,-37621
1456,85,706219,38900,803559,842120,-38561
1457,90,706643,40050,804544,845096,-40552
1458,86,706960,40300,805696,847620,-41924
1459,81,707352,37350,807559,849620,-42061
1460,84,707383,38400,807475,852796,-45321
1461,88,707518,38600,808696,855846,-47150
1462,80,707676,36850,809594,859170,-49576
1463,85,708226,39800,810246,862896,-52650
1464,84,708842,38850,811144,865896,-54752
1465,84,709544,39300,812346,868220,-55874
1466,89,709829,40000,813396,871320,-57924
1467,81,710504,35100,813946,872870,-58924
1468,88,710844,39950,815194,874870,-59676
1469,81,710948,37350,817025,877096,-60071
1470,90,711010,42300,817046,878420,-61374
1471,90,711512,40500,819694,881420,-61726
1472,84,711520,37050,819809,883470,-63661
1473,90,711542,42750,820075,885970,-65895
1474,86,711901,38500,821096,887696,-66600
1475,87,713015,41250,822096,890070,-67974
1476,90,713372,41850,823194,892246,-69052
1477,87,714607,39900,824194,894796,-70602
1478,81,714906,38250,825309,897796,-72487
1479,87,715908,39900,826744,901296,-74552
1480,90,717184,39150,827105,903796,-76691
1481,87,717933,41250,828575,906870,-78295
1482,80,718179,35950,829294,908346,-79052
1483,89,718311,38200,830296,827100,3196
1484,85,718355,40700,830605,828142,2463
1485,84,718407,36150,821884,828907,-7023
1486,85,718670,36650,822778,829907,-7129
1487,88,719600,39950,823322,831142,-7820
1488,84,720511,37050,824017,832107,-8090
1489,80,720680,35500,825317,832398,-7081
1490,89,721109,42250,826220,833349,-7129
1491,83,721501,37450,826815,833898,-7083
1492,83,722014,37900,827875,834642,-6767
1493,90,722891,42300,829517,835849,-6332
1494,86,723763,38950,830113,836192,-6079
1495,85,725251,40700,830917,836849,-5932
1496,80,725745,35950,831613,837407,-5794
1497,86,727739,40300,832517,838742,-6225
1498,80,728084,36850,833163,839250,-6087
1499,84,728519,37500,834472,839849,-5377
1500,81,728807,37350,835417,841300,-5883
1501,88,728988,40400,837358,842457,-5099
1502,84,729062,39300,837365,842957,-5592
1503,88,729063,38150,837378,843350,-5972
1504,80,729699,38200,838205,844448,-6243
1505,88,730274,41750,841017,845350,-4333
1506,90,730281,37800,841365,846448,-5083
1507,85,730323,38900,841467,847242,-5775
1508,86,730616,38950,842358,848157,-5799
1509,86,730770,37600,843575,848948,-5373
1510,87,732676,39000,844905,849448,-4543
1511,83,732694,37000,845125,850657,-5532
1512,90,733108,42300,845863,851950,-6087
1513,90,733146,40500,848955,852792,-3837
1514,89,733179,42250,849020,853049,-4029
1515,85,733743,40250,849565,829909,19656
1516,87,734331,40350,851028,830727,20301
1517,81,734893,38700,851505,831253,20252
1518,85,735003,38450,852908,832559,20349
1519,86,735677,38050,853520,833277,20243
1520,84,735970,37050,854028,833557,20471
1521,88,736430,41750,854667,834609,20058
1522,85,736707,38900,855667,835557,20110
1523,85,737438,38000,857267,836453,20814
1524,85,737502,37100,857422,837609,19813
1525,81,737976,36450,858267,838157,20110
1526,83,737984,38800,858717,839109,19608
1527,84,739254,36600,914598,840409,74189
1528,88,739376,40850,843241,840959,2282
1529,89,739919,40900,844241,842109,2132
1530,89,739987,39550,833911,842959,-9048
1531,83,741419,38350,837411,844159,-6748
1532,90,741473,41850,837535,845027,-7492
1533,86,741506,38950,837130,845799,-8669
1534,81,741512,38250,837603,846799,-9196
1535,82,742598,36500,838612,847799,-9187
1536,84,743705,37050,839961,849196,-9235
1537,84,744037,37950,842316,849202,-6886
1538,87,744080,38100,842235,850299,-8064
1539,85,744937,39800,843316,850955,-7639
1540,86,746330,38950,844112,851905,-7793
1541,80,746838,37300,845612,853455,-7843
1542,88,747365,38600,846303,854405,-8102
1543,90,747481,40500,846866,855252,-8386
1544,88,748014,40400,848011,855955,-7944
1545,80,749494,36400,848735,851015,-2280
1546,83,749923,38800,849630,852015,-2385
1547,83,750997,37000,850540,853565,-3025
1548,90,751594,41400,851561,857412,-5851
1549,80,752363,36850,852561,859412,-6851
1550,83,752550,36550,854866,861165,-6299
1551,85,752554,38000,854903,863462,-8559
1552,81,752836,36000,855866,865462,-9596
1553,82,753794,36950,856416,867512,-11096
1554,90,755218,42300,859299,870012,-10713
1555,90,755224,37800,859667,871815,-12148
1556,84,755744,36150,860849,860918,-69
1557,83,757369,37000,865167,862918,2249
1558,90,758304,39600,868217,865468,2749
1559,82,759322,37850,869217,869568,-351
1560,87,760115,40800,872217,872068,149
1561,82,760283,37850,874717,874920,-203
1562,84,760465,37950,878267,877920,347
1563,87,760716,41700,881317,880420,897
1564,83,760801,38800,881499,883420,-1921
1565,83,760933,38800,884225,885920,-1695
1566,84,760983,37500,887111,888768,-1657
1567,89,762099,42250,889111,890768,-1657
1568,80,762401,33700,891149,892768,-1619
1569,80,762748,36850,893661,894520,-859
1570,85,762855,38900,896149,897520,-1371
1571,84,763882,36150,898025,899520,-1495
1572,88,765432,42200,901161,902070,-909
1573,86,765782,36250,904261,903418,843
1574,89,765831,41800,904761,906120,-1359
1575,82,765933,36500,907675,908120,-445
1576,86,766212,36250,909559,910170,-611
1577,85,766633,40700,911699,913118,-1419
1578,87,769054,39000,913217,915670,-2453
1579,83,769160,39250,915249,917670,-2421
1580,80,769736,36850,918217,919718,-1501
1581,87,770051,39450,920267,922718,-2451
1582,85,770054,38450,922349,924220,-1871
1583,81,770213,36450,924349,926268,-1919
1584,86,770247,40300,926349,928268,-1919
1585,82,770585,36950,928949,930768,-1819
1586,82,770777,36950,930317,933818,-3501
1587,87,770903,38100,932867,935868,-3001
1588,86,771526,38950,936049,937020,-971
1589,84,771970,38400,938417,939020,-603
1590,85,772054,40700,942967,942020,947
1591,83,772088,37450,943199,944520,-1321
1592,85,772369,37550,946017,946468,-451
1593,83,772425,37000,946299,949120,-2821
1594,87,772809,40800,948799,951620,-2821
1595,80,774142,35950,951299,953620,-2321
1596,90,774216,40500,953912,956718,-2806
1597,81,774442,38250,955364,882459,72905
1598,90,774801,43200,956462,884059,72403
1599,80,775071,36850,957050,885059,71991
1600,81,775204,35550,955167,888119,67048
1601,88,775477,39050,957999,890619,67380
1602,85,776592,39350,958667,892243,66424
1603,80,777149,35950,960717,889459,71258
1604,86,778180,39850,961217,890459,70758
1605,84,778533,39750,962049,891327,70722
1606,87,779233,39450,935361,893259,42102
1607,89,779336,41350,939961,894327,45634
1608,88,781448,39500,942475,895653,46822
1609,87,782171,36750,944061,896109,47952
1610,90,782275,39600,947061,896459,50602
1611,83,782633,36550,955225,898109,57116
1612,88,782687,39500,953061,898609,54452
1613,85,782708,40250,955561,899559,56002
1614,84,786272,38850,956061,900353,55708
1615,82,786311,38300,903207,901109,2098
1616,81,786942,38250,903970,902059,1911
1617,86,787074,38500,905186,903109,2077
1618,84,787436,40650,906915,903877,3038
1619,85,788282,37550,907915,905377,2538
1620,84,788539,38400,908807,906853,1954
1621,80,790223,34600,910020,907927,2093
1622,90,790317,42300,910186,909559,627
1623,88,791056,41300,911380,910209,1171
1624,90,792196,41850,912407,911259,1148
1625,85,792437,40700,913415,912559,856
1626,83,793391,37450,914186,913853,333
1627,83,794055,37000,915686,914809,877
1628,85,794107,38900,915620,916309,-689
1629,85,794337,39800,917930,916477,1453
1630,86,794417,38050,919480,916959,2521
1631,87,794486,39900,919120,918209,911
1632,84,794734,37500,920065,919209,856
1633,83,795427,37000,908048,919809,-11761
1634,88,795440,39950,908025,920403,-12378
1635,89,795833,40900,909009,921527,-12518
1636,80,795955,37750,909957,922309,-12352
1637,85,797465,39350,910598,923309,-12711
1638,84,797666,39750,911525,924209,-12684
1639,90,797680,39150,912025,924809,-12784
1640,85,798931,38000,913025,926209,-13184
1641,83,799434,38350,913598,927553,-13955
1642,88,800018,37250,914098,928309,-14211
1643,81,800060,38250,904372,928559,-24187
1644,87,800640,36300,905372,916291,-10919
1645,84,801121,37500,906122,917263,-11141
1646,80,801442,35050,907122,918263,-11141
1647,80,801797,35500,908622,919642,-11020
1648,86,803304,38050,909472,920391,-10919
1649,84,803347,37050,910413,921293,-10880
1650,87,805419,40800,911413,922313,-10900
1651,86,806844,38050,913172,923293,-10121
1652,84,806885,37500,913375,924293,-10918
1653,88,806910,38150,913123,924891,-11768
1654,90,807603,40050,914172,925863,-11691
1655,84,808130,37050,915522,926843,-11321
1656,86,808429,41200,916513,927843,-11330
1657,89,809028,39100,917925,928541,-10616
1658,87,810002,38100,918722,929041,-10319
1659,90,810710,38700,919925,930192,-10267
1660,85,810926,41150,920823,931041,-10218
1661,80,811931,36850,921772,932041,-10269
1662,83,812404,36100,922622,933401,-10779
1663,85,812930,39800,923425,934413,-10988
1664,86,813698,40300,924925,935413,-10488
1665,85,815054,36650,927163,936913,-9750
1666,90,815152,39150,927222,937792,-10570
1667,85,815854,39800,927872,938401,-10529
1668,83,815898,37900,929163,939191,-10028
1669,90,816964,41850,930372,940191,-9819
1670,87,817153,40350,931525,941691,-10166
1671,88,817742,40850,931873,942501,-10628
1672,82,818026,39200,932822,943001,-10179
1673,84,818053,36150,934422,944001,-9579
1674,88,818093,41300,934423,945191,-10768
1675,80,820194,36400,935923,945493,-9570
1676,85,820241,38450,936072,946113,-10041
1677,88,820527,40850,937213,947613,-10400
1678,84,820653,38400,938072,948501,-10429
1679,82,821093,36500,938713,949163,-10450
1680,85,821320,38900,939572,950191,-10619
1681,85,822667,37100,940622,951691,-11069
1682,85,822683,38900,940872,952043,-11171
1683,81,822729,36000,918527,943872,-25345
1684,84,822768,38400,913264,947422,-34158
1685,80,822922,36850,914764,949949,-35185
1686,88,823506,41300,915953,952472,-36519
1687,87,823595,39000,915764,927901,-12137
1688,90,824933,42300,917085,928902,-11817
1689,84,825223,37950,918011,929855,-11844
1690,86,826088,37600,919511,930834,-11323
1691,88,826502,38600,920314,932334,-12020
1692,83,826721,38350,921166,933307,-12141
1693,85,827926,40700,922166,933951,-11785
1694,80,828392,36400,923561,934307,-10746
1695,85,828535,35300,924216,935405,-11189
1696,89,828598,38650,925061,935407,-10346
1697,84,828766,37050,925814,937265,-11451
1698,88,829456,39500,927253,940315,-13062
1699,84,829805,39300,928385,943165,-14780
1700,87,830330,39000,929766,946415,-16649
1701,85,831589,40250,930314,949215,-18901
1702,90,831861,38250,931314,951915,-20601
1703,87,832728,38550,932314,954415,-22101
1704,83,832956,38350,933161,957915,-24754
1705,88,833221,35900,935866,960465,-24599
1706,88,833240,39050,934866,964415,-29549
1707,84,833316,37050,935803,966465,-30662
1708,82,833491,38300,936435,967965,-31530
1709,89,834421,41800,937823,972465,-34642
1710,86,834543,38050,939569,973515,-33946
1711,89,834970,41350,941872,975015,-33143
1712,89,836425,40900,942213,978515,-36302
1713,81,836841,36000,943075,980565,-37490
1714,83,837092,39250,943872,982015,-38143
1715,85,837444,39350,944975,983515,-38540
1716,87,837490,40350,945124,985065,-39941
1717,80,837928,36400,945763,987565,-41802
1718,87,838336,39450,946069,957191,-11122
1719,85,839387,40700,946485,958043,-11558
1720,82,839412,36950,946803,958801,-11998
1721,81,839721,35100,947466,959442,-11976
1722,90,840103,41400,948464,959942,-11478
1723,90,840405,39600,950064,960643,-10579
1724,80,840449,35500,950361,961693,-11332
1725,90,840612,42300,951485,962315,-10830
1726,88,841002,41300,952911,963001,-10090
1727,84,843362,37950,954353,956580,-2227
1728,86,846236,38950,955114,958130,-3016
1729,83,846352,37900,956114,959908,-3794
1730,87,846940,39900,957411,962383,-4972
1731,86,848682,39850,958516,964315,-5799
1732,80,848936,37300,955881,965044,-9163
1733,89,849028,43600,956707,966341,-9634
1734,85,852614,37100,948015,966501,-18486
1735,86,852800,38050,949211,967096,-17885
1736,89,853269,39100,949711,967596,-17885
1737,87,853315,40800,950820,967933,-17113
1738,82,853446,36950,951320,969396,-18076
1739,87,854307,38550,952015,971396,-19381
1740,85,854806,35300,953178,973396,-20218
1741,83,855351,36550,953870,976423,-22553
1742,81,856857,37350,955178,977973,-22795
1743,83,857214,37900,956370,980946,-24576
1744,86,858895,38500,957858,982473,-24615
1745,80,858905,36850,958228,984973,-26745
1746,86,859223,38950,960561,987023,-26462
1747,85,859224,38000,960665,991073,-30408
1748,81,859377,35100,961165,992573,-31408
1749,85,859708,38450,962508,994746,-32238
1750,89,859817,40000,963611,997246,-33635
1751,82,860117,37400,964715,999796,-35081
1752,81,860868,34650,966008,957651,8357
1753,80,861325,36400,967008,958979,8029
1754,82,861607,37400,967878,960009,7869
1755,81,861872,36000,968715,960979,7736
1756,83,862007,38350,969715,961922,7793
1757,82,862588,36500,970520,963243,7277
1758,84,864496,38400,971020,965743,5277
1759,87,865359,36750,972058,966422,5636
1760,87,866045,39900,972761,965309,7452
1761,87,866094,39000,973578,966029,7549
1762,85,866753,39350,974608,967103,7505
1763,80,871863,37750,975520,968529,6991
1764,83,872546,37000,976215,969809,6406
1765,85,872671,40250,977108,971029,6079
1766,90,873017,40950,977715,972309,5406
1767,90,873217,40500,978215,973509,4706
1768,86,873503,41200,979020,974209,4811
1769,89,873871,40900,979658,975079,4579
1770,90,875002,38250,981257,976129,5128
1771,83,875064,38350,982078,977209,4869
1772,86,875090,38950,984208,978209,5999
1773,83,875114,37450,984078,978809,5269
1774,86,875319,40750,985208,980203,5005
1775,90,875620,40950,986361,980859,5502
1776,80,876109,38650,987708,982229,5479
1777,87,876238,38550,988465,983229,5236
1778,90,876519,40950,989465,985717,3748
1779,86,877279,40300,991220,988319,2901
1780,86,877376,38500,991308,992869,-1561
1781,89,877928,40900,992128,996369,-4241
1782,87,878145,39450,993308,998369,-5061
1783,88,878301,42200,994128,999869,-5741
1784,86,879849,40300,995015,989259,5756
1785,85,880451,38000,996015,989829,6186
1786,83,880647,36550,997780,990759,7021
1787,85,880724,40250,998678,991953,6725
1788,80,880744,35950,998808,992509,6299
1789,88,881635,39950,999678,993609,6069
1790,85,881804,36350,999858,994259,5599
1791,81,883515,30450,999908,995259,4649
1792,84,883632,31750,998575,996309,2266
1793,82,884374,26950,999459,997003,2456
1794,81,884478,23250,999959,998159,1800
1795,80,884591,25100,986563,998879,-12316
1796,88,885080,32150,988275,999809,-11534
1797,86,885704,32150,988527,999941,-11414
1798,81,885718,26300,989113,990301,-1188
1799,85,886626,30650,990627,990946,-319
1800,85,886767,32850,991775,991946,-171
1801,87,888102,28950,992827,992851,-24
1802,82,889334,26850,994474,993165,1309
1803,80,889630,24900,995327,993665,1662
1804,89,890342,31850,996875,995045,1830
1805,90,890696,30900,997827,996265,1562
1806,84,890821,29200,998663,996901,1762
1807,83,890907,37300,999663,998045,1618
1808,82,890914,37400,999925,998543,1382
1809,80,891506,33750,985164,999446,-14282
1810,81,891584,33250,985312,999946,-14634
1811,80,892396,33200,986312,999996,-13684
1812,82,892670,28250,988505,997902,-9397
1813,82,892752,34300,988250,999399,-11149
1814,90,892961,36400,990505,999902,-9397
1815,88,893053,33750,990514,999952,-9438
1816,89,893392,37800,991300,989554,1746
1817,83,894054,32000,992412,990605,1807
1818,90,894455,31600,993300,991209,2091
1819,83,894502,36750,995264,992501,2763
1820,83,894794,33400,995814,993104,2710
1821,88,895363,36350,997462,994001,3461
1822,80,896352,31350,998555,994709,3846
1823,84,896581,30950,999850,995501,4349
1824,87,896736,30350,999864,996604,3260
1869,86,917036,32250,998292,997604,688
1869,86,917036,29300,999842,998601,1241
1870,89,917070,22400,999897,999604,293
1870,89,917070,20400,999947,999859,88
1870,89,917070,18300,988643,984884,3759
1870,89,917070,20200,989793,985884,3909
1870,89,917070,21700,990681,988384,2297
1870,89,917070,17650,992607,989798,2809
1870,89,917070,19200,993607,991798,1809
1870,89,917070,21650,997107,994348,2759
1870,89,917070,20400,999841,995434,4407
1870,89,917070,17100,996611,997934,-1323
1870,89,917070,17750,999661,999948,-287
1870,89,917070,8100,999978,995322,4656
1869,86,917036,6600,997937,997102,835
1869,86,917036,15100,999320,999322,-2
1869,86,917036,14050,999843,999822,21
1870,89,917070,6500,999937,998357,1580
1871,85,917636,10200,961418,999020,-37602
1871,85,917636,8600,961818,999929,-38111
1871,85,917636,11100,961918,999888,-37970
1871,85,917636,13000,962219,999938,-37719
1871,85,917636,11600,962549,999768,-37219
1872,89,918541,9100,962719,957894,4825
1872,89,918541,10500,963049,960394,2655
1872,89,918541,5200,963219,961894,1325
1872,89,918541,14300,963549,963418,131
1872,89,918541,19100,963719,964918,-1199
1873,85,918789,17650,964381,966918,-2537
1873,85,918789,16550,966049,969468,-3419
1873,85,918789,16300,975199,971094,4105
1873,85,918789,18050,972431,973152,-721
1873,85,918789,12650,975699,973399,2300
1873,85,918789,17150,978031,974248,3783
1873,85,918789,14350,979531,975399,4132
1873,85,918789,17750,985899,975899,10000
1873,85,918789,18000,986031,976652,9379
1873,85,918789,16000,986399,977401,8998
1873,85,918789,17500,988899,977901,10998
1874,82,919304,22000,992031,979152,12879
1874,82,919304,19200,996899,980152,16747
1874,82,919304,16200,998949,981449,17500
1874,82,919304,11900,999449,982296,17153
1874,82,919304,14700,999949,983501,16448
1874,82,919304,8500,999968,984501,15467
1875,80,919378,6050,999468,985252,14216
1875,80,919378,500,968219,986001,-17782
1875,80,919378,500,968599,987402,-18803
1875,80,919378,2000,968719,988049,-19330
1875,80,919378,4600,969099,989049,-19950
1875,80,919378,12050,974099,989551,-15452
1876,90,919384,8500,972219,990448,-18229
1877,87,919507,8600,976099,991151,-15052
1878,86,919780,9050,978269,991948,-13679
1879,80,920133,13500,982269,992796,-10527
1880,90,920490,15300,984769,993796,-9027
1881,88,920606,12650,986299,994448,-8149
1882,80,920722,12150,987799,995651,-7852
1883,86,920913,16050,994299,996948,-2649
1884,88,920930,14650,993799,997618,-3819
1885,89,921132,21750,996849,999672,-2823
1886,86,921748,17200,998349,998552,-203
1887,86,922249,21200,999469,999694,-225
1888,89,922304,20250,999969,999998,-29
1925,83,935070,12800,983742,994172,-10430
1925,83,935070,13550,984401,996246,-11845
1925,83,935070,18100,987401,998822,-11421
1925,83,935070,16600,991451,999872,-8421
1924,83,935026,18650,991842,992461,-619
1926,87,935198,21700,992842,993783,-941
1926,87,935198,24500,995951,995561,390
1926,87,935198,26000,999642,998333,1309
1926,87,935198,26700,999501,999833,-332
1926,87,935198,18700,999794,976118,23676
1926,87,935198,14600,977318,976144,1174
1926,87,935198,12600,979318,978974,344
1926,87,935198,13700,981868,982524,-656
1926,87,935198,9450,983368,984174,-806
1926,87,935198,13700,988068,986174,1894
1926,87,935198,12850,988018,988624,-606
1926,87,935198,12650,989068,991224,-2156
1926,87,935198,12800,993168,994124,-956
1926,87,935198,19000,994168,996624,-2456
1927,81,936061,15150,996668,998224,-1556
1927,81,936061,20700,999568,999724,-156
1927,81,936061,15600,999668,996968,2700
1927,81,936061,17200,999871,999494,377
1927,81,936061,8100,991702,999994,-8292
1927,81,936061,9150,994668,979194,15474
1927,81,936061,8600,996368,979618,16750
1927,81,936061,12600,999718,979694,20024
1927,81,936061,7500,999868,980118,19750
1927,81,936061,500,968868,980194,-11326
1927,81,936061,500,968968,980618,-11650
1927,81,936061,50,968918,980244,-11326
1928,82,936222,500,969418,980744,-11326
1928,82,936222,500,969468,981118,-11650
1928,82,936222,500,969918,981244,-11326
1928,82,936222,500,969968,981618,-11650
1928,82,936222,500,970418,981744,-11326
1928,82,936222,500,970468,988721,-18253
1928,82,936222,500,970918,991271,-20353
1928,82,936222,500,970968,993321,-22353
1928,82,936222,1000,971468,996821,-25353
1929,87,937317,7100,975018,997871,-22853
1930,90,937672,9550,981518,999871,-18353
1931,83,937758,3550,981568,993814,-12246
1932,89,939989,4500,986018,997364,-11346
1933,83,940045,4000,985568,999364,-13796
1934,84,940364,5600,988618,999971,-11353
1935,81,940494,6050,991618,999968,-8350
1936,90,941720,2600,993168,977718,15450
1937,86,942345,5600,995768,980268,15500
1938,90,942360,3550,997668,981318,16350
1939,87,944425,7500,999818,984918,14900
1956,81,952899,6500,988218,986618,1600
1956,81,952899,6050,988368,988068,300
1958,81,953094,6050,988718,989968,-1250
1958,81,953094,2050,988418,992968,-4550
1958,81,953094,4050,989118,994918,-5800
1958,81,953094,5100,991618,997468,-5850
1958,81,953094,4050,993318,999968,-6650
1958,81,953094,3550,994818,999968,-5150
1959,85,954040,5100,997168,999968,-2800
