job_id,tasks_num_of_single_job,task_generation_time,total_time,complation_time,complation_time_ordered,shortened_completion_time
0,80,31,21550,1086,638,448
1,87,70,25950,1582,2285,-703
2,88,217,21050,2733,2124,609
3,89,245,22000,2636,3034,-398
4,86,337,25450,3234,4073,-839
5,86,361,23650,3224,3334,-110
6,85,371,27200,3033,3688,-655
7,82,632,23450,3425,3991,-566
8,82,791,22100,4124,4431,-307
9,90,892,25200,5031,4981,50
10,88,1184,22400,5968,5471,497
11,87,1357,25950,6021,5574,447
12,90,1360,22500,6284,5834,450
13,87,1451,24600,6584,5835,749
14,81,1552,22500,7271,15389,-8118
15,81,1707,19800,7184,15234,-8050
16,80,1792,23800,7487,8026,-539
17,89,1975,24700,16382,8482,7900
18,86,1989,24100,10139,9123,1016
19,83,2200,22600,11339,10284,1055
20,90,2256,27450,9876,10385,-509
21,89,2508,26500,10674,10968,-294
22,90,2530,27000,11521,11183,338
23,81,2652,21150,11424,11639,-215
24,89,2775,22900,9987,12183,-2196
25,90,2889,27000,11087,13233,-2146
26,87,2897,24150,11087,11835,-748
27,89,3182,22000,12987,12381,606
28,90,3238,23850,12984,12931,53
29,80,3274,22900,13083,15234,-2151
30,90,3404,24300,15037,16790,-1753
31,88,3457,23300,15636,18134,-2498
32,89,3501,24250,15282,19340,-4058
33,84,3529,23100,15587,19840,-4253
34,86,3789,25450,16136,21484,-5348
35,86,3969,20050,16031,23342,-7311
36,88,4059,25100,17285,25134,-7849
37,86,4079,22750,17034,25692,-8658
38,90,4134,24300,17335,27284,-9949
39,88,4161,23300,18485,28484,-9999
40,90,4251,22950,18435,30234,-11799
41,83,4295,21700,18634,29992,-11358
42,86,4427,19600,16828,31834,-15006
43,84,4690,24450,18887,33134,-14247
44,81,4857,21600,19137,34684,-15547
45,88,5011,27350,23337,36692,-13355
46,88,5092,25550,24437,36942,-12505
47,80,5112,20650,24937,39234,-14297
48,80,5212,26500,29037,41092,-12055
49,85,5259,23150,29237,42192,-12955
50,90,5353,22050,29587,43742,-14155
51,90,5992,19800,31737,44792,-13055
52,87,6053,21900,33287,45892,-12605
53,86,6112,25000,34587,25222,9365
54,83,6202,24400,35490,23076,12414
55,80,6284,19750,34687,24076,10611
56,85,6286,21800,37183,24576,12607
57,88,6319,24650,37184,25473,11711
58,84,6355,24900,37283,26023,11260
59,85,6363,22250,36944,26768,10176
60,84,6496,21300,37387,27376,10011
61,81,6531,22050,40587,27468,13119
62,88,6573,22850,39737,27968,11769
63,85,6630,16400,40087,28323,11764
64,88,6933,20600,27975,28526,-551
65,89,6972,21550,28526,29118,-592
66,83,7033,23050,29025,29326,-301
67,86,7255,28600,29776,29738,38
68,82,7462,27050,31778,30623,1155
69,88,7489,23750,32025,31083,942
70,82,7494,24800,32026,31788,238
71,82,7522,25250,32276,32288,-12
72,88,7685,26000,36289,33091,3198
73,88,7734,23300,36939,33788,3151
74,83,7734,23950,35789,34633,1156
75,83,7763,18550,36636,34842,1794
76,81,7803,23400,37686,35733,1953
77,80,7869,24250,38489,36138,2351
78,81,7926,25650,38091,37138,953
79,82,7953,22550,38382,38238,144
80,89,8076,26050,39089,38738,351
81,85,8252,23150,39432,39388,44
82,89,8514,24250,40286,39942,344
83,82,8656,25250,40936,40438,498
84,85,8706,23150,41482,41434,48
85,80,8741,25600,39776,42139,-2363
86,83,8841,23500,40476,43734,-3258
87,88,8881,22850,41175,44789,-3614
88,80,9118,20200,41725,45384,-3659
89,84,9689,24450,42089,46084,-3995
90,82,9764,23000,42177,46539,-4362
91,82,9827,23450,42689,36323,6366
92,82,9830,25250,42987,36778,6209
93,83,9883,22150,43523,37770,5753
94,90,9974,25650,44220,38378,5842
95,89,9988,22000,44041,39270,4771
96,86,10151,26350,45227,39878,5349
97,88,10237,25100,45577,40271,5306
98,84,10280,22650,45870,40578,5292
99,86,10498,22300,46727,41370,5357
100,85,10544,23150,47173,41870,5303
101,84,10795,25800,44036,42920,1116
102,80,10933,24700,46137,43223,2914
103,82,10946,21650,46636,44021,2615
104,82,10951,23900,46941,44823,2118
105,80,10991,21100,46441,45278,1163
106,83,11260,20800,47941,42235,5706
107,82,11323,22550,53891,43089,10802
108,87,11350,22350,56041,44535,11506
109,90,11358,26100,56423,45235,11188
110,81,11430,22950,58091,47385,10706
111,86,11501,24100,58023,48289,9734
112,87,11586,25500,58641,48235,10406
113,87,11872,20550,59438,45528,13910
114,80,11916,26500,59285,45375,13910
115,82,12146,23000,60136,45884,14252
116,90,12227,26100,60235,46821,13414
117,90,12355,25200,60686,47371,13315
118,80,12413,22000,60785,47921,12864
119,86,12439,23200,61238,48421,12817
120,89,12831,23350,49385,48834,551
121,83,12923,18550,49131,49535,-404
122,88,13166,21950,49686,50285,-599
123,89,13345,26950,50286,50785,-499
124,88,13348,25100,50895,51478,-583
125,83,13712,20800,51986,51934,52
126,80,13747,20650,52031,52436,-405
127,86,13941,23650,52685,54136,-1451
128,89,13963,24700,52531,54190,-1659
129,83,14083,22600,53936,54128,-192
130,83,14111,24850,54086,54985,-899
131,89,14142,25600,54281,55485,-1204
132,84,14280,23550,54545,56134,-1589
133,88,14379,26900,55331,56728,-1397
134,86,14613,23650,55936,57635,-1699
135,82,14753,21650,57238,58135,-897
136,82,14851,20300,56981,58334,-1353
137,88,15385,24650,60433,58884,1549
138,88,15476,26900,60388,59484,904
139,88,15512,24650,62083,60134,1949
140,90,15525,24750,62688,60639,2049
141,82,15557,23000,60395,60935,-540
142,86,15841,22300,60786,61284,-498
143,88,15900,24200,61181,61939,-758
144,90,16002,23400,61445,62384,-939
145,81,16032,25200,63186,62939,247
146,89,16033,26500,63686,63535,151
147,83,16109,17650,64736,64235,501
148,86,16194,25900,64885,64539,346
149,84,16439,22200,65631,65039,592
150,85,16562,25400,68036,65539,2497
151,83,16578,22150,66745,65884,861
152,87,16635,25500,68635,66628,2007
153,85,16649,23150,67985,67034,951
154,83,16710,23050,68295,67628,667
155,80,16720,22900,68586,68285,301
156,87,16854,28650,70795,69328,1467
157,82,16889,20750,71795,69785,2010
158,88,16898,24650,70686,64026,6660
159,87,16924,23700,71985,64526,7459
160,82,16985,24350,72281,65268,7013
161,87,17097,26850,73035,66184,6851
162,90,17219,25200,74036,66734,7302
163,88,17367,21050,74335,67376,6959
164,83,17592,23500,75086,67625,7461
165,83,17766,19900,75545,68239,7306
166,85,18144,24950,77186,68625,8561
167,85,18236,23150,77035,69384,7651
168,87,18294,23700,67184,69868,-2684
169,81,18543,22050,67783,70384,-2601
170,81,18628,22950,68940,70984,-2044
171,82,18733,24800,69540,71484,-1944
172,87,18780,22350,69833,71984,-2151
173,87,18975,25500,70233,72875,-2642
174,84,19108,19500,70584,73326,-2742
175,86,19287,21850,70896,73975,-3079
176,81,19361,25650,71533,74876,-3343
177,90,19464,25200,72940,75376,-2436
178,80,19474,24700,72440,76376,-3936
179,84,19559,19950,73583,77384,-3801
180,83,19601,24850,73546,78087,-4541
181,82,19670,27500,74034,79737,-5703
182,83,19726,23950,76184,80737,-4553
183,85,19770,24950,75183,81737,-6554
184,81,19786,21150,76246,83342,-7096
185,87,19949,23250,77333,84637,-7304
186,90,19953,26100,77346,86692,-9346
187,84,20032,24000,77734,87187,-9453
188,90,20073,25650,77933,88387,-10454
189,87,20247,25950,78433,89487,-11054
190,84,20270,20850,80146,90192,-10046
191,81,20296,18900,79083,91637,-12554
192,85,20301,26300,80233,93287,-13054
193,82,20408,23000,83140,95092,-11952
194,85,20454,24950,84140,97642,-13502
195,84,20463,25800,82383,99742,-17359
196,84,20496,23100,83784,101242,-17458
197,89,20509,26500,84283,102842,-18559
198,90,20701,20700,84934,105042,-20108
199,89,20726,28300,85683,107542,-21859
200,84,20799,23100,87233,108542,-21309
201,84,20826,23550,87783,110237,-22454
202,86,20904,26350,87846,112387,-24541
203,85,21137,22250,88883,113437,-24554
204,86,21144,24100,89383,115687,-26304
205,86,21369,26800,90433,116787,-26354
206,87,21407,21900,90433,117685,-27252
207,87,21760,27750,91046,118091,-27045
208,90,21903,25200,91483,118844,-27361
209,80,21919,17500,91840,119191,-27351
210,80,22132,19750,93783,119390,-25607
211,84,22171,23100,92890,119885,-26995
212,87,22178,25950,93390,120885,-27495
213,84,22210,21300,95184,121385,-26201
214,80,22289,22450,95233,121885,-26652
215,80,22293,23800,95046,122294,-27248
216,80,22482,21550,95732,122941,-27209
217,83,22487,22150,98834,123540,-24706
218,90,22502,25200,98640,124041,-25401
219,85,22516,25400,97296,124585,-27289
220,83,22526,19900,99690,125085,-25395
221,81,22585,21150,99246,125735,-26489
222,89,22623,23800,99234,126791,-27557
223,83,22802,19000,101690,127641,-25951
224,86,22814,23650,101433,128991,-27558
225,84,22864,24000,101883,129644,-27761
226,86,22964,20950,102496,130144,-27648
227,85,23360,24950,103190,130835,-27645
228,89,23738,22900,100492,131694,-31202
229,88,23741,21050,100932,132491,-31559
230,82,23864,23900,101541,132844,-31303
231,82,23979,23000,102091,133535,-31444
232,80,24088,24250,103142,134091,-30949
233,82,24104,22550,103691,134591,-30900
234,81,24192,24300,104642,134991,-30349
235,90,24265,27900,104682,135490,-30808
236,85,24532,23600,105191,135691,-30500
237,80,24542,22450,105242,136444,-31202
238,86,24741,20950,107342,136891,-29549
239,86,24804,23200,107832,138140,-30308
240,86,24834,24550,107491,138944,-31453
241,86,24851,23650,107991,139541,-31550
242,87,24914,23250,107892,139791,-31899
243,85,25023,24500,108490,121037,-12547
244,87,25055,18750,108592,123087,-14495
245,88,25203,23750,109292,123637,-14345
246,85,25214,24950,109691,124542,-14851
247,85,25453,19100,110041,126487,-16446
248,90,25469,22950,111790,127637,-15847
249,83,25542,23500,112892,129392,-16500
250,84,25551,20400,113041,130937,-17896
251,83,25561,21250,113541,132037,-18496
252,89,25630,24700,113732,133087,-19355
253,86,25645,22750,113741,134287,-20546
254,86,25969,22300,114332,135192,-20860
255,80,25973,21100,114741,136637,-21896
256,83,26079,20800,116040,137787,-21747
257,83,26169,24400,115982,138742,-22760
258,81,26240,20700,116590,139292,-22702
259,85,26297,25850,117082,140041,-22959
260,80,26678,24250,118240,140591,-22351
261,87,26819,22350,119342,140885,-21543
262,85,26975,18200,119940,141385,-21445
263,81,27189,22500,121141,141841,-20700
264,80,27262,24250,121032,142491,-21459
265,84,27305,23100,121641,142940,-21299
266,89,27338,27850,121992,143635,-21643
267,84,27401,23550,119228,144591,-25363
268,82,27537,23900,120228,145040,-24812
269,84,27741,23550,120578,145641,-25063
270,83,27755,22600,115937,145235,-29298
271,80,27815,23350,116087,143137,-27050
272,83,27833,23050,116286,144292,-28006
273,90,28238,27900,118986,145748,-26762
274,89,28300,25150,119841,146291,-26450
275,81,28309,20250,119435,146385,-26950
276,84,28336,23550,119935,146690,-26755
277,83,28388,22150,119787,147291,-27504
278,90,28473,25650,120336,147690,-27354
279,90,28773,25200,120439,147987,-27548
280,88,28887,21500,121036,148042,-27006
281,81,28944,23850,121685,125228,-3543
282,80,29421,18850,122235,125670,-3435
283,80,29493,21550,122587,126675,-4088
284,85,29525,24950,123091,127180,-4089
285,88,29656,24650,124141,127975,-3834
286,80,29657,24250,124185,128670,-4485
287,88,29667,25100,124237,129221,-4984
288,87,29828,25050,124786,130271,-5485
289,80,30105,20650,126185,130821,-4636
290,83,30113,24850,126689,131275,-4586
291,87,30207,24150,128541,131770,-3229
292,81,30239,22050,127685,132278,-4593
293,84,30246,20400,128536,120831,7705
294,90,30529,23400,129591,121575,8016
295,86,30571,21850,129686,121881,7805
296,88,30873,23750,130339,122235,8104
297,82,30949,19400,131337,123835,7502
298,81,30994,20250,131236,125241,5995
299,82,31173,23000,131685,126841,4844
300,84,31325,24900,132091,128135,3956
301,86,31585,19600,133336,128735,4601
302,80,31598,24250,133285,129235,4050
303,84,31704,20400,133741,130441,3300
304,86,31771,22300,134385,131991,2394
305,80,32146,20200,134935,132885,2050
306,83,32259,22600,135387,133435,1952
307,89,32285,27850,136485,128284,8201
308,90,32400,26550,137085,128825,8260
309,80,32486,19300,131229,129381,1848
310,83,32504,23950,130630,130334,296
311,90,32562,25650,131189,131341,-152
312,87,32717,22800,132172,131631,541
313,87,32794,20550,131980,132125,-145
314,80,32818,23350,132672,132641,31
315,89,32951,22450,133222,133281,-59
316,83,32984,21700,135229,133672,1557
317,86,33033,25000,134425,134722,-297
318,88,33062,24650,135180,135272,-92
319,83,33205,22600,135925,135884,41
320,86,33453,22300,136730,136434,296
321,83,33717,22150,137379,137241,138
322,86,33807,23650,138339,137484,855
323,85,33837,21800,138730,137984,746
324,82,34013,22550,139075,138581,494
325,84,34111,23550,139939,139122,817
326,87,34484,25500,140729,139891,838
327,83,34576,24400,141372,140541,831
328,83,35083,25300,141830,141041,789
329,83,35196,25300,143980,141381,2599
330,82,35196,21200,144443,141881,2562
331,88,35211,24650,144523,142591,1932
332,85,35235,21800,144543,143422,1121
333,89,35795,23800,147823,143922,3901
334,88,35830,25100,147393,144422,2971
335,87,36136,21000,148973,144922,4051
336,87,36320,21000,149473,145731,3742
337,80,36415,22900,150393,145972,4421
338,87,36535,25500,151523,146925,4598
339,83,36539,23950,153173,147575,5598
340,84,36884,20400,154993,148622,6371
341,81,37042,22950,161543,148825,12718
342,83,37056,21700,162043,149331,12712
343,82,37071,22550,162723,149875,12848
344,87,37302,22350,165643,150591,15052
345,85,37374,24500,165823,151334,14489
346,82,37414,27500,168123,151931,16192
347,86,37488,20500,168623,152481,16142
348,80,37644,17950,170423,152575,17848
349,81,37739,21600,170593,153234,17359
350,87,37868,26400,171643,153872,17771
351,85,37981,18650,174423,154434,19989
352,87,38183,23700,176293,154941,21352
353,81,38206,22950,180593,155534,25059
354,90,38269,24300,183043,156225,26818
355,84,38284,28500,183543,157172,26371
356,90,38329,24750,183773,157734,26039
357,81,38331,20700,183273,158234,25039
358,88,38752,26900,186973,158981,27992
359,90,38824,26100,190223,159591,30632
360,86,38903,24100,190043,160141,29902
361,86,39009,25000,193193,160734,32459
362,87,39054,21450,193693,161284,32409
363,89,39074,25600,194673,161784,32889
364,87,39084,24150,195843,162531,33312
365,83,39178,23950,161589,163022,-1433
366,83,39196,25300,162689,163791,-1102
367,90,39270,23850,162429,164584,-2155
368,80,39319,22450,163239,164875,-1636
369,87,39320,26400,163529,165272,-1743
370,84,39852,23100,164529,165781,-1252
371,85,39858,22250,165225,166381,-1156
372,80,40089,22900,165330,166975,-1645
373,89,40245,23350,165679,167572,-1893
374,86,40288,26350,166275,168125,-1850
375,87,40360,24150,166722,168334,-1612
376,89,40423,23800,167030,168934,-1904
377,83,40607,25300,168080,169681,-1601
378,90,40705,23400,168772,170375,-1603
379,82,40739,25700,169130,171281,-2151
380,90,40864,26550,170272,172084,-1812
381,86,40980,20950,170689,172734,-2045
382,81,41185,22950,171822,173234,-1412
383,90,41260,27450,172229,173791,-1562
384,82,41700,22550,174239,174081,158
385,89,41725,22000,174975,174541,434
386,87,41752,23250,175072,174834,238
387,82,41811,22100,174780,175041,-261
388,90,41860,20250,176075,175472,603
389,83,41872,22150,175839,176231,-392
390,86,42180,21850,176339,176591,-252
391,85,42307,29000,176922,177684,-762
392,84,42449,21750,178338,178231,107
393,81,43021,24750,179786,178925,861
394,81,43448,24300,181688,179384,2304
395,87,43545,24600,182188,179984,2204
396,86,43872,29050,183738,181172,2566
397,82,43991,20300,185286,181534,3752
398,82,44003,22550,185488,182291,3197
399,84,44123,23550,187538,183131,4407
400,87,44138,25950,189588,183391,6197
401,90,44244,21150,190688,183834,6854
402,83,44377,23050,192238,184281,7957
403,82,44655,21200,193338,184884,8454
404,90,44964,19350,194136,185384,8752
405,87,45173,21450,194186,185641,8545
406,81,45175,22050,195238,168580,26658
407,85,45409,25850,196236,169289,26947
408,87,45694,28200,198188,170130,28058
409,88,45832,24650,199238,170887,28351
410,90,45992,25200,202686,171630,31056
411,80,46022,19300,203186,171989,31197
412,86,46082,20050,202588,172487,30101
413,86,46144,21400,207188,172830,34358
414,81,46145,23400,205988,173189,32799
415,80,46170,20650,207336,173689,33647
416,89,46312,23800,210388,174080,36308
417,84,46397,25350,210386,174687,35699
418,86,46580,21400,212088,175484,36604
419,84,46639,22200,215486,176134,39352
420,83,46657,23050,215738,176880,38858
421,85,46681,24050,215238,177287,37951
422,88,46772,22400,217088,177787,39301
423,86,46990,20500,218136,178039,40097
424,89,47017,27850,219686,178684,41002
425,80,47085,24250,221888,178880,43008
426,82,47116,22550,222436,179380,43056
427,80,47557,21100,225336,179930,45406
428,90,47598,27000,225836,180839,44997
429,87,47698,24150,230536,181434,49102
430,81,47735,26100,230586,182130,48456
431,87,47791,25050,231588,182437,49151
432,81,47853,21600,235738,182934,52804
433,86,47911,25450,235786,183230,52556
434,80,47932,25150,236238,183689,52549
435,83,48165,24400,236336,184289,52047
436,82,48339,23000,238388,184830,53558
437,86,48501,24550,239736,185830,53906
438,84,48814,25350,241938,185937,56001
439,87,48866,20550,244436,186487,57949
440,86,48920,23200,243636,186834,56802
441,82,48940,21650,244388,187430,56958
442,80,49149,21550,246038,187980,58058
443,81,49299,23400,247738,188284,59454
444,87,49454,17400,250836,188687,62149
445,89,49467,24700,251288,188784,62504
446,85,49572,24950,252388,189687,62701
447,85,49959,20000,252536,189987,62549
448,80,50003,20650,187987,190537,-2550
449,85,50038,20900,188845,191030,-2185
450,84,50405,22200,189345,191339,-1994
451,89,50744,21550,189938,191987,-2049
452,90,50828,26100,190386,192230,-1844
453,82,50989,23450,190188,192484,-2296
454,87,51083,19650,191283,192980,-1697
455,86,51349,22300,192188,193039,-851
456,81,51397,21600,192386,194039,-1653
457,88,51736,21950,193188,194539,-1351
458,88,51746,26450,193688,195230,-1542
459,85,51803,22250,195186,195934,-748
460,87,51845,25950,195686,196280,-594
461,85,51935,22700,195583,196780,-1197
462,88,52026,26450,197386,197387,-1
463,83,52080,21250,197288,198380,-1092
464,83,52185,26200,198595,198880,-285
465,84,52253,25350,199133,199489,-356
466,80,52319,20650,199038,199737,-699
467,85,52368,23600,199536,200630,-1094
468,83,52403,21700,200045,201134,-1089
469,84,52510,21300,200545,201684,-1139
470,80,52669,21550,201337,202187,-850
471,84,52872,20850,201083,202389,-1306
472,80,52896,23350,201688,203130,-1442
473,81,53109,19800,202236,203237,-1001
474,90,53248,23850,203037,203684,-647
475,84,53256,25800,203537,204637,-1100
476,81,53650,19800,203738,205230,-1492
477,87,53809,24600,205788,206280,-492
478,86,53843,21850,205595,206589,-994
479,82,53861,21650,206083,207089,-1006
480,89,53968,24250,206788,207437,-649
481,87,54212,25050,207936,207689,247
482,82,54256,22550,207787,208284,-497
483,84,54272,25350,208883,208939,-56
484,84,54328,24900,208787,209580,-793
485,88,54386,26450,209536,210384,-848
486,84,54599,23100,209888,211037,-1149
487,83,54669,22600,211695,211689,6
488,88,54675,22850,211588,212534,-946
489,87,54684,29100,212245,213237,-992
490,83,54782,24400,214095,213637,458
491,84,54790,21750,212983,214337,-1354
492,90,54817,27000,214137,215080,-943
493,84,54880,22650,213983,215687,-1704
494,89,54952,22000,214637,216689,-2052
495,82,55060,20750,215133,217137,-2004
496,84,55126,22200,215795,217687,-1892
497,81,55366,19800,216333,218130,-1797
498,86,55609,21850,217683,218687,-1004
499,84,55695,20400,218095,219289,-1194
500,85,55802,23600,218538,219537,-999
501,87,55975,25050,219245,220037,-792
502,81,56339,20250,219945,220230,-285
503,85,56485,24500,220436,220730,-294
504,87,56531,22800,222488,221389,1099
505,86,56594,24550,223083,222234,849
506,90,56598,23850,223086,222387,699
507,87,56630,22800,223437,223334,103
508,80,56675,20200,223686,223839,-153
509,87,56760,26400,224088,224537,-449
510,90,56881,27900,224688,225037,-349
511,87,56934,24150,225533,226037,-504
512,89,56972,23350,226137,226930,-793
513,89,57059,26500,226187,227784,-1597
514,87,57109,21000,226533,228037,-1504
515,81,57316,19800,227538,228580,-1042
516,85,57384,18650,227437,228639,-1202
517,83,57511,23500,228537,208393,20144
518,85,57553,24950,229095,209228,19867
519,82,57626,22550,229695,209836,19859
520,83,57675,20350,229737,210470,19267
521,85,57821,25850,230733,210836,19897
522,90,57867,27450,232986,211475,21511
523,81,57934,23400,232987,212070,20917
524,87,57937,24600,233483,212578,20905
525,81,57953,19800,233395,213486,19909
526,81,58150,17550,233587,214078,19509
527,86,58311,22750,234945,214628,20317
528,85,58325,22250,234486,215443,19043
529,82,58340,19850,234938,216070,18868
530,87,58607,24600,236736,216570,20166
531,89,58608,24700,236883,217536,19347
532,89,58635,24250,236645,218028,18617
533,85,58768,20000,237433,218686,18747
534,87,58948,25950,238038,219736,18302
535,89,58971,25150,238445,220593,17852
536,80,59084,20650,238786,221070,17716
537,88,59089,25100,239283,221678,17605
538,87,59288,25500,239833,222343,17490
539,86,59309,25450,240145,222975,17170
540,81,59419,22050,240687,223343,17344
541,82,59450,25250,229181,223720,5461
542,90,59516,23400,230381,224186,6195
543,81,59544,21150,230322,224525,5797
544,88,59928,25100,231726,225043,6683
545,86,59992,26350,232381,225728,6653
546,80,60045,23800,232681,226328,6353
547,89,60201,26500,234047,226675,7372
548,83,60261,22150,234181,227420,6761
549,82,60345,24800,235147,227920,7227
550,80,60368,20650,235031,228586,6445
551,82,60576,24350,236197,229920,6277
552,82,60606,23900,236031,230078,5953
553,87,60761,23250,236826,230593,6233
554,87,61100,26850,237781,231236,6545
555,89,61332,25150,237897,233089,4808
556,85,61449,22700,238331,235139,3192
557,85,61489,24500,238997,236691,2306
558,83,61536,22600,239497,237989,1508
559,82,61604,26600,240231,238489,1742
560,86,61650,23650,240526,239591,935
561,83,61819,19450,241076,234675,6401
562,83,61827,24850,242226,235228,6998
563,88,61916,21950,242981,235943,7038
564,90,61931,22500,242726,236378,6348
565,87,62108,26400,244597,236875,7722
566,90,62144,25200,244376,237493,6883
567,85,62453,24500,246147,238493,7654
568,89,62539,26500,246722,238836,7886
569,80,62609,18850,246481,239170,7311
570,87,62610,24600,247422,240170,7252
571,89,62673,23350,247922,241336,6586
572,84,63051,27600,248422,242325,6097
573,85,63247,22700,248897,242728,6169
574,84,63365,28500,249431,242943,6488
575,83,63446,26200,250476,243943,6533
576,88,63522,23750,251676,244493,7183
577,83,63522,21250,251272,244686,6586
578,88,63616,25550,251647,245225,6422
579,82,63622,22100,252947,245993,6954
580,81,63712,21600,254326,246325,8001
581,82,63810,23000,255047,246975,8072
582,80,63813,23800,255022,247278,7744
583,90,63929,22500,256597,247975,8622
584,86,63944,28600,256626,248928,7698
585,89,64087,22450,256631,249520,7111
586,85,64170,24950,257822,250136,7686
587,87,64240,21900,257976,250736,7240
588,88,64336,25550,259331,251578,7753
589,85,64365,24050,260226,252393,7833
590,81,64403,23400,259681,252786,6895
591,89,64447,21550,260072,253386,6686
592,85,64766,23600,260826,254225,6601
593,81,64979,23400,261326,254436,6890
594,82,65074,21650,261781,254743,7038
595,83,65204,20350,262631,255370,7261
596,82,65244,23000,263526,256186,7340
597,80,65327,25600,264722,256825,7897
598,85,65419,26300,264631,257570,7061
599,81,65582,25650,265831,258228,7603
600,81,65612,23850,265697,258670,7027
601,82,65664,22100,265822,258686,7136
602,82,65840,25700,266331,259428,6903
603,83,65985,21250,267176,260125,7051
604,90,66014,25200,267676,260528,7148
605,82,66132,25700,268381,261078,7303
606,86,66350,25000,269326,261870,7456
607,81,66428,20250,271031,262420,8611
608,82,66452,23000,271122,263020,8102
609,88,66504,25550,270397,263825,6572
610,81,66505,22950,271381,264325,7056
611,90,66568,28350,271722,264933,6789
612,87,66621,25050,272031,265628,6403
613,90,66671,26100,272726,266228,6498
614,86,66699,26350,273647,267025,6622
615,80,66789,17950,273481,267336,6145
616,84,66857,23100,274381,267743,6638
617,87,66932,21450,274131,268143,5988
618,81,67015,26550,276222,269343,6879
619,82,67030,24350,275497,269533,5964
620,81,67069,22950,276381,270089,6292
621,80,67242,22000,277597,270499,7098
622,89,67242,21550,277526,271049,6477
623,88,67666,23300,278647,271549,7098
624,85,67803,25400,279431,271789,7642
625,86,67944,24550,279831,273099,6732
626,88,68114,24650,280797,273699,7098
627,81,68481,22950,281226,273989,7237
628,81,68558,22050,282822,274399,8423
629,86,68562,24100,282831,275089,7742
630,81,68576,19800,283331,275593,7738
631,80,68659,21100,282926,276189,6737
632,83,68874,23050,283922,276988,6934
633,87,68966,25500,284331,277488,6843
634,87,69072,24150,285026,277743,7283
635,89,69229,26050,286026,278378,7648
636,89,69234,27850,286031,278936,7095
637,82,69367,22100,287547,279693,7854
638,89,69426,26950,288672,280520,8152
639,85,69441,24050,287281,281425,5856
640,88,69489,25550,289597,281925,7672
641,88,69502,22850,289681,282343,7338
642,88,69547,26450,290822,282893,7929
643,83,69612,21250,291422,283336,8086
644,85,69640,22250,290697,283775,6922
645,85,69671,20900,291526,284320,7206
646,83,69802,22150,291797,284849,6948
647,87,69832,26400,292526,285533,6993
648,81,70107,18450,292847,286033,6814
649,89,70156,29200,293681,287243,6438
650,86,70175,23200,293997,287949,6048
651,83,70299,25300,295372,288839,6533
652,80,70348,22000,295797,289390,6407
653,84,70383,19500,296397,290440,5957
654,84,70405,22650,297576,291940,5636
655,81,70466,22500,297781,292537,5244
656,88,70503,21500,298781,293040,5741
657,87,70592,26850,298881,294690,4191
658,86,70964,24550,299726,296990,2736
659,89,71028,25150,300331,298737,1594
660,87,71046,23700,300997,300290,707
661,81,71255,22050,301572,301987,-415
662,86,71342,25450,302276,303037,-761
663,82,71614,17600,303381,304090,-709
664,88,71623,27800,303872,305640,-1768
665,83,71627,20800,303426,307940,-4514
666,86,71702,25900,303597,309587,-5990
667,84,71734,21300,305247,310287,-5040
668,80,71751,23800,304647,312837,-8190
669,87,71790,21900,305847,313340,-7493
670,88,71869,23750,305631,300138,5493
671,86,71935,25000,306726,300638,6088
672,82,72060,23000,307281,301039,6242
673,89,72281,25600,309576,301793,7783
674,90,72308,22500,309626,302493,7133
675,81,72323,22050,309031,302738,6293
676,90,72342,24300,310347,303083,7264
677,83,72366,23500,310822,303889,6933
678,84,72425,22200,310626,304288,6338
679,84,72518,21300,311081,304883,6198
680,82,72564,22100,306191,305343,848
681,87,72633,20550,306486,305978,508
682,87,72765,23700,308391,306720,1671
683,89,72766,25150,308396,307636,760
684,88,72810,21050,308341,308193,148
685,80,72921,21100,310390,308686,1704
686,89,72943,22450,310591,309186,1405
687,85,72957,24500,310286,309293,993
688,81,73002,25650,310246,309675,571
689,81,73127,21150,310896,309993,903
690,87,73170,23700,311996,310870,1126
691,80,73213,22900,312990,311825,1165
692,89,73215,24250,313486,312436,1050
693,80,73290,22450,314036,313120,916
694,90,73352,26100,314141,313620,521
695,81,73846,21150,314736,314393,343
696,90,73885,23850,315640,315028,612
697,90,73886,22950,316946,315586,1360
698,86,73892,21850,317041,316475,566
699,81,74026,23400,318041,316686,1355
700,88,74074,25550,318096,317320,776
701,80,74142,24700,318290,318275,15
702,83,74334,22600,319340,318825,515
703,85,74392,22700,319291,319420,-129
704,87,74654,24150,319941,320025,-84
705,88,74657,28250,320391,320943,-552
706,90,74762,22950,320941,321525,-584
707,87,75018,21000,321091,322170,-1079
708,89,75145,18850,322641,322993,-352
709,87,75159,23700,322286,323543,-1257
710,88,75221,26000,323941,323736,205
711,85,75296,23600,324446,324470,-24
712,86,75303,25900,323896,324986,-1090
713,86,75372,22750,324890,325275,-385
714,80,75584,26050,326046,297221,28825
715,89,75595,26050,326440,298234,28206
716,85,75694,20900,327091,298834,28257
717,85,75713,26300,327536,299678,27858
718,82,75895,23000,328641,300171,28470
719,85,75898,19100,328536,300722,27814
720,87,76132,26850,331336,301272,30064
721,86,76138,20950,330890,302028,28862
722,88,76151,23300,330891,303028,27863
723,85,76220,20900,331091,303771,27320
724,89,76385,20200,331646,304525,27121
725,80,76461,20200,332241,305034,27207
726,83,76521,22600,333541,305478,28063
727,82,76566,19400,334236,305684,28552
728,86,76615,22750,334246,306384,27862
729,87,76638,23250,334591,306578,28013
730,88,77161,24650,335246,307421,27825
731,83,77395,23050,335341,307975,27366
732,83,77412,23500,335746,308487,27259
733,82,77515,25700,337441,310191,27250
734,85,77558,20900,337641,310841,26800
735,89,77704,26050,338241,312841,25400
736,80,77818,22000,339341,314041,25300
737,84,77887,22200,339186,315741,23445
738,83,78040,23050,339736,318787,20949
739,89,78043,21550,340091,321337,18754
740,88,78267,21950,340336,322987,17349
741,89,78296,28300,341336,325491,15845
742,83,78463,26200,343390,327541,15849
743,90,78483,27450,343841,328437,15404
744,81,78488,22050,343290,329991,13299
745,82,78491,20300,343646,332687,10959
746,82,78611,18950,344841,333787,11054
747,89,78687,24250,344696,334837,9859
748,82,78752,21650,345846,335991,9855
749,90,78794,28350,346690,337541,9149
750,85,78913,24950,346841,338641,8200
751,81,79271,19800,347240,339737,7503
752,86,79750,25450,348291,341541,6750
753,84,79808,22650,350341,343037,7304
754,82,79856,22550,350136,343737,6399
755,81,79892,24750,350140,345887,4253
756,86,79898,29500,350096,349037,1059
757,83,80100,23500,351140,350037,1103
758,84,80103,25350,352041,351491,550
759,83,80191,26650,352436,353991,-1555
760,90,80393,26550,354291,355691,-1400
761,85,80402,20900,353746,356837,-3091
762,81,80450,24300,354536,358841,-4305
763,80,81094,23800,354991,360087,-5096
764,86,81260,23200,356886,361687,-4801
765,83,81281,23050,356891,362737,-5846
766,85,81358,21350,356746,364337,-7591
767,89,81437,26050,357246,365987,-8741
768,85,81552,24500,357886,369187,-11301
769,85,81575,23150,358191,370187,-11996
770,82,81774,20750,343330,371141,-27811
771,83,81817,21700,343778,372337,-28559
772,85,81870,22250,344178,373341,-29163
773,90,82023,24750,345428,373841,-28413
774,80,82103,25600,345528,374987,-29459
775,81,82150,18900,345828,376041,-30213
776,81,82227,24750,346828,377737,-30909
777,87,82329,24150,347830,378937,-31107
778,84,82486,24900,347878,379491,-31613
779,81,82768,19800,305685,380241,-74556
780,85,82808,25400,306136,381887,-75751
781,81,82896,22500,306339,383387,-77048
782,89,82925,23350,306836,384537,-77701
783,85,83108,22250,307539,384741,-77202
784,81,83207,19350,308039,385841,-77802
785,87,83285,26400,308585,387841,-79256
786,81,83351,20250,308539,388391,-79852
787,84,83450,24000,309391,389987,-80596
788,85,83565,21350,309739,391787,-82048
789,80,83568,22000,310889,392291,-81402
790,82,83584,23000,311486,393387,-81901
791,87,83658,24150,311285,394187,-82902
792,86,83694,26350,313841,395341,-81500
793,87,83758,23700,313885,396587,-82702
794,87,83785,25950,314186,398487,-84301
795,86,83785,24100,314239,400441,-86202
796,85,83785,19550,314339,402037,-87698
797,90,83900,22050,315236,403641,-88405
798,85,83902,23600,315441,404741,-89300
799,81,84064,22500,315941,405887,-89946
800,81,84225,18450,316689,407587,-90898
801,81,84297,16200,317189,408637,-91448
802,89,84403,25150,318085,409241,-91156
803,82,84403,26150,317741,410937,-93196
804,87,84631,23250,319291,412887,-93596
805,87,84683,23250,319289,415491,-96202
806,85,84932,24050,319839,416641,-96802
807,84,85088,23550,320285,418241,-97956
808,89,85259,23800,320889,420387,-99498
809,87,85377,22800,321991,421637,-99646
810,85,85427,22250,322689,423641,-100952
811,86,85510,28150,322939,423887,-100948
812,86,85616,25450,323235,354678,-31443
813,84,85632,24000,324039,355072,-31033
814,89,85657,25150,324439,355875,-31436
815,83,85888,21700,324991,356678,-31687
816,89,86163,26500,325491,357178,-31687
817,82,86294,19400,325885,357525,-31640
818,80,86563,19300,327136,358125,-30989
819,90,86617,27000,327485,359071,-31586
820,87,86788,23700,328186,359228,-31042
821,87,86874,22800,328989,359778,-30789
822,88,87019,22400,329639,360222,-30583
823,84,87131,21300,330689,360278,-29589
824,88,87188,28250,331139,361125,-29986
825,82,87291,30200,332189,362278,-30089
826,80,87325,22000,332189,363271,-31082
827,88,87478,22850,332791,364022,-31231
828,86,87585,21850,333385,364675,-31290
829,82,87827,23900,334385,365175,-30790
830,81,87844,25650,334689,365622,-30933
831,90,88404,25200,335185,366122,-30937
832,85,88805,25400,335939,366622,-30683
833,84,88850,20400,338891,367622,-28731
834,89,88861,26950,337039,369028,-31989
835,85,88886,24500,337285,369122,-31837
836,89,88905,22900,339939,370121,-30182
837,84,88933,22200,340041,370225,-30184
838,85,88953,24050,339385,371171,-31786
839,82,88953,25700,340539,371734,-31195
840,87,88961,21000,340541,372221,-31680
841,84,89243,23100,341286,372734,-31448
842,85,89300,26300,341641,373234,-31593
843,89,89381,24700,342685,373478,-30793
844,83,89465,23950,343589,374472,-30883
845,81,89582,22500,344086,375325,-31239
846,89,89670,30100,345341,375984,-30643
847,87,89760,24600,345935,376728,-30793
848,80,89764,25150,345139,377278,-32139
849,84,89778,24450,346435,378278,-31843
850,82,89845,22100,347341,378928,-31587
851,88,89904,26000,347985,379625,-31640
852,85,89970,27200,347989,380428,-32439
853,80,90206,22000,350089,380822,-30733
854,81,90266,22500,350739,381972,-31233
855,89,90279,26500,350086,382984,-32898
856,90,90356,26100,350835,383484,-32649
857,80,90628,20650,351239,383725,-32486
858,89,90954,22900,353736,384275,-30539
859,85,90990,24500,353291,384778,-31487
860,85,90995,21800,353135,385584,-32449
861,87,91021,24600,354889,385778,-30889
862,81,91103,25650,354936,386634,-31698
863,80,91108,22900,354989,386928,-31939
864,83,91272,26200,355685,387721,-32036
865,80,91732,24250,356941,388225,-31284
866,83,91823,20350,356685,389022,-32337
867,86,91980,23200,357441,389771,-32330
868,85,92043,23600,358041,390125,-32084
869,89,92160,25600,359389,390675,-31286
870,88,92197,23750,359686,390971,-31285
871,80,92277,24700,359889,391928,-32039
872,84,92327,20400,360389,392172,-31783
873,88,92561,23750,361391,392978,-31587
874,86,92573,23650,361389,393822,-32433
875,86,92690,23650,361885,394322,-32437
876,90,92733,23400,351989,394822,-42833
877,89,93336,25150,353277,395548,-42271
878,85,93351,21800,352679,396641,-43962
879,81,93399,25200,353180,397247,-44067
880,86,93607,23200,354230,397837,-43607
881,90,93655,31500,354974,398837,-43863
882,89,94091,26500,355430,399387,-43957
883,85,94131,24500,357077,399841,-42764
884,83,94144,19000,356780,400287,-43507
885,80,94222,22000,357129,400847,-43718
886,86,94302,22300,358089,401490,-43401
887,81,94370,23400,357679,402490,-44811
888,89,94436,22450,359679,402787,-43108
889,80,94454,22000,359727,403597,-43870
890,82,94507,23450,360024,404348,-44324
891,82,94612,24800,360739,405448,-44709
892,84,94850,21300,361229,406448,-45219
893,83,94885,22600,362977,407793,-44816
894,84,94896,22650,362530,409485,-46955
895,84,94906,22200,362829,409985,-47156
896,85,95066,22700,363329,411735,-48406
897,88,95328,28700,364324,413285,-48961
898,86,95396,27700,365279,414693,-49414
899,89,95426,25150,364989,416343,-51354
900,88,95437,20150,365077,417893,-52816
901,89,95699,24700,365929,418993,-53064
902,83,95702,24400,366479,420035,-53556
903,81,95816,19350,367839,420785,-52946
904,81,95827,25200,367124,422885,-55761
905,83,95866,23950,367624,424443,-56819
906,82,95940,20750,369624,425785,-56161
907,90,95990,25200,368539,427743,-59204
908,86,95992,25450,369627,429485,-59858
909,82,96015,23450,369930,431185,-61255
910,89,96095,22450,370089,433785,-63696
911,82,96167,23450,371030,435243,-64213
912,85,96179,20900,371177,436935,-65758
913,80,96315,22450,371927,437893,-65966
914,87,96378,23250,372030,438493,-66463
915,87,96591,20100,372525,440043,-67518
916,81,96712,22950,375975,442185,-66210
917,82,96749,20750,376475,444235,-67760
918,89,96807,24700,376343,445785,-69442
919,88,97008,21050,379775,448243,-68468
920,80,97022,21100,379793,449393,-69600
921,84,97196,22200,385275,451493,-66218
922,90,97227,24750,382843,453093,-70250
923,80,97247,24700,384943,453635,-68692
924,85,97452,27200,386993,454793,-67800
925,89,97548,27400,392943,456543,-63600
926,80,97568,22000,393043,457535,-64492
927,87,97595,25500,395143,458693,-63550
928,86,97607,23650,395475,458485,-63010
929,83,97643,23050,393325,459635,-66310
930,84,97691,25350,394643,461193,-66550
931,88,97989,24200,396525,462285,-65760
932,88,98240,23750,398725,462793,-64068
933,90,98681,25650,400193,465443,-65250
934,80,98831,21550,401743,467685,-65942
935,88,98875,26000,404943,468735,-63792
936,83,98914,19900,404775,469735,-64960
937,81,98985,24750,407625,471435,-63810
938,85,99000,21350,408043,473035,-64992
939,90,99143,24750,408743,474143,-65400
940,90,99247,24750,409793,475293,-65500
941,87,99885,22800,413525,476485,-62960
942,80,99918,19750,415493,477535,-62042
943,84,100004,24450,414525,479643,-65118
944,83,100016,24850,420325,480835,-60510
945,85,100048,23600,420093,481835,-61742
946,89,100060,25150,420143,483143,-63000
947,89,100078,22900,420793,484535,-63742
948,87,100408,26400,421925,486335,-64410
949,90,100421,22050,424525,487985,-63460
950,89,100524,22000,425625,489535,-63910
951,80,100525,24250,427093,490993,-63900
952,87,100547,25050,428743,492285,-63542
953,85,100887,20900,430893,493843,-62950
954,88,101016,26000,434425,495385,-60960
955,85,101078,24950,434925,497485,-62560
956,84,101197,23100,436743,498485,-61742
957,87,101318,22800,439225,500135,-60910
958,89,101365,25600,439343,501135,-61792
959,81,101614,22950,442593,502835,-60242
960,80,101623,22450,441525,504035,-62510
961,81,101640,20700,443125,506043,-62918
962,89,101886,26950,445193,507935,-62742
963,85,102020,23600,448025,509185,-61160
964,88,102022,21500,448525,408991,39534
965,81,102048,20700,448293,410141,38152
966,85,102159,22250,449893,410641,39252
967,81,102335,22500,453175,411241,41934
968,88,102402,25100,451643,411829,39814
969,89,102428,24250,452675,412341,40334
970,82,102460,23450,456893,412841,44052
971,86,102480,22750,455193,413776,41417
972,80,102531,21550,457125,414091,43034
973,85,102693,24050,459375,414779,44596
974,82,103392,21200,460625,415136,45489
975,86,103518,23650,461143,415836,45307
976,89,103787,24700,466975,416333,50642
977,89,103802,26950,465375,417376,47999
978,87,103841,27750,469043,418279,50764
979,80,103935,22450,469693,418926,50767
980,82,104010,23900,469725,419433,50292
981,85,104051,19100,471325,419926,51399
982,82,104184,20750,472475,420579,51896
983,83,104460,25300,474475,420926,53549
984,88,104779,23750,476625,421426,55199
985,82,104809,20750,477175,421926,55249
986,85,104909,21800,479293,422591,56702
987,87,105140,24150,480793,422933,57860
988,81,105174,24750,482143,423433,58710
989,87,105207,24150,481825,424029,57796
990,82,105369,22550,483025,425033,57992
991,84,105650,18600,482893,425583,57310
992,90,105793,27000,484893,426776,58117
993,80,105886,24250,486225,427391,58834
994,90,105903,26100,487825,427891,59934
995,90,106435,24750,488643,428426,60217
996,90,106537,26550,491125,428991,62134
997,85,106549,24500,492125,429541,62584
998,87,106559,22800,494743,430086,64657
999,90,106620,22950,497443,430733,66710
1000,81,106686,21150,500525,431191,69334
1001,80,106693,22450,496975,431691,65284
1002,87,106748,23700,501025,432326,68699
1003,89,106755,23800,501525,432929,68596
1004,86,106940,25000,503175,433929,69246
1005,82,107061,21200,505425,434391,71034
1006,90,107073,25200,505643,434733,70910
1007,82,107356,22100,511525,435541,75984
1008,80,107381,22000,511093,435629,75464
1009,85,107412,24050,508975,436333,72642
1010,85,107441,22700,512093,436833,75260
1011,89,107630,26050,516643,437676,78967
1012,81,107678,24750,516275,438179,78096
1013,86,108010,26800,518193,438886,79307
1014,83,108163,26200,524143,439826,84317
1015,86,108196,24100,524725,440376,84349
1016,87,108220,25950,526093,440941,85152
1017,85,108250,24950,523725,441876,81849
1018,80,108290,20200,527775,442179,85596
1019,81,108318,22950,527793,442679,85114
1020,90,108346,25650,528275,443186,85089
1021,84,108451,21750,529393,443736,85657
1022,87,108467,23250,531075,444329,86746
1023,83,108617,23500,532043,445233,86810
1024,84,108732,25350,533525,445791,87734
1025,90,108912,23850,534625,446833,87792
1026,84,109074,19500,536425,447341,89084
1027,86,109346,25000,538575,447983,90592
1028,84,109387,16800,539093,448126,90967
1029,86,109668,19150,540275,448341,91934
1030,83,109840,23500,542475,448891,93584
1031,88,109936,26450,545025,449683,95342
1032,85,110066,19100,545493,450233,95260
1033,83,110359,23050,548593,450776,97817
1034,80,110433,22450,550943,451236,99707
1035,82,110503,25250,550975,451579,99396
1036,85,110524,21800,551475,452079,99396
1037,80,110632,22900,552125,452626,99499
1038,81,110770,19800,552793,453036,99757
1039,90,110929,22950,558075,453883,104192
1040,90,110989,25200,559675,454586,105089
1041,82,110994,21650,559943,454729,105214
1042,81,111030,23850,559725,455686,104039
1043,89,111232,23800,561375,456279,105096
1044,89,111365,23800,563075,456983,106092
1045,85,111511,20900,565693,457829,107864
1046,84,111670,23100,567975,458476,109499
1047,81,111761,22500,568475,458929,109546
1048,86,111916,23650,571193,459479,111714
1049,89,111968,23350,570775,460083,110692
1050,80,112324,22450,572425,460676,111749
1051,86,112465,20500,573975,461233,112742
1052,89,112596,23350,577643,461786,115857
1053,84,112680,26700,578143,462726,115417
1054,85,112690,22700,577625,462929,114696
1055,88,113052,24200,580925,463929,116996
1056,89,113126,26050,580443,464433,116010
1057,82,113181,18950,581475,465086,116389
1058,81,113486,25650,584025,465629,118396
1059,82,113594,24350,584525,466376,118149
1060,90,113632,23850,587493,466876,120617
1061,87,113740,25050,589225,467336,121889
1062,88,113927,19250,592043,467886,124157
1063,87,113964,19200,591975,468176,123799
1064,88,114158,18800,594125,468726,125399
1065,85,114330,24050,594725,469529,125196
1066,89,114498,25150,597543,470229,127314
1067,85,114503,24950,596775,471279,125496
1068,85,114563,24500,597593,471536,126057
1069,86,114966,23200,601843,472236,129607
1070,86,115015,26800,602225,472829,129396
1071,84,115170,20850,603825,473326,130499
1072,90,115364,26550,605593,474133,131460
1073,87,115398,26850,606725,474633,132092
1074,87,115486,22350,608593,475429,133164
1075,80,115573,22900,610293,475586,134707
1076,83,115573,23950,613743,476041,137702
1077,81,115659,22500,615343,476591,138752
1078,80,115674,23350,615393,476833,138560
1079,90,115861,22500,617125,477336,139789
1080,83,116009,20350,619293,477886,141407
1081,82,116259,21200,620993,478626,142367
1082,84,116402,24450,624293,479126,145167
1083,89,116432,23800,624475,480033,144442
1084,88,116520,26900,626443,481036,145407
1085,89,116592,22450,626425,481676,144749
1086,90,116939,25650,630175,482233,147942
1087,85,116998,27200,631725,483236,148489
1088,88,117062,25100,631343,483876,147467
1089,80,117234,22000,632325,484429,147896
1090,87,117317,21000,634525,484936,149589
1091,90,117318,25650,638793,485626,153167
1092,87,117328,28200,637743,485983,151760
1093,84,117348,21300,639293,485991,153302
1094,84,117543,24450,640943,486541,154402
1095,86,117597,22750,642193,487476,154717
1096,90,117619,25650,642325,487629,154696
1097,90,117753,24750,643793,488679,155114
1098,86,117842,22750,645025,489236,155789
1099,89,117964,25600,646625,490083,156542
1100,89,118053,23800,648143,491241,156902
1101,82,118193,23900,650193,491476,158717
1102,80,118323,22000,652375,492036,160339
1103,81,118327,25650,652743,492891,159852
1104,80,118490,19750,653993,493391,160602
1105,87,118659,23700,655543,494226,161317
1106,85,118717,19100,657525,494336,163189
1107,82,118736,22550,657593,494886,162707
1108,82,118877,21200,659143,495191,163952
1109,80,119266,20200,660143,495386,164757
1110,90,120068,27450,660775,495936,164839
1111,89,120183,24250,663293,497376,165917
1112,85,120274,24050,665025,498091,166934
1113,82,120444,26150,667025,499036,167989
1114,90,120552,22500,669825,499526,170299
1115,87,120604,21900,669793,500026,169767
1116,90,120820,22050,672425,500526,171899
1117,85,121119,26300,676443,501076,175367
1118,90,121125,28800,676825,501783,175042
1119,86,121239,22300,677593,502676,174917
1120,90,121448,28350,683825,503929,179896
1121,86,121479,25450,684875,504629,180246
1122,83,121485,24400,683325,505191,178134
1123,88,121560,23300,686325,505729,180596
1124,81,121613,23850,687993,506533,181460
1125,90,121674,22950,688043,507033,181010
1126,82,121699,20750,688575,507379,181196
1127,84,121897,19050,689575,508133,181442
1128,88,122060,21050,693293,508791,184502
1129,89,122078,22900,693793,509791,184002
1130,86,122314,23650,695025,510229,184796
1131,82,122450,21650,696675,510633,186042
1132,80,122454,22450,698393,511176,187217
1133,83,122492,17650,699675,511391,188284
1134,90,122495,23400,699643,511891,187752
1135,87,122706,25950,700825,512279,188546
1136,80,122817,24250,701743,512879,188864
1137,87,123008,24600,704125,513833,190292
1138,85,123156,23600,705925,513991,191934
1139,83,123159,23500,706693,514991,191702
1140,81,123261,23400,708725,515533,193192
1141,89,123415,24700,715425,516226,199199
1142,87,123461,23700,715893,517129,198764
1143,86,123503,26350,718175,517636,200539
1144,88,123507,21500,718675,518683,199992
1145,85,123593,21800,721975,519236,202739
1146,87,123617,24150,721593,519836,201757
1147,80,123658,21550,721543,521179,200364
1148,89,123731,26050,724243,522076,202167
1149,85,123822,20000,726125,522436,203689
1150,86,123825,19150,726075,522626,203449
1151,82,124177,23450,728793,523036,205757
1152,86,124196,23650,729293,523383,205910
1153,80,124213,25600,729375,524379,204996
1154,82,124335,19400,731075,524636,206439
1155,80,124492,21100,732093,525191,206902
1156,81,124851,22050,734325,525483,208842
1157,80,124928,21550,734693,525691,209002
1158,88,125007,28250,736825,527033,209792
1159,85,125243,24500,737975,527776,210199
1160,87,125389,25500,741225,528179,213046
1161,85,125439,21800,743075,528836,214239
1162,90,125503,26100,742643,529383,213260
1163,82,125591,19850,743643,529779,213864
1164,83,125613,19000,745043,530476,214567
1165,90,125632,24750,745325,530976,214349
1166,80,125847,23350,749693,531433,218260
1167,85,125915,20900,749525,531933,217592
1168,90,125953,25200,751343,533026,218317
1169,88,126068,25550,752893,533533,219360
1170,81,126174,19350,754093,533841,220252
1171,83,126366,21700,755275,534441,220834
1172,90,126749,26100,758375,535176,223199
1173,89,126760,25600,756293,535641,220652
1174,86,126768,23200,757893,535886,222007
1175,81,126884,22050,760725,536626,224099
1176,88,126898,26900,760693,537279,223414
1177,90,127282,22050,762625,537779,224846
1178,82,127347,19850,763125,538329,224796
1179,85,127740,24000,764493,538686,225807
1180,90,127761,20350,577936,539186,38750
1181,82,127965,22250,580140,539686,40454
1182,81,128027,19100,579836,540186,39650
1183,84,128215,21350,581140,541629,39511
1184,86,128297,22800,582586,541986,40600
1185,86,128330,21750,583990,542779,41211
1186,82,128605,23700,584990,542986,42004
1187,82,129066,18500,585990,543976,42014
1188,82,129195,19500,586536,544479,42057
1189,85,129249,21000,588040,545441,42599
1190,86,129371,23800,589736,545783,43953
1191,87,129505,25000,595436,547041,48395
1192,82,129535,19250,595490,547236,48254
1193,89,129695,22450,596740,548041,48699
1194,83,129864,17350,597736,548436,49300
1195,89,130243,21900,599640,548986,50654
1196,87,130244,20950,604586,549529,55057
1197,80,130320,18200,602336,550533,51803
1198,87,130339,26950,606540,551083,55457
1199,87,130408,21650,606136,551686,54450
1200,84,130702,15100,607736,552186,55550
1201,82,130760,21400,611386,552736,58650
1202,89,130770,18250,610240,552991,57249
1203,81,130790,20400,611790,553236,58554
1204,90,130905,19550,613490,554091,59399
1205,88,130996,20800,615736,554583,61153
1206,87,131036,18450,619086,555029,64057
1207,85,131119,22000,621786,555529,66257
1208,81,131123,17600,622490,556041,66449
1209,83,131140,21650,622786,556876,65910
1210,87,131168,19600,621990,557686,64304
1211,90,131423,23900,624540,558376,66164
1212,88,131973,19200,628686,558933,69753
1213,81,131976,21250,628740,559426,69314
1214,87,132280,20650,629890,559941,69949
1215,87,132455,17350,631586,560541,71045
1216,84,132685,20500,632586,561086,71500
1217,90,132855,23100,633540,561733,71807
1218,81,133243,21250,638690,562136,76554
1219,85,133258,24150,638736,562726,76010
1220,86,133290,20550,639190,563283,75907
1221,88,133411,22000,640240,564179,76061
1222,86,133486,20800,641536,564436,77100
1223,81,133496,18600,642090,564833,77257
1224,82,133753,18350,643236,565636,77600
1225,84,133812,24150,645786,565833,79953
1226,85,133820,19400,647386,565626,81760
1227,85,133944,18750,648790,566333,82457
1228,84,134118,19000,650490,566686,83804
1229,89,134329,22550,652190,567186,85004
1230,81,134371,18400,655040,567686,87354
1231,84,134423,20700,655036,567891,87145
1232,88,134644,24250,656236,568283,87953
1233,83,134960,17350,657890,568426,89464
1234,86,135039,23700,658890,569079,89811
1235,81,135140,16850,660890,569786,91104
1236,81,135222,17300,660936,570386,90550
1237,87,135406,20750,667936,571091,96845
1238,83,135436,17500,667940,571636,96304
1239,81,135436,17200,667986,572186,95800
1240,84,135489,21650,669136,572533,96603
1241,83,135537,21600,669490,572941,96549
1242,87,135719,18400,670740,573576,97164
1243,83,135738,20050,671486,573583,97903
1244,82,135867,18100,673590,574141,99449
1245,86,135882,20100,674736,574683,100053
1246,88,136000,22850,675740,575436,100304
1247,88,136085,20900,676886,575929,100957
1248,89,136203,21600,679186,576883,102303
1249,80,136412,24100,680490,577479,103011
1250,81,136495,20900,682240,578029,104211
1251,90,136624,23900,765675,578491,187184
1252,82,136764,20300,766843,578926,187917
1253,81,136796,23400,768875,579641,189234
1254,89,137045,20200,769543,579976,189567
1255,84,137268,20400,772925,580679,192246
1256,81,137337,24300,773093,581141,191952
1257,88,137662,24650,775493,581641,193852
1258,89,137671,26050,775625,582429,193196
1259,87,137823,21450,777275,583036,194239
1260,87,138075,22800,779525,583391,196134
1261,80,138311,22000,780725,583586,197139
1262,84,138517,26250,785143,584086,201057
1263,85,138601,20450,784475,584991,199484
1264,90,138602,23850,789443,585433,204010
1265,81,138617,20250,789625,586136,203489
1266,83,138657,24400,789543,587126,202417
1267,84,138886,25800,790775,587479,203296
1268,81,139237,22050,795443,588241,207202
1269,81,139278,25200,795475,588791,206684
1270,80,139322,18850,794975,589291,205684
1271,80,139499,22000,797043,589729,207314
1272,89,139874,26050,798693,590279,208414
1273,82,139997,19400,799893,590583,209310
1274,87,140059,21000,805725,591491,214234
1275,85,140063,24050,806093,592036,214057
1276,90,140101,24750,804525,592276,212249
1277,88,140111,22850,806593,592629,213964
1278,80,140337,19750,809025,592736,216289
1279,84,140409,22200,809443,593376,216067
1280,81,140494,22500,810143,593083,217060
1281,89,140646,26950,813225,572537,240688
1282,85,140799,21350,816075,572842,243233
1283,80,140818,19300,816125,573342,242783
1284,85,140845,23150,816093,573737,242356
1285,82,140937,23450,816693,574641,242052
1286,85,141024,29450,818775,575236,243539
1287,86,141286,22300,818893,574837,244056
1288,85,141579,20900,822275,532730,289545
1289,80,141663,22000,824043,533086,290957
1290,83,141687,24400,822775,533636,289139
1291,86,141714,24550,824543,534237,290306
1292,84,141864,26250,826643,534636,292007
1293,81,141888,22500,828325,535380,292945
1294,82,142018,24800,829443,536136,293307
1295,86,142149,26800,831475,536736,294739
1296,86,142179,19150,836043,537189,298854
1297,83,142204,24400,836525,538037,298488
1298,88,142230,23300,836593,538389,298204
1299,87,142401,22350,837625,538989,298636
1300,88,142501,23300,840243,539687,300556
1301,85,142550,25850,843143,540337,302806
1302,89,142597,24250,842593,541280,301313
1303,81,142745,23850,844625,541780,302845
1304,80,142867,23350,846875,542689,304186
1305,88,142893,27800,848993,543830,305163
1306,84,142909,25800,850025,544736,305289
1307,89,143028,22000,850843,545480,305363
1308,88,143068,23300,852593,545737,306856
1309,82,143151,25250,853693,546336,307357
1310,85,143257,25850,856993,546837,310156
1311,90,143291,24300,857225,547337,309888
1312,88,143422,20600,858325,547887,310438
1313,80,143517,22000,859075,548486,310589
1314,83,143555,22600,860343,549037,311306
1315,80,143558,23800,861875,550087,311788
1316,88,143612,23300,784040,550637,233403
1317,80,143653,21550,784540,550739,233801
1318,87,143807,23700,786140,551137,235003
1319,84,143866,21750,788536,551430,237106
1320,81,144086,27900,789990,552437,237553
1321,86,144327,21850,790640,552987,237653
1322,89,144384,24250,791140,553537,237603
1323,84,144564,24900,793790,554130,239660
1324,89,144625,21550,794186,554636,239550
1325,85,144732,23600,795240,554839,240401
1326,83,144879,21250,796340,555136,241204
1327,89,145019,19750,797086,555636,241450
1328,80,145128,22450,798140,555930,242210
1329,85,145244,21800,800740,556389,244351
1330,90,145347,23850,802786,557230,245556
1331,89,145390,26500,803986,558237,245749
1332,81,145538,20700,804490,559236,245254
1333,87,145574,21450,806690,559489,247201
1334,87,145666,22350,806836,560387,246449
1335,90,145779,22950,808036,560586,247450
1336,81,145919,21600,809690,561080,248610
1337,90,145923,27000,814640,561537,253103
1338,81,145940,27000,814986,562089,252897
1339,86,146002,22750,814486,562686,251800
1340,90,146054,23850,816390,563687,252703
1341,83,146150,22600,817636,564286,253350
1342,81,146235,21600,819186,564930,254256
1343,83,146253,25300,820340,565437,254903
1344,89,146277,28750,825136,565937,259199
1345,84,146303,23100,822586,566436,256150
1346,90,146334,28800,824640,566936,257704
1347,90,146385,20700,825740,567389,258351
1348,84,146571,20850,826790,567636,259154
1349,84,146721,19950,828686,568087,260599
1350,85,146855,24500,831936,569187,262749
1351,86,146855,25450,831436,569780,261656
1352,89,146957,25150,832836,570687,262149
1353,90,147019,27450,833487,571287,262200
1354,81,147044,23400,835091,572037,263054
1355,85,147089,24500,835591,572480,263111
1356,85,147125,25850,835687,572980,262707
1357,80,147506,20650,835936,573387,262549
1358,81,147813,19350,836937,573980,262957
1359,84,147824,23100,837791,574587,263204
1360,84,147913,24450,838041,575137,262904
1361,89,147933,26500,838591,575636,262955
1362,80,147958,22000,838487,576136,262351
1363,89,148078,24250,839087,576686,262401
1364,86,148097,25000,839637,576987,262650
1365,87,148154,20550,841189,577880,263309
1366,80,148192,18850,840841,578089,262752
1367,87,148192,20100,841337,578737,262600
1368,84,148293,23550,841586,579337,262249
1369,86,148688,25900,842789,579987,262802
1370,86,148706,25450,843641,580639,263002
1371,86,148920,22750,843837,581080,262757
1372,87,148948,23700,845391,581937,263454
1373,83,148981,25750,845386,582686,262700
1374,82,149630,24800,846891,583239,263652
1375,85,149724,20450,847089,584087,263002
1376,87,149820,23250,847041,584780,262261
1377,80,149895,20650,847739,584837,262902
1378,89,150112,22450,848239,585437,262802
1379,88,150249,24650,849237,586039,263198
1380,87,150266,25500,849691,586636,263055
1381,84,150301,23550,850191,587139,263052
1382,83,150383,20350,850191,587689,262502
1383,89,150466,25150,851189,588287,262902
1384,84,150491,19500,851341,588887,262454
1385,88,150555,22400,852041,589487,262554
1386,81,150711,23850,852786,590230,262556
1387,85,150807,20450,853286,590730,262556
1388,85,150942,22700,854089,591539,262550
1389,89,151065,25150,854486,591880,262606
1390,86,151313,25450,854986,592587,262399
1391,82,151380,22100,855486,592887,262599
1392,81,151502,25650,856586,593387,263199
1393,82,151597,21650,856541,594439,262102
1394,81,151607,26550,857041,595237,261804
1395,89,151650,24700,857736,596437,261299
1396,86,151676,28150,859391,596987,262404
1397,82,151685,23900,858637,597589,261048
1398,89,151759,22450,859637,598230,261407
1399,87,151997,24600,859891,598730,261161
1400,82,152107,19850,860341,599189,261152
1401,87,152274,24600,860636,599436,261200
1402,81,152350,19800,861636,600130,261506
1403,87,152438,24600,861591,600889,260702
1404,81,152483,18000,862191,601537,260654
1405,86,152640,23650,863341,602086,261255
1406,80,152647,22450,863191,602680,260511
1407,90,152801,22950,864237,603837,260400
1408,86,152843,25000,864639,604337,260302
1409,83,152932,21250,865139,604787,260352
1410,82,153034,24350,866789,605287,261502
1411,81,153074,20700,865886,605787,260099
1412,90,153086,28350,867586,606330,261256
1413,88,153165,27350,867289,606989,260300
1414,81,153340,22050,868337,607587,260750
1415,89,153464,27850,868887,608836,260051
1416,80,153499,20650,869041,609137,259904
1417,85,153568,26300,869487,610030,259457
1418,87,153788,22800,869987,610630,259357
1419,90,153788,20700,870136,611036,259100
1420,84,153851,24900,870786,611730,259056
1421,82,153915,20300,871089,612337,258752
1422,89,154156,22000,871841,613336,258505
1423,87,154299,23700,873836,614237,259599
1424,85,154344,26300,873437,614989,258448
1425,81,154345,22050,873889,615580,258309
1426,84,154396,20400,873791,616037,257754
1427,84,154540,23550,875537,616587,258950
1428,84,154541,19950,875291,617189,258102
1429,88,154563,26450,875441,618037,257404
1430,82,154861,19400,876491,619087,257404
1431,83,154901,23050,876491,619837,256654
1432,82,155020,18500,876687,620337,256350
1433,90,155107,24300,879237,620939,258298
1434,88,155125,24200,878187,621580,256607
1435,83,155188,26200,879337,622887,256450
1436,83,155251,23050,879539,623487,256052
1437,85,155674,26300,880091,624080,256011
1438,85,155724,24950,881486,624539,256947
1439,87,155751,22800,881239,624630,256609
1440,86,156101,22750,881986,625136,256850
1441,90,156225,27900,882737,626180,256557
1442,80,156346,21550,883191,627089,256102
1443,80,156376,26500,883691,627687,256004
1444,84,156427,23550,885939,628187,257752
1445,85,156448,21350,885986,628486,257500
1446,90,156468,26550,885737,628987,256750
1447,83,156635,21700,886439,629839,256600
1448,82,156955,25250,887039,630636,256403
1449,81,157015,23400,887686,631686,256000
1450,81,157143,22500,887937,632087,255850
1451,90,157265,24750,888437,585188,303249
1452,81,157412,22500,889736,585991,303745
1453,84,157439,24450,889789,586238,303551
1454,90,157545,22950,890191,587141,303050
1455,89,157575,24700,890637,587896,302741
1456,90,157625,22950,891439,588388,303051
1457,83,157679,24850,891886,588993,302893
1458,81,157840,21600,892887,589746,303141
1459,80,157856,24250,892936,590341,302595
1460,83,158167,23950,893436,591038,302398
1461,81,158381,22050,893986,591491,302495
1462,89,158556,25150,894536,592088,302448
1463,88,158810,25100,894937,592440,302497
1464,89,159008,28300,896037,592990,303047
1465,87,159019,21900,895691,593893,301798
1466,81,159067,24300,896537,594241,302296
1467,85,159254,23150,897086,594846,302240
1468,80,159447,20200,897989,595291,302698
1469,88,159580,27350,898736,595946,302790
1470,81,159723,22500,899491,596941,302550
1471,87,160026,20100,899886,597438,302448
1472,86,160061,24100,900287,597693,302594
1473,80,160064,20200,900691,598241,302450
1474,89,160123,22450,901291,598840,302451
1475,80,160130,22900,902537,599493,303044
1476,90,160186,25200,902889,599990,302899
1477,88,160306,23300,904691,600990,303701
1478,85,160339,26300,905486,602788,302698
1479,82,160374,21200,905536,603338,302198
1480,88,160408,26450,906036,604241,301795
1481,90,160433,21600,906887,604938,301949
1482,87,160531,23700,907136,605741,301395
1483,81,160532,22050,906741,606241,300500
1484,87,160754,24600,907241,606841,300400
1485,87,160854,22800,907589,607240,300349
1486,85,160905,22250,908041,607588,300453
1487,84,161079,19500,908637,608491,300146
1488,83,161269,25750,909137,608546,300591
1489,81,161669,21600,909489,609141,300348
1490,86,161707,22750,909637,609691,299946
1491,86,161828,24100,910536,610240,300296
1492,87,161885,22350,912441,610638,301803
1493,80,161912,18400,912841,611043,301798
1494,89,161944,23800,913336,611341,301995
1495,86,162010,25000,913341,611540,301801
1496,83,162306,21700,914089,611996,302093
1497,81,162407,19350,915541,612693,302848
1498,84,162434,21750,915486,612891,302595
1499,80,162658,22000,916489,613640,302849
1500,84,162706,22200,916287,614493,301794
1501,80,162784,22450,916841,614738,302103
1502,90,162999,28800,918191,615691,302500
1503,84,163349,22650,918887,616288,302599
1504,80,163374,20200,918689,616840,301849
1505,88,163494,25550,836940,617841,219099
1506,83,163590,22150,841090,618096,222994
1507,86,163657,26350,839836,618488,221348
1508,83,163661,24850,840836,619096,221740
1509,82,163673,20750,842686,619440,223246
1510,86,163710,23200,842340,619743,222597
1511,89,163891,24250,844040,620440,223600
1512,80,164082,23350,852040,620788,231252
1513,90,164119,22950,847836,621438,226398
1514,81,164172,26100,849390,622290,227100
1515,87,164172,27750,852036,622790,229246
1516,87,164459,25050,854740,623290,231450
1517,83,164466,22600,854486,623896,230590
1518,87,164582,21450,855686,624340,231346
1519,80,164697,24700,857840,625193,232647
1520,82,164829,25700,859390,626193,233197
1521,87,165317,25050,860490,626546,233944
1522,90,165429,22050,863786,627543,236243
1523,88,165454,27800,861690,628546,233144
1524,80,165470,24250,864190,629288,234902
1525,82,165593,21650,865836,630046,235790
1526,81,165630,22950,866986,630488,236498
1527,90,165673,23400,868190,630793,237397
1528,86,165784,23200,871686,631488,240198
1529,90,165844,25650,873036,632443,240593
1530,88,165867,26000,873086,633091,239995
1531,83,165936,21250,873586,633643,239943
1532,80,166203,25150,875990,633746,242244
1533,89,166233,23800,876736,634296,242440
1534,86,166350,25450,879290,634946,244344
1535,90,166415,26100,882336,635638,246698
1536,80,166469,25600,882040,636443,245597
1537,80,166700,23350,884190,637140,247050
1538,89,166774,22450,885290,637640,247650
1539,81,166827,21150,887136,637841,249295
1540,86,166842,23650,887390,638438,248952
1541,89,167022,23350,891836,638690,253146
1542,82,167094,19400,889686,639143,250543
1543,90,167101,22950,892336,639740,252596
1544,85,167202,20900,893986,640588,253398
1545,83,167399,23950,894586,640840,253746
1546,88,167461,24200,896190,641391,254799
1547,80,167598,21550,898536,641546,256990
1548,86,167664,23200,898790,642043,256747
1549,87,167867,27300,901590,642543,259047
1550,84,167915,19950,901736,642888,258848
1551,84,168081,22200,904890,643440,261450
1552,85,168118,23150,904886,643990,260896
1553,89,168330,22000,907690,644196,263494
1554,86,168336,24100,908086,644490,263596
1555,87,168855,25050,910786,645041,265745
1556,80,168916,22450,911836,645988,265848
1557,83,169025,20350,912640,646293,266347
1558,81,169050,18450,913140,646896,266244
1559,81,169234,25200,915440,647396,268044
1560,84,169272,22650,919143,647943,271200
1561,88,169314,21500,919186,648096,271090
1562,82,169370,23000,919341,648340,271001
1563,85,169464,23150,919686,648993,270693
1564,90,169481,27000,920643,649538,271105
1565,81,169552,25650,920489,650143,270346
1566,83,169585,24400,921041,650991,270050
1567,85,169757,24950,923636,651643,271993
1568,90,169766,23850,924487,652091,272396
1569,80,169828,19300,924089,652646,271443
1570,80,169854,22000,923541,653146,270395
1571,87,169865,24150,924589,654190,270399
1572,82,170141,21650,925089,654841,270248
1573,83,170214,21700,926139,655341,270798
1574,83,170299,24850,926737,655796,270941
1575,80,170347,21550,926741,656543,270198
1576,86,170391,21850,926693,657140,269553
1577,89,170843,23800,927741,657441,270300
1578,81,170955,21150,927839,658043,269796
1579,84,170955,25800,928539,658896,269643
1580,82,171084,16250,928941,659041,269900
1581,82,171228,18500,929387,659541,269846
1582,87,171328,23250,930536,659943,270593
1583,90,171380,22050,930893,660196,270697
1584,80,171609,21550,931691,660340,271351
1585,90,171626,25650,932393,661388,271005
1586,89,171826,27850,933587,662243,271344
1587,80,171874,23350,933593,662488,271105
1588,88,171954,20150,935187,662890,272297
1589,84,171985,24900,935189,663490,271699
1590,87,172010,22800,934986,664040,270946
1591,81,172129,24750,937439,664646,272793
1592,83,172132,23950,935893,665143,270750
1593,85,172179,24500,936641,665888,270753
1594,80,172197,20200,937191,666246,270945
1595,87,172204,25050,937939,667038,270901
1596,84,172218,22200,938391,667393,270998
1597,83,172317,25750,938387,668341,270046
1598,87,172485,24150,940041,668840,271201
1599,84,172516,22200,940043,669446,270597
1600,87,172559,24150,940189,670446,269743
1601,87,172757,21000,940887,671041,269846
1602,81,172965,22050,941636,672041,269595
1603,88,173014,22400,942186,672243,269943
1604,84,173175,23100,942437,672743,269694
1605,81,173225,20700,942987,673091,269896
1606,81,173324,19350,943537,673641,269896
1607,88,173532,22850,945287,673996,271291
1608,90,173556,27900,945386,674546,270840
1609,81,173573,27000,945143,675138,270005
1610,81,173870,21150,920836,675691,245145
1611,88,173939,21050,922186,676188,245998
1612,81,173940,22050,922540,676740,245800
1613,84,174134,24000,924190,677393,246797
1614,84,174328,28050,927036,678338,248698
1615,80,174387,23350,927536,678393,249143
1616,88,174503,25550,930836,667632,263204
1617,80,174519,20650,929990,668632,261358
1618,81,174562,23850,930640,669125,261515
1619,83,174688,24400,932240,669722,262518
1620,86,174867,20950,934990,669943,265047
1621,84,174964,22650,935336,670488,264848
1622,88,175108,20150,937086,670675,266411
1623,84,175345,22200,938636,671432,267204
1624,85,175587,24950,940790,672238,268552
1625,81,175643,19800,941840,672943,268897
1626,88,175703,23750,942340,673493,268847
1627,88,175965,28700,943840,673993,269847
1628,83,176053,19900,944736,674322,270414
1629,83,176423,22150,946193,674588,271605
1630,85,176496,21350,946543,675032,271511
1631,81,176652,22950,946837,675193,271644
1632,83,176879,25300,947293,675793,271500
1633,90,176925,24750,947839,676422,271417
1634,82,177140,23000,948487,676922,271565
1635,80,177211,22450,948987,677138,271849
1636,83,177371,28000,949589,677832,271757
1637,89,177515,24700,950543,678393,272150
1638,85,177612,20450,950536,679888,270648
1639,80,177876,22900,951043,680438,270605
1640,89,178162,24700,952086,680672,271414
1641,87,178271,25500,952737,681588,271149
1642,84,178400,22650,953337,682222,271115
1643,84,178487,22650,953243,682932,270311
1644,81,178603,23850,953743,683593,270150
1645,80,178650,23800,953839,684372,269467
1646,81,178737,21150,953486,684972,268514
1647,84,178741,22200,953740,686072,267668
1648,86,178765,25000,954440,686825,267615
1649,87,178825,26400,958190,687825,270365
1650,89,178858,23800,958186,687888,270298
1651,82,178873,26150,956836,688172,268664
1652,82,178886,22100,958686,689025,269661
1653,89,179047,21550,960286,690032,270254
1654,89,179182,22450,964986,690588,274398
1655,81,179245,22950,966536,691182,275354
1656,89,179277,19300,965040,691525,273515
1657,80,179310,22000,966640,691972,274668
1658,84,179364,24450,967036,692972,274064
1659,90,179403,27450,706028,693522,12506
1660,89,179407,22900,706081,694022,12059
1661,81,179409,19350,705972,694893,11079
1662,89,179534,27850,707022,695538,11484
1663,90,179582,27900,707628,696432,11196
1664,84,179710,25800,711272,697138,14134
1665,88,179721,26000,711497,697982,13515
1666,85,179723,22700,711681,698372,13309
1667,89,179730,26500,709672,699532,10140
1668,89,179775,22900,712628,699993,12635
1669,88,179801,26900,710997,700638,10359
1670,85,179844,24050,713433,700932,12501
1671,80,179878,20650,713281,702075,11206
1672,81,179974,22500,713872,702575,11297
1673,80,179978,18850,716497,703288,13209
1674,81,180022,24300,714872,703625,11247
1675,88,180022,24650,716172,704032,12140
1676,83,180039,20350,716131,704593,11538
1677,87,180041,27300,716631,705225,11406
1678,85,180267,24500,717131,705875,11256
1679,87,180396,23700,718583,706272,12311
1680,88,180428,27350,719047,707093,11954
1681,85,180432,27650,719083,707638,11445
1682,87,180616,24150,720678,707925,12753
1683,88,180628,26450,720431,708475,11956
1684,86,180686,25450,720972,709288,11684
1685,87,180880,22350,721472,709972,11500
1686,81,181039,25200,722278,709975,12303
1687,85,181103,23150,723231,710443,12788
1688,80,181147,19750,723883,710782,13101
1689,90,181241,25650,724231,711438,12793
1690,83,181254,19000,724078,711143,12935
1691,81,181360,19800,725083,712172,12911
1692,86,181829,25000,725381,713032,12349
1693,82,181956,22100,725778,713532,12246
1694,85,182254,25400,726733,714275,12458
1695,88,182326,24200,726378,715572,10806
1696,83,182340,23500,727378,716088,11290
1697,82,182343,22100,728572,716382,12190
1698,89,182349,21550,728631,717025,11606
1699,83,182548,26200,730172,718322,11850
1700,83,182559,22150,730181,718943,11238
1701,89,182574,26050,730028,719932,10096
1702,80,182812,18850,731078,720175,10903
1703,88,182819,25550,731781,721072,10709
1704,88,183022,29600,732178,722082,10096
1705,86,183116,26350,732397,722225,10172
1706,80,183116,23350,734478,723275,11203
1707,89,183125,23800,733472,724293,9179
1708,89,183134,26950,733928,724782,9146
1709,90,183147,23400,734481,725675,8806
1710,81,183244,23400,734972,726538,8434
1711,89,183389,25600,736722,726993,9729
1712,82,183424,23900,736081,727722,8359
1713,83,183433,26200,736728,728482,8246
1714,83,183739,19450,737222,729032,8190
1715,84,183802,27150,739281,729338,9943
1716,88,183896,23750,738322,729838,8484
1717,82,183897,23900,739297,730643,8654
1718,83,184050,23050,740281,731572,8709
1719,89,184051,25150,740672,732282,8390
1720,82,184082,24350,741222,732743,8479
1721,88,184195,26450,742128,734032,8096
1722,86,184246,26800,742881,734293,8588
1723,82,184584,26600,743397,734738,8659
1724,87,184767,23250,743783,735325,8458
1725,80,184883,22000,745328,735838,9490
1726,87,184918,23700,745422,736172,9250
1727,89,184927,24700,745631,736672,8959
1728,89,184959,24250,745733,737172,8561
1729,85,185228,25850,747778,738025,9753
1730,88,185267,20600,748478,738482,9996
1731,87,185292,25050,747728,738843,8885
1732,80,185324,24700,748222,739338,8884
1733,89,185352,24700,748881,739393,9488
1734,82,185560,21200,749431,739875,9556
1735,86,185702,23200,749983,740425,9558
1736,80,185749,20650,752728,740872,11856
1737,80,185757,23800,752833,741543,11290
1738,81,185804,23850,753047,742225,10822
1739,81,185804,24750,753081,742725,10356
1740,84,185984,20400,754731,742982,11749
1741,85,185993,23150,754983,743793,11190
1742,85,186047,22700,754697,744293,10404
1743,84,186139,24000,755428,745072,10356
1744,84,186203,21300,756478,745622,10856
1745,85,186216,24950,756872,746188,10684
1746,81,186303,23400,757922,746993,10929
1747,81,186319,23400,758331,747375,10956
1748,80,186432,19750,758947,747875,11072
1749,88,186523,24200,759172,748525,10647
1750,89,186752,26050,760128,748788,11340
1751,88,186806,25550,760631,748943,11688
1752,90,186882,24750,760628,749682,10946
1753,90,187097,24750,762081,750182,11899
1754,80,187171,19300,762178,751025,11153
1755,83,187183,19900,762631,751643,10988
1756,84,187280,22650,764122,751338,12784
1757,85,187307,26300,763731,752675,11056
1758,89,187379,22900,764228,753243,10985
1759,88,187566,20150,764772,753675,11097
1760,80,187839,24700,765372,753872,11500
1761,85,187956,22700,765947,754282,11665
1762,81,187978,24300,767047,755188,11859
1763,82,188044,21650,766833,755475,11358
1764,84,188142,24000,767178,755975,11203
1765,84,188250,21300,767647,756975,10672
1766,86,188501,25900,768181,757572,10609
1767,83,188724,23500,769647,758572,11075
1768,87,188788,24600,770222,759375,10847
1769,83,188840,21700,770778,760182,10596
1770,87,188896,26850,771733,760793,10940
1771,80,188962,23350,771778,761343,10435
1772,81,189073,22050,772328,761943,10385
1773,80,189161,22000,773147,762838,10309
1774,84,189190,26250,774431,763482,10949
1775,86,189200,23200,774378,763982,10396
1776,80,189294,21100,774928,764593,10335
1777,86,189475,25900,778431,764982,13449
1778,87,189477,26400,778478,765693,12785
1779,90,189525,24750,776678,766375,10303
1780,83,189549,18100,777122,767088,10034
1781,89,189565,25600,779033,767688,11345
1782,88,189569,25550,779197,768443,10754
1783,85,189650,23150,779222,768882,10340
1784,90,189889,21600,781178,769322,11856
1785,84,189894,27150,781222,770322,10900
1786,86,190010,26350,781681,771322,10359
1787,89,190170,26050,782272,771938,10334
1788,89,190464,22450,782872,772682,10190
1789,87,190782,28200,784047,773025,11022
1790,82,190835,20300,783872,773572,10300
1791,85,190891,23600,784522,774282,10240
1792,82,191054,22550,785733,775375,10358
1793,82,191140,22100,785522,776243,9279
1794,90,191399,27900,785978,777038,8940
1795,87,191430,24150,786522,777538,8984
1796,88,191510,21950,788228,778272,9956
1797,88,191519,26000,787522,778925,8597
1798,80,191566,20650,788033,779088,8945
1799,85,191620,21350,788631,779482,9149
1800,80,191731,25600,789583,780525,9058
1801,90,191862,31500,790831,781032,9799
1802,85,191864,24050,790772,781682,9090
1803,89,191966,22450,792028,782275,9753
1804,86,191966,21850,792097,782443,9654
1805,80,192162,22000,792431,783332,9099
1806,80,192252,22900,792983,784022,8961
1807,86,192313,26800,793431,784832,8599
1808,90,192370,26100,794431,785738,8693
1809,87,192370,25050,795178,786072,9106
1810,83,192501,25750,796228,786793,9435
1811,88,192509,26000,796131,787238,8893
1812,84,192544,26700,796447,788122,8325
1813,81,192644,23400,797072,789122,7950
1814,80,193092,17500,797833,789622,8211
1815,82,193206,25250,798481,790122,8359
1816,90,193352,25650,798933,791175,7758
1817,88,193506,23750,799322,791643,7679
1818,80,193697,19750,800747,792522,8225
1819,80,193717,18850,800922,792888,8034
1820,86,193880,25000,801881,793725,8156
1821,90,193897,25650,802178,794275,7903
1822,90,194028,25200,803522,795143,8379
1823,89,194107,24250,803481,796082,7399
1824,80,194275,24250,803997,797088,6909
1825,83,194310,26200,804481,797322,7159
1826,81,194332,22050,804622,798343,6279
1827,87,194641,23250,805622,798843,6779
1828,82,194723,22100,805481,799375,6106
1829,90,194825,24300,806178,800072,6106
1830,84,195043,21300,807581,800388,7193
1831,84,195054,22200,807033,800938,6095
1832,83,195103,23050,807681,801332,6349
1833,83,195172,23050,808672,801588,7084
1834,84,195264,22200,809728,802088,7640
1835,86,195302,29050,809683,802382,7301
1836,88,195439,23750,811978,803275,8703
1837,85,195475,24500,812431,803893,8538
1838,90,195504,24300,812383,804393,7990
1839,87,195646,25500,813328,804982,8346
1840,90,195720,22050,813031,805993,7038
1841,85,195802,18650,814181,806225,7956
1842,89,195817,21100,814197,806988,7209
1843,80,195870,21550,814528,807422,7106
1844,87,195996,25050,815831,808093,7738
1845,85,196021,25400,816331,808972,7359
1846,80,196049,22000,816833,809093,7740
1847,86,196124,22750,816831,809432,7399
1848,80,196187,20650,817778,809693,8085
1849,80,196266,21550,817483,810082,7401
1850,87,196270,22350,817278,810632,6646
1851,83,196315,24400,819283,811293,7990
1852,82,196368,27050,819333,811843,7490
1853,81,196388,20700,819372,812182,7190
1854,83,196466,20800,819833,812475,7358
1855,86,196656,23200,820597,813343,7254
1856,85,196727,21350,821597,813843,7754
1857,85,196862,20900,822331,814182,8149
1858,86,196892,25450,823178,814538,8640
1859,82,197154,19850,825628,814625,11003
1860,90,197156,24300,826083,815088,10995
1861,88,197156,26000,826128,815322,10806
1862,90,197182,22500,826422,816275,10147
1863,81,197331,21150,826733,816893,9840
1864,85,197332,22250,827081,817532,9549
1865,90,197473,22500,828522,818393,10129
1866,89,197518,23800,827397,818538,8859
1867,84,197523,21300,829197,818943,10254
1868,84,197548,20850,829672,819638,10034
1869,84,197599,21300,829022,820622,8400
1870,87,197602,23700,830831,821172,9659
1871,83,197663,24850,830528,821938,8590
1872,82,197668,18950,830872,822272,8600
1873,90,197767,26100,831028,823225,7803
1874,89,197963,25600,831547,823693,7854
1875,83,198077,23050,832472,824088,8384
1876,83,198180,23050,834747,824475,10272
1877,85,198204,21350,834883,825232,9651
1878,81,198222,25650,834928,825975,8953
1879,86,198242,20050,834431,826343,8088
1880,88,198510,22400,837522,826882,10640
1881,81,198546,23850,837547,827382,10165
1882,86,198581,27700,837483,827932,9551
1883,87,198770,23700,838381,828343,10038
1884,86,198893,23650,839572,828893,10679
1885,90,198943,27000,839583,829443,10140
1886,88,199323,18800,840578,829888,10690
1887,88,199355,23300,841131,830375,10756
1888,80,199453,23800,840697,830988,9709
1889,86,199532,25900,841631,831822,9809
1890,88,199750,26000,842781,832093,10688
1891,81,199781,20700,842433,832972,9461
1892,89,200010,22450,843497,833025,10472
1893,80,200484,20200,844431,833243,11188
1894,90,200515,22050,844472,833972,10500
1895,83,200917,23050,846197,834943,11254
1896,90,200970,22050,845181,835632,9549
1897,84,200981,24450,845883,836175,9708
1898,83,201015,22150,845931,836675,9256
1899,83,201197,21700,846697,837543,9154
1900,87,201413,24600,847022,837888,9134
1901,80,201555,19750,847483,838388,9095
1902,81,201749,22050,848747,839172,9575
1903,80,201801,18850,848722,839832,8890
1904,85,201913,19100,850178,840588,9590
1905,87,201990,26850,850728,841293,9435
1906,82,202062,21650,851031,842272,8759
1907,81,202210,21150,851597,842975,8622
1908,82,202334,22100,852147,843338,8809
1909,90,202353,23400,852578,843893,8685
1910,80,202539,23350,853747,844125,9622
1911,86,202603,20500,853483,844632,8851
1912,83,203039,22150,854328,845543,8785
1913,88,203172,24650,854828,846043,8785
1914,82,203366,21200,855822,846543,9279
1915,87,203536,23250,856778,847322,9456
1916,90,203632,25200,858531,848338,10193
1917,89,203699,24250,857197,849122,8075
1918,87,203714,23250,858578,849425,9153
1919,83,203727,23050,858797,850088,8709
1920,84,203834,23550,859081,851032,8049
1921,86,203949,22750,861081,851688,9393
1922,87,203992,21900,860683,852325,8358
1923,80,204015,22000,861022,852875,8147
1924,90,204154,26100,862883,854182,8701
1925,81,204245,22950,862831,854493,8338
1926,87,204293,26850,864247,855572,8675
1927,86,204330,23200,864381,856538,7843
1928,83,204451,22600,865772,857122,8650
1929,83,204488,19900,865728,857693,8035
1930,83,204732,21250,867533,858172,9361
1931,86,204758,27700,867872,858725,9147
1932,89,204793,27400,867481,859338,8143
1933,90,205023,23400,868233,859472,8761
1934,88,205079,23300,869128,859832,9296
1935,85,205144,25400,869297,860575,8722
1936,80,205258,21100,870022,861382,8640
1937,81,205268,23400,870522,861982,8540
1938,84,205429,22650,871678,862443,9235
1939,84,205471,21750,871747,863082,8665
1940,85,205670,24050,872822,863738,9084
1941,87,205700,22800,873928,864282,9646
1942,86,205795,19600,873533,864338,9195
1943,81,205898,21600,875031,864875,10156
1944,83,205906,20800,874978,865482,9496
1945,87,206123,24150,875683,865988,9695
1946,90,206172,22500,876578,866425,10153
1947,85,206323,22700,877683,867475,10208
1948,87,206407,25500,877678,867975,9703
1949,87,206435,23700,878828,868788,10040
1950,81,206517,24300,879328,869472,9856
1951,83,206578,24850,879997,870032,9965
1952,86,206633,20950,879783,870472,9311
1953,86,206678,21400,880597,871072,9525
1954,86,206695,24550,881281,871572,9709
1955,90,206885,23850,883622,872122,11500
1956,89,206901,18850,882622,872488,10134
1957,83,206957,26650,883678,872943,10735
1958,84,207218,20850,884122,873382,10740
1959,85,207243,20900,884478,873975,10503
1960,90,207775,23400,884978,874743,10235
1961,88,207920,26000,885622,875743,9879
1962,83,208099,20800,886172,876238,9934
1963,88,208495,23300,887147,876788,10359
1964,86,208740,24550,889633,877225,12408
1965,85,208791,20900,890181,877725,12456
1966,85,208834,28100,889822,878225,11597
1967,88,208859,26000,890628,879043,11585
1968,86,208979,23650,891422,879988,11434
1969,89,209003,22450,891978,880375,11603
1970,89,209099,26050,892022,880593,11429
1971,82,209218,25700,892881,881143,11738
1972,85,209233,29000,859589,882025,-22436
1973,89,209290,22900,859635,882643,-23008
1974,86,209475,22300,859940,883025,-23085
1975,89,209477,25600,861540,883238,-21698
1976,84,209517,22650,861439,884125,-22686
1977,90,209614,19800,861884,884438,-22554
1978,81,209827,21150,862835,884843,-22008
1979,87,209880,27750,863340,885432,-22092
1980,90,210234,26550,864035,885843,-21808
1981,86,210408,27700,864946,886522,-21576
1982,80,210432,22450,864934,886825,-21891
1983,88,210626,22850,865496,887672,-22176
1984,89,210729,23350,866684,888243,-21559
1985,89,210820,26050,867685,888743,-21058
1986,88,210843,23750,867590,889375,-21785
1987,80,210938,23350,868039,889572,-21533
1988,90,211162,24750,868396,890122,-21726
1989,87,211251,27750,869290,890793,-21503
1990,87,211517,24150,870735,891122,-20387
1991,87,211568,21900,870890,891893,-21003
1992,87,211601,22350,870689,892393,-21704
1993,87,211710,24600,871785,893182,-21397
1994,90,211724,27450,872784,893638,-20854
1995,85,211823,23600,873196,894422,-21226
1996,83,211911,19900,873389,894882,-21493
1997,88,211913,19700,876294,895138,-18844
1998,81,211938,22050,875987,895793,-19806
1999,87,211948,20100,875539,896382,-20843
2000,80,211964,23350,876994,896822,-19828
2001,83,211965,25750,875184,897888,-22704
2002,84,212011,22650,877037,898372,-21335
2003,85,212062,27650,877044,898943,-21899
2004,83,212295,24400,878144,899493,-21349
2005,87,212476,20550,879994,900175,-20181
2006,88,212546,23750,881237,900972,-19735
2007,85,212574,24050,884444,901482,-17038
2008,90,212657,24750,884387,902072,-17685
2009,90,212796,26550,888744,902825,-14081
2010,82,212819,18950,888794,903582,-14788
2011,86,212868,23200,888987,904082,-15095
2012,83,212996,22600,889587,904525,-14938
2013,86,213169,25450,890694,904993,-14299
2014,89,213370,22000,891744,905543,-13799
2015,81,213371,17550,892587,905875,-13288
2016,90,213393,26100,895194,906693,-11499
2017,82,213496,20300,896387,907375,-10988
2018,89,213802,25150,898437,907875,-9438
2019,89,213952,23800,898694,908843,-10149
2020,88,213956,22850,900787,909482,-8695
2021,80,214069,19750,904087,909622,-5535
2022,81,214124,19800,904094,910032,-5938
2023,88,214472,22400,905637,910543,-4906
2024,85,214619,23600,908237,911632,-3395
2025,84,214698,22650,911044,912132,-1088
2026,82,214721,20750,912637,913143,-506
2027,82,214722,20300,913137,913643,-506
2028,87,214815,23250,912594,913838,-1244
2029,86,215161,20950,914644,914425,219
2030,81,215169,23850,915337,915388,-51
2031,90,215179,23400,918094,916075,2019
2032,90,215217,22050,918594,916438,2156
2033,80,215480,20650,920144,917243,2901
2034,84,215612,24000,922294,917438,4856
2035,89,215840,21550,925487,917972,7515
2036,86,215850,25000,924987,918382,6605
2037,81,216016,21150,926587,918882,7705
2038,88,216227,25550,930937,919438,11499
2039,84,216248,26250,930494,920022,10472
2040,90,216296,22950,930444,920638,9806
2041,90,216635,25650,931094,921293,9801
2042,84,216763,24900,933244,922032,11212
2043,86,216900,24100,938494,922722,15772
2044,86,216901,23200,936737,923488,13249
2045,84,216985,26250,940044,924038,16006
2046,83,217065,22150,941094,924422,16672
2047,82,217095,17150,940887,925422,15465
2048,82,217245,21650,945587,926093,19494
2049,87,217282,22350,945994,926375,19619
2050,85,217283,24050,945687,927238,18449
2051,82,217492,22550,946237,927743,18494
2052,89,217684,23800,948787,928338,20449
2053,82,217742,20750,948244,929293,18951
2054,83,217847,23950,949937,930038,19899
2055,80,218098,22450,951487,930525,20962
2056,90,218281,22500,953144,931093,22051
2057,89,218385,25600,954244,932188,22056
2058,90,218404,24750,954887,933482,21405
2059,86,218420,23650,912884,934193,-21309
2060,85,218437,24050,912889,935232,-22343
2061,87,218471,25050,912990,935888,-22898
2062,80,218573,22900,913639,936843,-23204
2063,88,218932,25100,914239,937475,-23236
2064,86,219192,24100,915289,937938,-22649
2065,85,219753,26750,915584,938438,-22854
2066,90,220057,23850,912940,938575,-25635
2067,87,220149,18300,913291,939093,-25802
2068,85,220165,21350,913990,939682,-25692
2069,81,220176,24750,914293,940143,-25850
2070,84,220335,22650,915290,940643,-25353
2071,81,220372,22050,915548,941625,-26077
2072,81,220498,22500,915843,941822,-25979
2073,84,220516,24900,917441,942372,-24931
2074,84,220567,22650,916648,942872,-26224
2075,81,220600,24300,917148,943032,-25884
2076,89,220618,20650,918393,943732,-25339
2077,86,220672,24550,918198,943975,-25777
2078,84,220693,21750,918943,944572,-25629
2079,85,220760,21800,920848,945993,-25145
2080,82,220828,26600,920890,946175,-25285
2081,84,220828,24000,920138,947088,-26950
2082,90,220856,23400,921041,947643,-26602
2083,81,221045,24300,922288,948193,-25905
2084,85,221046,24500,922898,948638,-25740
2085,86,221160,25000,923898,948843,-24945
2086,88,221432,26900,925090,949343,-24253
2087,83,221470,19000,925038,949725,-24687
2088,86,221507,25450,926841,937693,-10852
2089,90,221564,25200,927388,939637,-12249
2090,90,221594,26550,928388,940393,-12005
2091,84,221626,26700,928093,941893,-13800
2092,80,221668,23350,928698,943043,-14345
2093,82,221698,22100,928890,944693,-15803
2094,82,221987,24800,930143,946193,-16050
2095,82,222012,19850,930141,946737,-16596
2096,81,222159,24750,930498,949993,-19495
2097,81,222204,26550,931143,951437,-20294
2098,86,222237,22750,931691,952743,-21052
2099,83,222533,23050,932190,953843,-21653
2100,87,222676,25950,932943,955393,-22450
2101,83,222767,22600,934190,956493,-22303
2102,80,222773,19750,933891,957993,-24102
2103,90,222787,22950,934043,959593,-25550
2104,89,222992,25600,935248,961287,-26039
2105,81,223062,22050,935240,963337,-28097
2106,90,223126,22500,935988,964543,-28555
2107,81,223192,20250,936291,965343,-29052
2108,80,223619,23800,937243,966343,-29100
2109,88,223685,24200,937538,968537,-30999
2110,84,223768,19500,937840,970137,-32297
2111,87,223922,24600,938390,971187,-32797
2112,88,223951,23750,938890,972687,-33797
2113,90,224338,26550,939890,974093,-34203
2114,84,224498,25350,941643,974593,-32950
2115,87,224533,24150,941490,977787,-36297
2116,84,224644,20850,941898,979343,-37445
2117,87,224766,21900,942743,980487,-37744
2118,86,224880,22300,943090,981837,-38747
2119,87,224886,25950,943448,982837,-39389
2120,86,224964,20500,944088,983793,-39705
2121,82,225064,29300,945443,984793,-39350
2122,80,225111,19300,946443,985793,-39350
2123,80,225170,23800,946141,987793,-41652
2124,83,225296,23050,947741,988437,-40696
2125,80,225318,22450,947943,989543,-41600
2126,82,225395,21650,948291,991137,-42846
2127,88,225492,21950,949143,992743,-43600
2128,86,225536,22300,949748,993937,-44189
2129,90,225708,24750,950440,995737,-45297
2130,83,225844,24400,950743,997387,-46644
2131,87,225959,24150,950940,998293,-47353
2132,87,225976,21450,951341,999787,-48446
2133,83,225979,19450,951588,999993,-48405
2134,80,226187,24250,952088,908298,43790
2135,82,226322,22550,952993,908701,44292
2136,85,226526,24500,954838,909251,45587
2137,83,226557,22600,954491,909539,44952
2138,85,226579,23600,955338,910040,45298
2139,86,227288,27250,955991,910590,45401
2140,84,227413,22650,957141,910998,46143
2141,82,227443,20300,957641,911091,46550
2142,90,227483,28350,958191,911641,46550
2143,80,227570,23350,958238,912498,45740
2144,89,227661,24250,959338,912840,46498
2145,89,227745,24700,958990,913689,45301
2146,80,228399,22000,960643,914198,46445
2147,88,228425,21950,960748,914490,46258
2148,88,228488,19700,961241,915248,45993
2149,89,228550,21550,961291,915439,45852
2150,84,228566,23550,961640,916051,45589
2151,81,228922,18900,961988,916240,45748
2152,80,228940,20650,962393,916398,45995
2153,86,229194,23650,962941,917151,45790
2154,87,229498,25500,964238,918201,46037
2155,86,229499,25000,963998,918998,45000
2156,81,229662,21600,965243,919451,45792
2157,88,229663,23300,965540,920139,45401
2158,90,229665,24300,965598,920748,44850
2159,82,229792,27500,966293,921248,45045
2160,86,229999,24550,967841,922101,45740
2161,84,230030,24900,967793,922889,44904
2162,90,230152,29700,968698,923889,44809
2163,90,230392,26100,969391,924640,44751
2164,90,230634,21600,969543,924848,44695
2165,86,230706,25450,970288,925441,44847
2166,81,230864,22500,970740,925948,44792
2167,80,230872,19750,971043,926551,44492
2168,80,231008,21100,971938,927090,44848
2169,85,231053,24050,972490,927289,45201
2170,81,231117,22050,972893,927789,45104
2171,85,231175,22250,973140,928339,44801
2172,85,231362,20450,974098,929251,44847
2173,88,231380,25100,974940,929698,45242
2174,86,231472,24550,975238,930351,44887
2175,83,231502,27100,976238,931091,45147
2176,82,231775,22550,976788,931851,44937
2177,81,231844,25200,977093,932189,44904
2178,89,232066,27850,977593,932998,44595
2179,81,232226,21150,978388,933591,44797
2180,86,232249,22300,978143,934148,43995
2181,85,232405,24500,979490,934648,44842
2182,90,232660,20700,980498,935501,44997
2183,84,232729,19050,980988,935740,45248
2184,85,232851,25850,981548,936639,44909
2185,84,233005,26250,982488,937498,44990
2186,81,233130,20250,984698,938048,46650
2187,82,233174,22550,984943,938491,46452
2188,86,233219,20050,984640,939389,45251
2189,80,233341,22000,985698,939801,45897
2190,89,233601,26500,987288,940139,47149
2191,80,233699,22000,987243,940639,46604
2192,81,233806,22050,987788,940990,46798
2193,89,233923,24700,989340,941651,47689
2194,90,233934,26100,989388,942491,46897
2195,87,233992,24150,989938,943248,46690
2196,81,234085,18900,990438,943748,46690
2197,83,234141,18550,990341,943951,46390
2198,88,234389,24200,992090,944840,47250
2199,84,234438,24900,992788,945051,47737
2200,87,234474,19650,991991,945891,46100
2201,84,234516,22200,992741,946898,45843
2202,81,234572,21600,993338,947639,45699
2203,84,234740,22650,994398,948639,45759
2204,86,234767,22750,994388,949590,44798
2205,86,234913,23200,994593,950148,44445
2206,84,234948,21300,995193,951101,44092
2207,86,235186,27700,995793,951539,44254
2208,83,235217,21700,996293,951898,44395
2209,82,235547,21200,996640,952539,44101
2210,83,235639,23050,997293,952898,44395
2211,81,235714,18000,999143,953441,45702
2212,84,235717,19500,998641,953941,44700
2213,90,235751,27900,999141,954541,44600
2214,86,235784,19600,999988,955489,44499
2215,86,235871,22250,999793,956089,43704
2216,87,235955,20000,999740,956391,43349
2217,86,235968,23200,999993,957251,42742
2218,85,236069,21850,987929,957801,30128
2219,82,236127,18000,988032,958190,29842
2220,83,236255,17100,988479,958991,29488
2221,87,236273,21050,988979,959739,29240
2222,84,236402,22250,989480,960339,29141
2223,80,236534,18500,990229,960951,29278
2224,87,236622,26450,990632,961889,28743
2225,88,236795,22900,991132,962601,28531
2226,81,237050,19000,992130,962989,29141
2227,90,237169,23850,992829,963601,29228
2228,85,237354,20400,992832,963991,28841
2229,87,237532,19550,993928,964651,29277
2230,83,237607,19850,995179,965448,29731
2231,84,237663,20950,995478,965740,29738
2232,84,237749,21250,996729,966148,30581
2233,82,237770,20300,996280,966789,29491
2234,80,237801,15600,997429,967191,30238
2235,81,237874,21600,997182,967901,29281
2236,81,238099,17150,998280,968140,30140
2237,80,238120,17500,998780,968798,29982
2238,83,238122,21150,998828,968991,29837
2239,87,238289,23050,999779,969889,29890
2240,88,238299,15400,999679,970939,28740
2241,80,238316,16600,999982,971641,28341
2242,87,238784,16600,858026,972139,-114113
2243,88,238942,17550,860039,972689,-112650
2244,85,238959,18600,859330,973540,-114210
2245,80,238987,17800,860126,974151,-114025
2246,82,239115,15200,860683,974739,-114056
2247,85,239132,20900,861726,975498,-113772
2248,90,239139,20850,861733,976251,-114518
2249,82,239313,14350,862276,976648,-114372
2250,81,239364,17750,863139,977390,-114251
2251,90,239397,21950,863480,977940,-114460
2252,83,239553,11650,864030,978440,-114410
2253,87,239631,20100,865226,979141,-113915
2254,89,239655,17550,865726,979348,-113622
2255,83,239677,18500,865589,979851,-114262
2256,87,239756,18350,866876,980490,-113614
2257,89,239758,14800,867030,981341,-114311
2258,86,239814,14900,866826,981990,-115164
2259,81,239814,15500,867289,982501,-115212
2260,86,239919,17050,869289,983091,-113802
2261,81,239939,20800,869330,984048,-114718
2262,80,239993,13550,869733,984698,-114965
2263,89,240044,19150,870826,985248,-114422
2264,80,240129,15600,870839,985639,-114800
2265,82,240138,15400,870429,986298,-115869
2266,89,240292,18850,872339,986501,-114162
2267,82,240381,17450,872426,986741,-114315
2268,88,240612,18750,873033,987341,-114308
2269,89,240835,22950,873533,988001,-114468
2270,87,241060,21000,876126,989098,-112972
2271,86,241085,20500,875583,989739,-114156
2272,85,241125,16700,876280,990201,-113921
2273,85,241205,19450,877789,990839,-113050
2274,82,241205,18150,877733,991398,-113665
2275,87,241294,20100,878330,992291,-113961
2276,83,241386,16550,878289,992851,-114562
2277,81,241392,12300,878429,993048,-114619
2278,86,241492,17850,879830,993991,-114161
2279,89,241559,18150,879626,994651,-115025
2280,80,241599,14700,880633,995289,-114656
2281,85,241704,19250,881380,995448,-114068
2282,85,241932,19100,881880,995889,-114009
2283,89,242050,18800,882483,996389,-113906
2284,80,242293,17550,882983,996939,-113956
2285,83,242402,14750,884876,997439,-112563
2286,89,242454,17750,885430,997951,-112521
2287,83,242516,18000,885583,998690,-113107
2288,81,242660,19600,886026,999451,-113425
2289,83,242716,15900,886526,999840,-113314
2290,85,242850,19450,886783,999990,-113207
2291,84,242999,21300,888829,989930,-101101
2292,80,243017,22850,887833,990573,-102740
2293,88,243083,22300,888539,991030,-102491
2294,81,243091,14750,888730,991524,-102794
2295,84,243185,20550,889930,992080,-102150
2296,89,243592,18950,890530,992630,-102100
2297,85,243699,18100,891029,993473,-102444
2298,85,243883,19000,892080,993973,-101893
2299,80,243977,23300,892126,994780,-102654
2300,80,244126,18950,892626,995284,-102658
2301,88,244164,20500,895880,995673,-99793
2302,83,244169,19800,895976,996223,-100247
2303,81,244181,22500,894389,996834,-102445
2304,88,244197,21400,894976,997580,-102604
2305,85,244200,19400,895829,998423,-102594
2306,84,244350,21300,896929,998630,-101701
2307,80,244357,20350,897430,999130,-101700
2308,83,244440,21800,897930,999473,-101543
2309,85,244508,18350,897826,999973,-102147
2310,88,244594,23000,899579,999780,-100201
2311,80,244619,18950,899180,868638,30542
2312,89,244676,17950,899680,869135,30545
2313,85,245000,21200,899983,869441,30542
2314,89,245010,22200,901339,870030,31309
2315,88,245105,19850,901533,870635,30898
2316,88,245376,21400,903930,871491,32439
2317,87,245385,25100,902226,871685,30541
2318,83,245398,17550,904039,872091,31948
2319,88,245440,22850,904179,872679,31500
2320,87,245462,19450,904183,873130,31053
2321,83,246208,17500,904983,873385,31598
2322,85,246299,20700,906526,874179,32347
2323,88,246315,20050,906733,874829,31904
2324,85,246321,20150,906029,875188,30841
2325,80,246414,17750,906639,875641,30998
2326,81,246778,22850,907333,876185,31148
2327,81,247009,20400,907639,876480,31159
2328,80,247344,22300,908930,877335,31595
2329,83,247461,19200,909430,877530,31900
2330,80,247547,22400,910289,878130,32159
2331,80,247640,17800,910179,879238,30941
2332,82,247683,23100,912639,879435,33204
2333,81,247724,21050,913130,879841,33289
2334,83,247725,16550,912876,880288,32588
2335,84,247879,18250,913883,881135,32748
2336,89,248019,22650,914280,881491,32789
2337,89,248158,23150,915126,882779,32347
2338,80,248186,16400,915380,883279,32101
2339,85,248604,19400,915829,883841,31988
2340,87,248857,20750,916133,884530,31603
2341,87,249039,21100,918026,885541,32485
2342,83,249044,17650,917739,886079,31660
2343,82,249075,20850,918239,887085,31154
2344,83,249194,17550,919383,887729,31654
2345,86,249208,22250,919380,888229,31151
2346,90,249294,19750,919930,888779,31151
2347,87,249321,20550,920429,889385,31044
2348,90,249519,22150,921033,890241,30792
2349,89,249698,20500,921426,891288,30138
2350,87,249726,24100,921739,891585,30154
2351,82,249836,19550,923876,892029,31847
2352,87,249859,21900,924330,892291,32039
2353,89,249892,19300,924476,892780,31696
2354,84,249903,20850,923830,893391,30439
2355,80,250007,19200,925139,894280,30859
2356,81,250157,17400,926829,894785,32044
2357,80,250209,19450,926976,895138,31838
2358,84,250334,20400,927479,895485,31994
2359,88,250458,26700,928529,896238,32291
2360,83,251282,22050,928883,896535,32348
2361,83,251545,21750,929226,896979,32247
2362,86,251681,17750,931229,897735,33494
2363,88,251740,22850,932526,898235,34291
2364,85,251740,21450,932089,898480,33609
2365,84,251785,21900,931730,899229,32501
2366,84,251835,18700,932733,899580,33153
2367,83,251919,20850,933139,900229,32910
2368,87,251983,21150,933833,900729,33104
2369,89,252103,21500,934480,901435,33045
2370,87,252140,19600,935076,901779,33297
2371,84,252170,16150,935383,902388,32995
2372,84,252286,20900,935879,902691,33188
2373,80,252390,17650,936280,903388,32892
2374,81,252635,19250,936780,904030,32750
2375,87,252965,19200,937583,904541,33042
2376,86,253209,19800,937926,905085,32841
2377,90,253309,19850,938876,905641,33235
2378,80,253331,21700,939980,906191,33789
2379,80,253385,19350,939539,906988,32551
2380,89,253402,20350,939589,907538,32051
2381,88,253424,21600,940629,908229,32400
2382,81,253521,18950,940639,908588,32051
2383,88,254079,21850,941576,909430,32146
2384,82,254205,17950,942133,910141,31992
2385,80,254215,21100,942380,910641,31739
2386,87,254339,17800,942779,911030,31749
2387,85,254424,25250,943279,911530,31749
2388,89,254627,23000,944383,911735,32648
2389,80,254716,18800,945483,912235,33248
2390,90,254793,21100,945526,912788,32738
2391,85,254921,19950,946439,913041,33398
2392,88,254958,21150,947080,913338,33742
2393,86,254975,23650,947580,913938,33642
2394,85,255135,22650,948589,914891,33698
2395,80,255183,21950,948379,915280,33099
2396,84,255243,19900,949730,915535,34195
2397,83,255306,18400,950129,916438,33691
2398,81,255511,16500,951476,916585,34891
2399,85,255582,23100,951489,917030,34459
2400,90,255605,23400,951729,917091,34638
2401,90,255901,23850,952139,917580,34559
2402,83,255909,23050,953280,918080,35200
2403,86,255940,25450,953789,918691,35098
2404,81,255966,20700,953626,919130,34496
2405,80,256284,22450,954429,919679,34750
2406,82,256354,22550,954889,920130,34759
2407,81,256582,20250,956039,920585,35454
2408,89,256635,25600,955939,921180,34759
2409,90,256655,24300,956480,921641,34839
2410,90,256682,26100,957139,922279,34860
2411,89,256899,24250,958833,922691,36142
2412,83,256997,27550,958680,923685,34995
2413,83,257019,22150,960189,923930,36259
2414,82,257023,24350,960676,924430,36246
2415,90,257023,24300,960533,925441,35092
2416,80,257134,22000,961533,926235,35298
2417,88,257174,19700,962289,926441,35848
2418,84,257256,23100,962329,927079,35250
2419,86,257331,20050,962829,927579,35250
2420,87,257489,25050,964333,928230,36103
2421,80,257527,23800,964326,928730,35596
2422,84,257800,20850,964880,928991,35889
2423,80,257904,22450,965639,929938,35701
2424,85,257937,21800,965526,930730,34796
2425,87,257941,26850,966789,931780,35009
2426,86,258027,25000,966983,932480,34503
2427,82,258180,21200,969588,933130,36458
2428,87,258211,22800,970992,933735,37257
2429,90,258244,25200,973092,934630,38462
2430,90,258283,23400,971238,935630,35608
2431,86,258338,22300,972788,936138,36650
2432,89,258462,25150,974742,936985,37757
2433,86,258568,26800,976038,937535,38503
2434,88,258605,23750,982138,937991,44147
2435,83,258608,23500,979442,938180,41262
2436,90,258619,24750,982638,939179,43459
2437,88,258704,24650,982142,940179,41963
2438,85,258780,22700,983242,940285,42957
2439,89,258876,26050,987238,940830,46408
2440,82,258929,21650,988042,941388,46654
2441,80,259002,21550,991038,942279,48759
2442,88,259049,23750,992088,942779,49309
2443,87,259131,22350,992092,943779,48313
2444,88,259332,24200,993692,944585,49107
2445,83,259346,21700,998742,945085,53657
2446,80,259371,21100,998588,945688,52900
2447,84,259438,27150,999088,946529,52559
2448,87,259722,24050,999842,947330,52512
2449,88,259939,20900,977676,947785,29891
2450,82,260086,20200,979079,948380,30699
2451,87,260132,21450,978483,949138,29345
2452,88,260158,21100,979579,949638,29941
2453,80,260183,20600,979130,949930,29200
2454,88,260241,20600,979339,950779,28560
2455,82,260430,19400,979989,951188,28801
2456,87,260537,20700,980329,951779,28550
2457,81,260583,18050,981180,952691,28489
2458,81,260607,21350,981479,953191,28288
2459,88,260683,19450,981979,954085,27894
2460,87,260873,20300,983529,954929,28600
2461,84,260923,19400,983389,955080,28309
2462,89,261345,21050,984130,955429,28701
2463,81,261363,17000,984829,955841,28988
2464,86,261611,25550,985533,956341,29192
2465,88,261939,21500,986329,957029,29300
2466,85,262010,20350,986539,957391,29148
2467,80,262113,18650,986830,957830,29000
2468,84,262122,19800,987933,958629,29304
2469,83,262145,17850,988039,959138,28901
2470,89,262237,21450,988933,960138,28795
2471,86,262472,19000,989639,961185,28454
2472,83,262576,17050,990289,961829,28460
2473,81,262729,21250,990579,962580,27999
2474,81,263050,19050,991833,963329,28504
2475,89,263086,22000,992333,963388,28945
2476,83,263108,18100,992276,964379,27897
2477,81,263237,19250,992826,965230,27596
2478,81,263404,19850,994876,965529,29347
2479,80,263428,19350,995330,966235,29095
2480,86,263480,19950,994729,966441,28288
2481,84,263495,20500,995483,966938,28545
2482,80,263599,23000,995930,967438,28492
2483,81,263675,17650,996289,967880,28409
2484,80,263932,17800,997039,968691,28348
2485,83,264005,21650,997530,969379,28151
2486,87,264184,20300,999226,970080,29146
2487,82,264242,17250,999033,970379,28654
2488,82,264243,18750,999579,970441,29138
2489,88,264455,21250,999876,971379,28497
2490,87,264539,14300,999939,972230,27709
2491,80,264557,17900,932684,972835,-40151
2492,89,264599,16300,933142,973241,-40099
2493,83,264747,19700,933696,973891,-40195
2494,84,264822,18100,934839,974391,-39552
2495,88,264909,17850,935534,974985,-39451
2496,89,265005,19300,936389,975430,-39041
2497,88,265041,16600,936435,976188,-39753
2498,87,265299,15250,937535,977035,-39500
2499,82,265386,16950,937446,977391,-39945
2500,83,265440,16550,938634,978079,-39445
2501,82,265505,15850,938684,978991,-40307
2502,89,265582,16500,939696,979679,-39983
2503,86,265677,19050,940685,980279,-39594
2504,87,265739,19100,940739,981041,-40302
2505,85,265909,17750,941946,981338,-39392
2506,89,266002,16150,941842,982030,-40188
2507,80,266494,17900,942642,982635,-39993
2508,86,266573,19550,943596,983138,-39542
2509,90,266666,15900,943534,983729,-40195
2510,80,266666,15850,944034,984288,-40254
2511,87,266729,16250,944242,985379,-41137
2512,86,267038,16200,944534,986141,-41607
2513,83,267481,17600,946585,986691,-40106
2514,84,267564,16750,948339,987385,-39046
2515,84,267567,17450,947996,988238,-40242
2516,86,267599,19950,948735,989029,-40294
2517,84,267629,22250,948085,989635,-41550
2518,83,267681,17650,949735,990135,-40400
2519,86,267699,18950,949192,990741,-41549
2520,83,267768,14100,949884,991038,-41154
2521,82,267800,17700,950384,991630,-41246
2522,84,268149,15750,950792,992235,-41443
2523,82,268320,15650,951385,992779,-41394
2524,83,268468,17200,953235,993829,-40594
2525,81,268490,16850,953689,994488,-40799
2526,86,268493,18700,952542,994541,-41999
2527,88,268510,20800,953734,995130,-41396
2528,85,268547,20000,953592,995279,-41687
2529,86,268921,17250,953785,995741,-41956
2530,81,269035,20600,954642,996238,-41596
2531,88,269103,24050,955285,996991,-41706
2532,87,269308,19800,956389,998538,-42149
2533,88,269406,22750,956834,999841,-43007
2534,81,269426,22050,958834,998485,-39651
2535,81,269480,19850,958442,998985,-40543
2536,81,269506,21500,958984,999535,-40551
2537,82,269593,18150,960439,999888,-39449
2538,85,269608,21200,960939,999891,-38952
2539,89,269638,19750,961135,943540,17595
2540,80,269671,19700,961284,944040,17244
2541,87,269881,25550,961992,944743,17249
2542,89,270288,20450,962784,945243,17541
2543,86,270510,21300,963334,945983,17351
2544,85,270632,21750,964092,946140,17952
2545,82,270996,18250,964739,947189,17550
2546,84,271119,22700,965239,947740,17499
2547,84,271201,19050,966096,948683,17413
2548,88,271221,23650,966684,949339,17345
2549,82,271309,15250,968984,949751,19233
2550,88,271328,21100,969692,950733,18959
2551,86,271369,23300,968434,951851,16583
2552,90,271405,20900,969696,952283,17413
2553,81,271542,20250,969984,952539,17445
2554,89,271629,22250,970792,953540,17252
2555,85,271744,18550,971392,954090,17302
2556,88,271841,17700,973542,954751,18791
2557,84,271906,21400,972784,955190,17594
2558,85,271921,19000,973546,955851,17695
2559,85,272153,19300,974042,956593,17449
2560,88,272206,22750,974385,957290,17095
2561,84,272345,17800,974885,958051,16834
2562,82,272462,18150,976589,958390,18199
2563,80,272476,18350,976785,958939,17846
2564,87,272513,22750,977239,959333,17906
2565,80,272533,21000,977385,959901,17484
2566,82,272561,20750,977496,960483,17013
2567,83,272563,20300,977142,961189,15953
2568,81,272661,15250,978239,961890,16349
2569,85,272827,18650,978884,962151,16733
2570,83,272913,20800,979192,962940,16252
2571,87,272939,21050,979685,963233,16452
2572,84,273046,19750,980196,963851,16345
2573,87,273116,22800,980639,964489,16150
2574,80,273286,19200,981235,965333,15902
2575,89,273339,22750,981542,966433,15109
2576,80,273448,16700,981985,967083,14902
2577,86,273681,21700,982634,967743,14891
2578,90,273781,26100,984185,968583,15602
2579,81,273793,15550,983784,969301,14483
2580,85,273856,20100,984685,970040,14645
2581,84,273965,21250,985296,970683,14613
2582,80,273968,23750,986284,971451,14833
2583,90,274019,23900,986192,972383,13809
2584,88,274024,17750,986835,972593,14242
2585,87,274307,20000,987935,973093,14842
2586,80,274337,20050,988442,973639,14803
2587,81,274375,20200,989284,974133,15151
2588,89,274473,22550,988935,974739,14196
2589,87,274656,21550,990484,975239,15245
2590,88,274740,24700,990096,975839,14257
2591,83,274762,19350,991096,976583,14513
2592,87,274974,20450,991835,976893,14942
2593,85,275109,20150,992892,977251,15641
2594,88,275193,20600,993035,977740,15295
2595,80,275277,19300,993392,977993,15399
2596,84,275982,20500,993635,978483,15152
2597,90,276106,20850,994392,979043,15349
2598,83,276106,22600,995135,979643,15492
2599,89,276264,16500,995635,980033,15602
2600,86,276490,23750,996142,980643,15499
2601,90,276505,22900,996384,981539,14845
2602,86,276594,22700,996685,982033,14652
2603,88,276693,24650,997139,982583,14556
2604,83,276777,21550,997842,983240,14602
2605,87,276900,21150,998392,983693,14699
2606,85,277245,19500,998934,984240,14694
2607,81,277297,17850,999289,984389,14900
2608,83,277419,17300,999992,985001,14991
2609,82,277448,21500,999989,985390,14599
2610,90,277595,17100,861589,985940,-124351
2611,87,277828,18600,862739,986440,-123701
2612,86,277838,18100,863186,987343,-124157
2613,82,277957,16800,864186,987483,-123297
2614,82,278040,16400,863983,988039,-124056
2615,85,278127,17050,865447,988539,-123092
2616,83,278130,16050,865236,988640,-123404
2617,82,278365,17000,865990,989351,-123361
2618,83,278624,15300,867097,989943,-122846
2619,88,278700,16100,866883,990139,-123256
2620,86,278716,17400,867590,990689,-123099
2621,88,279025,16500,916137,990990,-74853
2622,80,279032,15050,915743,992040,-76297
2623,86,279228,18150,918193,992633,-74440
2624,85,279250,20550,918237,993189,-74952
2625,86,279465,24950,920293,993743,-73450
2626,83,279643,20750,922443,994333,-71890
2627,80,279683,21650,921687,995239,-73552
2628,80,279724,21200,924787,996339,-71552
2629,86,279747,16400,925293,996790,-71497
2630,86,279749,19500,924737,997339,-72602
2631,88,279889,21350,928643,998001,-69358
2632,83,279901,19600,928537,998133,-69596
2633,88,279999,22350,930587,998639,-68052
2634,88,279999,17300,932187,999693,-67506
2635,83,280113,19500,939137,999889,-60752
2636,89,280129,22850,935693,986390,-50697
2637,87,280137,18750,940043,987037,-46994
2638,89,280191,24550,938943,987540,-48597
2639,88,280338,25900,943337,988293,-44956
2640,84,280375,15250,943343,988742,-45399
2641,82,280481,19850,945787,989341,-43554
2642,84,280540,19800,945993,990342,-44349
2643,89,280601,24350,947937,990991,-43054
2644,84,280610,16700,951787,991437,-39650
2645,81,280629,18800,949893,991942,-42049
2646,83,280657,20400,951943,992341,-40398
2647,80,280764,15500,952787,993037,-40250
2648,87,280851,20350,957537,993642,-36105
2649,83,280894,20400,959087,994192,-35105
2650,86,280900,16200,959093,994692,-35599
2651,84,280948,21850,960643,995440,-34797
2652,85,280955,21100,958993,995692,-36699
2653,80,281014,17550,960287,996037,-35750
2654,88,281122,17800,961037,996637,-35600
2655,87,281159,16100,962287,996791,-34504
2656,87,281308,20600,963043,997637,-34594
2657,80,281378,16650,966237,998092,-31855
2658,87,281447,20450,966537,998693,-32156
2659,82,281503,20250,966993,999590,-32597
2660,86,281848,22850,971437,999787,-28350
2661,87,281897,18800,969793,999893,-30100
2662,89,281937,24250,971487,877280,94207
2663,87,282134,18650,972987,877880,95107
2664,88,282239,21050,976443,878439,98004
2665,89,282299,23150,976493,878739,97754
2666,83,282324,20100,978643,879439,99204
2667,82,282408,20450,979837,880739,99098
2668,88,282440,22600,979843,881388,98455
2669,82,282924,21250,981337,881989,99348
2670,87,283510,17950,982937,882489,100448
2671,86,283633,21650,984637,883088,101549
2672,81,283773,19500,985943,883539,102404
2673,81,283786,21750,988943,884088,104855
2674,84,283808,21600,988443,884289,104154
2675,85,283903,23350,991993,884739,107254
2676,80,284571,21250,995643,885688,109955
2677,86,284619,21850,995237,886339,108898
2678,90,285092,21750,997337,886939,110398
2679,86,285099,20000,999437,887338,112099
2680,80,285475,19500,999893,887489,112404
2681,90,285497,14000,999637,888280,111357
2682,81,285681,19850,944641,888789,55852
2683,88,285738,16100,944994,889239,55755
2684,87,285931,19100,948691,889739,58952
2685,87,285964,14400,950994,890530,60464
2686,84,285975,18500,951191,891180,60011
2687,84,286058,17650,951891,890789,61102
2688,88,286115,17050,954141,891939,62202
2689,89,286202,19800,955144,892280,62864
2690,80,286285,18350,955641,892780,62861
2691,88,286439,19450,956691,893439,63252
2692,80,286740,17600,958844,893938,64906
2693,81,287110,12800,960544,894489,66055
2694,81,287353,20100,961594,895130,66464
2695,84,287465,17450,966894,895789,71105
2696,86,287465,13050,964591,896389,68202
2697,80,287508,13250,966791,897189,69602
2698,83,287527,18550,966394,897839,68555
2699,82,287692,16950,968441,898788,69653
2700,85,287870,19900,970141,899089,71052
2701,82,288037,14700,971644,899380,72264
2702,85,288507,15500,975141,900039,75102
2703,84,288587,18150,974994,900388,74606
2704,81,288611,15200,975691,900839,74852
2705,80,288765,16800,976144,901480,74664
2706,81,288946,20300,977941,902038,75903
2707,80,289064,18450,978941,902539,76402
2708,86,289099,20650,980091,903189,76902
2709,84,289190,16650,983344,903789,79555
2710,86,289196,20500,983341,904539,78802
2711,81,289348,15750,986994,905639,81355
2712,86,289398,21650,986991,906738,80253
2713,84,289474,17700,988044,907189,80855
2714,88,289665,15450,989094,907938,81156
2715,80,290045,18250,994444,908439,86005
2716,83,290074,18750,994491,908938,85553
2717,84,290128,20750,994944,909538,85406
2718,85,290142,17400,994441,910689,83752
2719,85,290479,15950,996094,911239,84855
2720,90,290482,18650,997644,911630,86014
2721,81,290655,15350,999341,911839,87502
2722,86,290786,13150,999841,911730,88111
2723,90,290851,17200,925389,912889,12500
2724,87,291550,14650,926136,913289,12847
2725,81,291658,10750,926897,913889,13008
2726,87,291669,14000,927033,914438,12595
2727,83,291858,16900,928189,915039,13150
2728,80,291909,12500,928047,915689,12358
2729,85,291925,14600,928683,916539,12144
2730,86,292070,13250,929247,917189,12058
2731,89,292105,13450,929747,918030,11717
2732,82,292208,16150,930347,918580,11767
2733,80,292283,15100,931039,919239,11800
2734,84,292290,16450,932189,919488,12701
2735,88,292330,17250,932547,920289,12258
2736,90,292432,12750,933889,920989,12900
2737,85,292531,12400,934483,921689,12794
2738,82,292580,14550,934790,922080,12710
2739,85,292633,12550,935989,922639,13350
2740,83,292645,18200,935947,923238,12709
2741,88,292750,16050,936489,924139,12350
2742,83,293099,15550,937489,924689,12800
2743,85,293407,17150,938040,924938,13102
2744,84,293547,17700,939286,925389,13897
2745,84,293566,12700,939533,925988,13545
2746,87,293668,13700,941089,926889,14200
2747,84,293691,15100,941183,927339,13844
2748,85,293712,12350,940886,927688,13198
2749,89,293908,14850,941683,928238,13445
2750,87,294177,15500,942183,929080,13103
2751,80,294311,11350,943647,929139,14508
2752,84,294344,13950,943839,929539,14300
2753,89,294384,19800,944090,930539,13551
2754,89,294699,16550,944647,931089,13558
2755,85,294736,14200,946286,931888,14398
2756,80,294756,12750,945736,932639,13097
2757,85,294770,14700,946483,933339,13144
2758,86,294877,15550,947290,934039,13251
2759,80,295001,15300,948033,934789,13244
2760,85,295131,15800,950040,935538,14502
2761,83,295148,18350,950633,935980,14653
2762,88,295190,16550,950739,936389,14350
2763,81,295239,14100,950997,937339,13658
2764,82,295581,12400,951240,937989,13251
2765,83,295710,15000,953036,938338,14698
2766,85,295776,12400,954039,939230,14809
2767,86,295799,14650,953433,939739,13694
2768,84,295843,13300,954040,940639,13401
2769,85,296464,14250,955189,940939,14250
2770,80,296496,10950,955186,941339,13847
2771,84,296617,13050,955689,941839,13850
2772,86,296815,17000,957383,942389,14994
2773,85,296872,11700,957436,942939,14497
2774,86,296905,12100,957533,943489,14044
2775,83,296978,12050,958940,943889,15051
2776,81,297064,16350,958889,944680,14209
2777,82,297302,13550,959440,945039,14401
2778,90,297315,13400,960097,945639,14458
2779,86,297505,15250,960797,946289,14508
2780,81,297760,13250,961383,946830,14553
2781,82,297980,19950,962186,947389,14797
2782,86,298210,18000,963197,947930,15267
2783,81,298304,14500,963186,948138,15048
2784,83,298313,20350,963797,948839,14958
2785,84,298514,17750,964336,949138,15198
2786,81,298613,13250,964783,949639,15144
2787,90,298624,19900,965289,949989,15300
2788,87,298643,20100,966339,950339,16000
2789,90,298995,19400,968586,950588,17998
2790,87,299012,16100,968671,951330,17341
2791,80,299024,15850,968840,951489,17351
2792,83,299040,17050,969295,952330,16965
2793,81,299185,17450,970895,952989,17906
2794,89,299343,14850,971921,953839,18082
2795,80,299408,16050,973571,954389,19182
2796,89,299569,20050,974721,954939,19782
2797,84,299700,19700,976245,955439,20806
2798,84,299815,17150,976795,956030,20765
2799,88,300211,21500,978995,956289,22706
2800,82,300234,15850,980921,956889,24032
2801,88,300321,21700,981095,957238,23857
2802,80,300653,15450,984121,957938,26183
2803,83,300677,19700,984395,958438,25957
2804,81,300947,14750,985871,959038,26833
2805,86,301111,17750,991595,959639,31956
2806,80,301130,17500,990295,960430,29865
2807,83,301171,14000,992121,960839,31282
2808,89,301400,20700,992645,961339,31306
2809,84,301812,17200,996245,961838,34407
2810,80,301880,16600,997971,962289,35682
2811,86,301945,15950,998521,962780,35741
2812,85,302067,13850,999521,963439,36082
2813,89,302234,14300,999945,963989,35956
2814,85,302281,15150,982139,964430,17709
2815,85,302335,14700,982547,964839,17708
2816,89,302601,12550,985189,965589,19600
2817,82,302632,15900,983290,966389,16901
2818,82,302634,14750,984797,966839,17958
2819,85,302693,18250,984836,967689,17147
2820,85,302918,11750,985386,968439,16947
2821,80,303068,13200,986239,968780,17459
2822,82,303085,13400,986739,969239,17500
2823,89,303272,14800,987239,969780,17459
2824,85,303466,14850,988090,970380,17710
2825,85,303680,17050,989547,970989,18558
2826,88,303761,15800,990690,971689,19001
2827,83,303798,16150,990089,972339,17750
2828,80,303798,8500,990589,972689,17900
2829,86,303902,19900,992886,973530,19356
2830,88,304001,14000,992897,973789,19108
2831,82,304239,14250,994840,974238,20602
2832,81,304307,15750,994947,974389,20558
2833,88,304485,17200,997033,974788,22245
2834,90,304559,14350,997047,975288,21759
2835,82,304570,14150,996839,975830,21009
2836,86,304730,12700,997533,976338,21195
2837,80,304807,16650,998186,976938,21248
2838,88,304988,16450,998533,977380,21153
2839,81,305235,14350,999247,977588,21659
2840,88,305284,16800,999090,978439,20651
2841,85,305309,16600,999733,978980,20753
2842,83,305438,12350,999939,979480,20459
2843,86,305461,16450,999847,980138,19709
2844,89,305486,10850,999989,980889,19100
4633,82,495244,14800,975441,981638,-6197
4634,81,495376,12450,976540,982638,-6098
4634,81,495376,9650,976940,982889,-5949
4634,81,495376,13600,977190,983789,-6599
4634,81,495376,14550,977889,984539,-6650
4634,81,495376,10450,978389,984839,-6450
4634,81,495376,11550,978939,985788,-6849
4634,81,495376,12850,979537,986389,-6852
4634,81,495376,11350,980340,986939,-6599
4635,84,495618,9300,980541,987789,-7248
4635,84,495618,13500,981539,988339,-6800
4635,84,495618,11500,982090,988739,-6649
4635,84,495618,10650,983390,989289,-5899
4635,84,495618,11900,983841,990280,-6439
4635,84,495618,10000,983689,991280,-7591
4635,84,495618,13650,984341,991439,-7098
4635,84,495618,11400,986740,991989,-5249
4635,84,495618,12400,987287,992630,-5343
4635,84,495618,12850,987340,993589,-6249
4636,89,495656,9050,987039,994188,-7149
4636,89,495656,8600,987539,994589,-7050
4636,89,495656,11250,988041,994888,-6847
4636,89,495656,14900,988740,995589,-6849
4636,89,495656,16050,989387,996239,-6852
4636,89,495656,9350,989641,996988,-7347
4636,89,495656,16250,990641,997189,-6548
4636,89,495656,12700,992490,998239,-5749
4636,89,495656,11600,991687,998039,-6352
4636,89,495656,14350,992687,999080,-6393
4637,84,495739,15000,994041,999589,-5548
4637,84,495739,11750,994389,999988,-5599
4637,84,495739,15500,995140,726230,268910
4637,84,495739,8550,995591,727380,268211
4637,84,495739,8450,996240,728430,267810
4637,84,495739,11700,996840,729280,267560
4637,84,495739,17250,997639,731580,266059
4637,84,495739,12600,997990,732880,265110
4637,84,495739,10100,998239,733730,264509
4637,84,495739,12300,999041,735680,263361
4637,84,495739,14600,999440,736980,262460
4637,84,495739,8900,999939,831046,168893
4637,84,495739,12200,999990,831435,168555
4637,84,495739,8150,861969,832346,29623
4637,84,495739,8600,859319,834346,24973
4636,89,495656,9750,862230,835235,26995
4636,89,495656,9800,862569,837046,25523
4637,84,495739,9650,865419,838246,27173
4638,88,495901,10550,865430,838796,26634
4638,88,495901,9100,866719,839796,26923
4638,88,495901,11500,868269,841785,26484
4638,88,495901,11400,873130,843885,29245
4638,88,495901,11900,871080,844935,26145
4638,88,495901,11100,872719,846485,26234
4638,88,495901,11650,874919,846985,27934
4638,88,495901,13300,875880,848546,27334
4638,88,495901,10800,876880,849646,27234
4638,88,495901,8600,879580,850585,28995
4638,88,495901,12200,879719,851835,27884
4639,81,495913,10000,881269,853996,27273
4639,81,495913,13400,882330,855046,27284
4639,81,495913,10800,885080,856085,28995
4639,81,495913,14550,884669,857796,26873
4639,81,495913,13900,886230,859185,27045
4639,81,495913,13150,888369,860496,27873
4639,81,495913,12950,889980,862146,27834
4639,81,495913,8550,893381,862796,30585
4639,81,495913,12500,893233,865135,28098
4639,81,495913,11850,893881,866285,27596
4639,81,495913,12150,894983,867835,27148
4638,88,495901,14450,894981,869646,25335
4638,88,495901,9100,897380,870935,26445
4638,88,495901,12250,896533,872085,24448
4640,80,496070,11900,897230,872796,24434
4640,80,496070,12400,903430,873785,29645
4640,80,496070,14100,899730,874846,24884
4640,80,496070,12600,905030,876446,28584
4640,80,496070,11950,905530,877635,27895
4640,80,496070,12200,906180,879246,26934
4640,80,496070,10450,905830,880846,24984
4640,80,496070,10250,907180,882635,24545
4640,80,496070,13750,909680,883335,26345
4640,80,496070,11850,909430,884546,24884
4640,80,496070,13100,910980,886485,24495
4641,80,496503,17450,915680,888135,27545
4641,80,496503,15050,915630,890596,25034
4641,80,496503,15600,918780,892835,25945
4641,80,496503,14350,922530,894246,28284
4641,80,496503,11300,922330,895385,26945
4641,80,496503,9600,926230,895896,30334
4641,80,496503,11850,926180,897496,28684
4641,80,496503,10900,928930,899135,29795
4641,80,496503,12650,927830,900096,27734
4641,80,496503,11250,929030,901185,27845
4641,80,496503,10250,931080,902335,28745
4641,80,496503,8550,931180,902996,28184
4641,80,496503,16800,936780,904485,32295
4641,80,496503,13200,936880,905396,31484
4642,80,496676,7550,935230,906096,29134
4642,80,496676,11500,938130,907685,30445
4642,80,496676,13050,938630,909485,29145
4642,80,496676,13450,940180,911296,28884
4642,80,496676,11500,941330,912896,28434
4642,80,496676,10500,943680,913535,30145
4642,80,496676,14050,944880,914146,30734
4642,80,496676,12650,944930,915296,29634
4642,80,496676,11300,946130,916396,29734
4642,80,496676,14000,950980,917385,33595
4642,80,496676,11100,948330,918985,29345
4642,80,496676,10950,951480,920296,31184
4642,80,496676,9750,949780,921296,28484
4642,80,496676,8150,950480,922396,28084
4642,80,496676,8050,951630,923435,28195
4642,80,496676,13800,952630,924146,28484
4643,84,496848,8400,953230,924735,28495
4643,84,496848,14800,954337,925796,28541
4643,84,496848,9000,954839,927835,27004
4643,84,496848,9600,956343,929046,27297
4643,84,496848,11550,956486,929846,26640
4643,84,496848,13150,956943,930946,25997
4643,84,496848,8450,956889,932196,24693
4644,87,496887,11850,958045,933796,24249
4644,87,496887,15600,958539,935446,23093
4644,87,496887,13300,958387,937046,21341
4644,87,496887,13300,958937,937985,20952
4644,87,496887,10200,959595,938696,20899
4644,87,496887,10350,959937,940235,19702
4644,87,496887,12050,960589,942235,18354
4644,87,496887,10200,961637,943835,17802
4644,87,496887,10500,961886,945246,16640
4645,86,496896,12100,963493,947685,15808
4645,86,496896,11300,963986,948885,15101
4645,86,496896,9300,964043,950046,13997
4645,86,496896,11700,965643,952196,13447
4645,86,496896,12950,966137,954246,11891
4645,86,496896,9300,965636,956085,9551
4645,86,496896,12050,966195,956146,10049
4645,86,496896,11450,967389,958185,9204
4645,86,496896,8950,967845,960296,7549
4645,86,496896,16700,968845,962535,6310
4645,86,496896,15900,971287,965096,6191
4645,86,496896,13600,971336,966185,5151
4646,90,496941,12750,971593,968235,3358
4646,90,496941,10700,971189,970196,993
4646,90,496941,17050,972095,971385,710
4646,90,496941,8450,972645,972985,-340
4646,90,496941,12650,975087,974896,191
4646,90,496941,11150,973795,976096,-2301
4646,90,496941,13700,975095,977296,-2201
4646,90,496941,11850,974989,978585,-3596
4646,90,496941,11600,975636,980185,-4549
4646,90,496941,14300,976236,981735,-5499
4646,90,496941,13000,977245,982596,-5351
4646,90,496941,9800,977493,983396,-5903
4646,90,496941,11500,978043,985446,-7403
4646,90,496941,13200,978837,987785,-8948
4646,90,496941,10800,979387,989196,-9809
4643,84,496848,10250,980243,990346,-10103
4644,87,496887,11800,980436,991185,-10749
4647,88,497001,11750,980039,991835,-11796
4647,88,497001,10100,982587,992835,-10248
4647,88,497001,10200,982593,994585,-11992
4647,88,497001,8200,982636,995785,-13149
4647,88,497001,15050,982739,996446,-13707
4647,88,497001,9200,983286,998046,-14760
4647,88,497001,15050,983843,999546,-15703
4647,88,497001,15300,984295,999835,-15540
4647,88,497001,9550,984737,928630,56107
4647,88,497001,10500,985436,929830,55606
4647,88,497001,14400,987495,931230,56265
4647,88,497001,11600,986543,932580,53963
4647,88,497001,17400,987437,934430,53007
4646,90,496941,16450,987643,935330,52313
4646,90,496941,14700,988193,936880,51313
4648,89,497079,13450,988536,938130,50406
4648,89,497079,15150,989036,940230,48806
4648,89,497079,12400,989145,940930,48215
4648,89,497079,15500,990893,942130,48763
4648,89,497079,16200,990687,943880,46807
4647,88,497001,13800,991145,944930,46215
4649,90,497119,13850,991736,946480,45256
4649,90,497119,17750,992239,947630,44609
4649,90,497119,12050,992836,948380,44456
4649,90,497119,13450,993436,950332,43104
4649,90,497119,14400,994637,950393,44244
4649,90,497119,13350,994686,950840,43846
4649,90,497119,11750,995186,951440,43746
4649,90,497119,16600,995145,952093,43052
4650,82,497139,17100,998443,952693,45750
4650,82,497139,16950,998539,953490,45049
4650,82,497139,12250,998295,953793,44502
4650,82,497139,15200,998387,954640,43747
4650,82,497139,14000,999043,955325,43718
4650,82,497139,12650,999389,955825,43564
4650,82,497139,16050,999487,956932,42555
4650,82,497139,14400,999989,957493,42496
4650,82,497139,14550,999743,958190,41553
4650,82,497139,13450,969347,958593,10754
4650,82,497139,10850,969030,958872,10158
4651,85,497139,11300,970972,959240,11732
4651,85,497139,12200,970397,959475,10922
4651,85,497139,11900,971180,959790,11390
4651,85,497139,13600,971780,960732,11048
4651,85,497139,9000,972097,961382,10715
4651,85,497139,13350,972622,961693,10929
4651,85,497139,13100,973122,962140,10982
4652,90,497142,12950,974380,962690,11690
4652,90,497142,8250,974333,962972,11361
4652,90,497142,10000,975597,963682,11915
4652,90,497142,12350,975772,964682,11090
4652,90,497142,10000,976197,965290,10907
4652,90,497142,9250,976697,965493,11204
4652,90,497142,13400,976881,965990,10891
4652,90,497142,8700,977083,966640,10443
4648,89,497079,12650,978133,967640,10493
4649,90,497119,10150,978431,968140,10291
4650,82,497139,13650,980530,968543,11987
4650,82,497139,9500,980122,969844,10278
4651,85,497139,13650,980581,970894,9687
4652,90,497142,8050,980333,972989,7344
4653,88,497242,11700,980347,974844,5503
4653,88,497242,11500,981422,976344,5078
4653,88,497242,10100,981681,978344,3337
4653,88,497242,14850,983083,979739,3344
4653,88,497242,11000,983331,980994,2337
4653,88,497242,10900,983881,982144,1737
4653,88,497242,12900,983931,984294,-363
4653,88,497242,12200,984480,985589,-1109
4653,88,497242,10400,984633,987639,-3006
4653,88,497242,11900,985183,988994,-3811
4653,88,497242,9550,987281,990939,-3658
4653,88,497242,11200,987831,991744,-3913
4654,82,497458,12700,987147,993639,-6492
4654,82,497458,13300,988883,994694,-5811
4654,82,497458,11450,989072,996744,-7672
4654,82,497458,10000,988830,997539,-8709
4654,82,497458,13050,989330,998094,-8764
4654,82,497458,11550,990131,999744,-9613
4654,82,497458,8650,990697,981782,8915
4654,82,497458,12900,992483,982940,9543
4655,81,497530,16600,992480,983872,8608
4655,81,497530,8300,992983,984343,8640
4655,81,497530,10700,993547,985343,8204
4655,81,497530,10900,994081,985940,8141
4655,81,497530,12050,994683,986440,8243
4655,81,497530,12550,995681,986893,8788
4656,85,497547,13900,996447,987090,9357
4656,85,497547,12150,998447,987675,10772
4656,85,497547,10350,997872,988282,9590
4656,85,497547,12000,998580,988782,9798
4656,85,497547,14800,999581,989543,10038
4656,85,497547,12800,999922,990543,9379
4654,82,497458,10000,842330,991022,-148692
4654,82,497458,8350,840230,991325,-151095
4654,82,497458,7600,841830,991740,-149910
4655,81,497530,10350,843930,992125,-148195
4656,85,497547,8300,846680,993172,-146492
4656,85,497547,8050,847180,993672,-146492
4656,85,497547,9650,846180,994343,-148163
4657,84,497674,9750,848680,994990,-146310
4657,84,497674,4400,849280,995493,-146213
4657,84,497674,10450,851530,995982,-144452
4657,84,497674,6450,855430,996343,-140913
4657,84,497674,10100,854380,996975,-142595
4657,84,497674,6950,854930,997475,-142545
4657,84,497674,8000,860430,997993,-137563
4657,84,497674,6950,860780,998593,-137813
4657,84,497674,9150,860480,999182,-138702
4657,84,497674,9950,860980,999243,-138263
4657,84,497674,7600,863830,999872,-136042
4657,84,497674,8750,865480,999990,-134510
4658,80,497690,12900,865630,999340,-133710
4658,80,497690,7600,867880,999990,-132110
4658,80,497690,6650,870130,727640,142490
4658,80,497690,7300,867880,728196,139684
4658,80,497690,9450,869980,729093,140887
4658,80,497690,5650,872430,729346,143084
4658,80,497690,8400,872880,729846,143034
4659,80,497747,10750,876530,730546,145984
4659,80,497747,8850,876930,731038,145892
4659,80,497747,9250,878130,731596,146534
4659,80,497747,6800,879230,732390,146840
4659,80,497747,8500,883780,733043,150737
4659,80,497747,8000,884280,733443,150837
4657,84,497674,8450,884180,734188,149992
4657,84,497674,7200,885380,735043,150337
4658,80,497690,10700,884130,735688,148442
4658,80,497690,9700,885880,736288,149592
4658,80,497690,9850,886980,736888,150092
4660,85,497906,5350,888530,737246,151284
4660,85,497906,6850,890130,738143,151987
4660,85,497906,7450,891880,738946,152934
4660,85,497906,7250,892930,739343,153587
4660,85,497906,8400,894580,739946,154634
4660,85,497906,4900,895530,740540,154990
4660,85,497906,8800,895680,741438,154242
4660,85,497906,6600,897230,742393,154837
4660,85,497906,8550,896830,742938,153892
4660,85,497906,9050,897930,743846,154084
4661,89,497915,6150,899280,744193,155087
4661,89,497915,7150,899530,744793,154737
4661,89,497915,10300,903930,745390,158540
4661,89,497915,6350,905430,745793,159637
4661,89,497915,10500,905180,746540,158640
4661,89,497915,9150,903430,747143,156287
4661,89,497915,7850,905680,747346,158334
4660,85,497906,10250,907230,747846,159384
4661,89,497915,10650,908880,748396,160484
4661,89,497915,10700,910580,749288,161292
4661,89,497915,10700,911630,749640,161990
4661,89,497915,8100,912980,750190,162790
4662,80,498066,7050,914180,750393,163787
4662,80,498066,9200,919280,751190,168090
4662,80,498066,9800,917980,751938,166042
4662,80,498066,6650,919230,752340,166890
4662,80,498066,9700,920280,752993,167287
4662,80,498066,8750,921830,753643,168187
4662,80,498066,9400,923830,754538,169292
4662,80,498066,10200,924430,755088,169342
4662,80,498066,12750,929430,756138,173292
4663,84,498185,11850,929630,756638,172992
4663,84,498185,8400,931580,757743,173837
4663,84,498185,13300,931830,758593,173237
4663,84,498185,14100,936330,759643,176687
4663,84,498185,8200,936830,760446,176384
4663,84,498185,11050,936030,760946,175084
4663,84,498185,8850,938330,761188,177142
4663,84,498185,8550,941030,761893,179137
4663,84,498185,6650,940980,762496,178484
4664,83,498371,12300,942730,764038,178692
4664,83,498371,9350,944330,764588,179742
4664,83,498371,6600,945830,764696,181134
4664,83,498371,8450,948080,765043,183037
4664,83,498371,6100,947880,765746,182134
4664,83,498371,7900,949080,766543,182537
4664,83,498371,9650,951280,767190,184090
4664,83,498371,7600,951730,768143,183587
4664,83,498371,7950,952930,769096,183834
4664,83,498371,9850,954430,769540,184890
4665,89,498412,8900,956230,770040,186190
4665,89,498412,6000,957430,770693,186737
4665,89,498412,11000,963180,771388,191792
4665,89,498412,8150,963730,771740,191990
4665,89,498412,8650,964280,772243,192037
4665,89,498412,9650,964030,772888,191142
4665,89,498412,6150,964530,773340,191190
4665,89,498412,12000,965380,773890,191490
4664,83,498371,10150,966730,774890,191840
4665,89,498412,9050,970380,775096,195284
4665,89,498412,9350,970480,775993,194487
4665,89,498412,7750,971580,776393,195187
4666,87,498610,11200,974630,777196,197434
4666,87,498610,10150,977230,777796,199434
4666,87,498610,7600,978630,778288,200342
4666,87,498610,6950,980030,779296,200734
4666,87,498610,8000,979930,779793,200137
4666,87,498610,8900,981680,780346,201334
4666,87,498610,8950,982880,781093,201787
4666,87,498610,9500,984480,781693,202787
4666,87,498610,13100,989380,782243,207137
4666,87,498610,8700,989730,782996,206734
4666,87,498610,9150,991480,783943,207537
4667,82,498660,4900,991980,784240,207740
4667,82,498660,7000,996530,785193,211337
4667,82,498660,5500,996680,785790,210890
4667,82,498660,10550,996880,786440,210440
4667,82,498660,11550,999980,786838,213142
4667,82,498660,8750,999630,787338,212292
4667,82,498660,7000,834380,787696,46684
4667,82,498660,6750,834430,788443,45987
4667,82,498660,6650,834880,788993,45887
4666,87,498610,6100,839330,789846,49484
4666,87,498610,6000,837880,790043,47837
4666,87,498610,6050,841630,790688,50942
4667,82,498660,4850,841480,791143,50337
4667,82,498660,5000,843780,791443,52337
4668,80,498923,3800,844130,792238,51892
4668,80,498923,7250,847730,793238,54492
4668,80,498923,6250,848230,793738,54492
4668,80,498923,5350,847930,794340,53590
4668,80,498923,6150,850980,794643,56337
4668,80,498923,4650,850480,794838,55642
4668,80,498923,4200,852230,795046,57184
4668,80,498923,7250,853430,795890,57540
4668,80,498923,3450,854030,796646,57384
4668,80,498923,6650,855580,797043,58537
4668,80,498923,6950,858280,797696,60584
4668,80,498923,6100,857780,798093,59687
4668,80,498923,6350,859380,798643,60737
4668,80,498923,6550,861480,798946,62534
4669,82,499056,5050,862480,799340,63140
4669,82,499056,5750,864830,800193,64637
4669,82,499056,3950,865180,800890,64290
4669,82,499056,4250,864930,801793,63137
4669,82,499056,7350,866480,802538,63942
4669,82,499056,6100,869980,803146,66834
4669,82,499056,6500,871680,803646,68034
4669,82,499056,7100,871730,804146,67584
4669,82,499056,6550,871180,804893,66287
4669,82,499056,6600,873830,805643,68187
4669,82,499056,6050,874930,805796,69134
4669,82,499056,3050,875230,806743,68487
4670,90,499204,8550,879680,807690,71990
4670,90,499204,3900,878480,808043,70437
4670,90,499204,5100,879730,808443,71287
4670,90,499204,4950,881680,809093,72587
4670,90,499204,5300,883680,809543,74137
4670,90,499204,5300,885630,810043,75587
4670,90,499204,4850,885980,810388,75592
4671,90,499255,7550,888980,811190,77790
4671,90,499255,5700,889130,811793,77337
4671,90,499255,7100,891730,812293,79437
4671,90,499255,7350,891080,812890,78190
4670,90,499204,4150,892680,813493,79187
4672,89,499336,7550,894430,814490,79940
4672,89,499336,4000,894980,814843,80137
4672,89,499336,6000,896680,814990,81690
4672,89,499336,3800,897980,815446,82534
4672,89,499336,9050,902180,816343,85837
4672,89,499336,6400,902180,816993,85187
4672,89,499336,6550,903830,817438,86392
4672,89,499336,8150,907930,817993,89937
4672,89,499336,7400,907330,818488,88842
4671,90,499255,7350,909780,819346,90434
4671,90,499255,4300,909130,820293,88837
4672,89,499336,1950,909680,820638,89042
4672,89,499336,5900,912380,821288,91092
4673,90,499474,7500,912530,821996,90534
4673,90,499474,5500,914480,822338,92142
4673,90,499474,4600,917430,822888,94542
4673,90,499474,7250,919680,823438,96242
4673,90,499474,7050,919580,823938,95642
4673,90,499474,4600,920230,824793,95437
4673,90,499474,6450,925130,825390,99740
4673,90,499474,6600,925180,825846,99334
4673,90,499474,7650,927980,826393,101587
4673,90,499474,5350,926980,826993,99987
4673,90,499474,6050,928080,827493,100587
4674,90,499534,6450,930830,828240,102590
4674,90,499534,5400,930680,828788,101892
4674,90,499534,7650,933480,829290,104190
4674,90,499534,5150,935030,829938,105092
4674,90,499534,7650,937730,830596,107134
4674,90,499534,5450,938430,831438,106992
4674,90,499534,4700,939280,831938,107342
4675,87,499630,7200,941330,832438,108892
4675,87,499630,8400,943430,833196,110234
4675,87,499630,9450,946480,833746,112734
4675,87,499630,7650,948080,834593,113487
4675,87,499630,6700,949230,834993,114237
4675,87,499630,6050,951930,835593,116337
4675,87,499630,5550,952280,836190,116090
4675,87,499630,4600,952430,836690,115740
4675,87,499630,6600,954480,837190,117290
4675,87,499630,4950,958280,837443,120837
4675,87,499630,5200,957780,837996,119784
4675,87,499630,7300,960330,838646,121684
4675,87,499630,4850,960230,838988,121242
4676,88,499893,6100,962730,839743,122987
4676,88,499893,5050,963080,839890,123190
4676,88,499893,7650,965730,840588,125142
4676,88,499893,3600,964680,840743,123937
4676,88,499893,5050,966880,841638,125242
4676,88,499893,7000,968930,842288,126642
4676,88,499893,4400,970480,842946,127534
4676,88,499893,5950,971580,843243,128337
4677,86,499926,5350,973830,843793,130037
4677,86,499926,5600,974130,844496,129634
4677,86,499926,3800,975280,845046,130234
4677,86,499926,9100,976980,845593,131387
4677,86,499926,4950,980730,846390,134340
4677,86,499926,6050,983280,846988,136292
4678,83,500005,9050,985630,847246,138384
4678,83,500005,4500,981280,847693,133587
4678,83,500005,8050,982780,848243,134537
4678,83,500005,7300,984380,848193,136187
4678,83,500005,4150,986080,848793,137287
4678,83,500005,7850,992480,849443,143037
4678,83,500005,9350,992930,850338,142592
4678,83,500005,8600,993430,850840,142590
4678,83,500005,5250,994530,851496,143034
4678,83,500005,2150,994630,851940,142690
4678,83,500005,7000,994580,852738,141842
4678,83,500005,6750,998980,852643,146337
4678,83,500005,6850,998480,853240,145240
4677,86,499926,5300,999980,854196,145784
4678,83,500005,3250,854569,854790,-221
4679,86,500121,4450,856769,855043,1726
4679,86,500121,1750,857366,855746,1620
4679,86,500121,4650,861116,856643,4473
4679,86,500121,5350,865416,857143,8273
4679,86,500121,3850,865966,858040,7926
4679,86,500121,3600,864619,858696,5923
4679,86,500121,1700,866219,859493,6726
4679,86,500121,4350,868369,860043,8326
4679,86,500121,4800,873166,860643,12523
4679,86,500121,3250,873669,860940,12729
4679,86,500121,3450,875916,861193,14723
4680,87,500171,4850,875869,862143,13726
4680,87,500171,2800,877466,862693,14773
4680,87,500171,2750,878619,863590,15029
4680,87,500171,1450,881019,864090,16929
4680,87,500171,1900,881519,864393,17126
4680,87,500171,2650,881116,864993,16123
4680,87,500171,5750,884266,865493,18773
4681,84,500209,1150,884719,866088,18631
4681,84,500209,3150,885866,866740,19126
4681,84,500209,3550,887569,867240,20329
4681,84,500209,2900,889719,867893,21826
4681,84,500209,2700,895066,868693,26373
4679,86,500121,2350,895319,869293,26026
4679,86,500121,4300,895819,869796,26023
4680,87,500171,3250,896066,870140,25926
4681,84,500209,4000,896566,870438,26128
4682,81,500587,1950,897569,871343,26226
4682,81,500587,2850,899869,871893,27976
4682,81,500587,2250,899566,872438,27128
4682,81,500587,2350,902866,873390,29476
4682,81,500587,4650,903019,874390,28629
4682,81,500587,2200,904716,874940,29776
4682,81,500587,3350,905219,875746,29473
4682,81,500587,3150,906769,876246,30523
4683,82,500682,2150,907819,876943,30876
4683,82,500682,2300,908919,877840,31079
4683,82,500682,4150,910566,878043,32523
4683,82,500682,4400,912719,878643,34076
4683,82,500682,3200,914219,879193,35026
4683,82,500682,4800,916419,880040,36379
4683,82,500682,3950,918866,880493,38373
4683,82,500682,2200,918719,880638,38081
4683,82,500682,2950,921616,881188,40428
4684,85,500690,4600,922469,881643,40826
4684,85,500690,4150,924119,882693,41426
4684,85,500690,2800,927066,883693,43373
4684,85,500690,3500,926919,884693,42226
4684,85,500690,1800,928019,885193,42826
4684,85,500690,3300,929269,886393,42876
4684,85,500690,1150,929819,886943,42876
4685,87,500696,2300,931019,887188,43831
4685,87,500696,2500,932216,887790,44426
4685,87,500696,5300,936416,889143,47273
4685,87,500696,2300,935719,889838,45881
4685,87,500696,1450,936369,890346,46023
4685,87,500696,2250,937566,890896,46670
4685,87,500696,4800,940719,891396,49323
4685,87,500696,2650,941166,891896,49270
4686,83,500731,2350,942216,892396,49820
4686,83,500731,3700,944069,892946,51123
4686,83,500731,2950,948116,894046,54070
4686,83,500731,4250,946916,894393,52523
4686,83,500731,1400,947719,895093,52626
4686,83,500731,3350,949366,895643,53723
4684,85,500690,2250,950519,896193,54326
4684,85,500690,1850,952716,896796,55920
4684,85,500690,3350,952919,898093,54826
4684,85,500690,1600,953266,898846,54420
4684,85,500690,2650,954266,899396,54870
4685,87,500696,4450,956566,900140,56426
4685,87,500696,2300,958366,900693,57673
4686,83,500731,2700,958819,901638,57181
4686,83,500731,3250,960016,902638,57378
4687,87,500941,2650,961516,903188,58328
4687,87,500941,3350,964766,903688,61078
4687,87,500941,5200,965266,904493,60773
4687,87,500941,3300,967019,904943,62076
4687,87,500941,1800,967166,905043,62123
4687,87,500941,4300,969219,905296,63923
4687,87,500941,1900,970266,905543,64723
4687,87,500941,4700,972266,906488,65778
4687,87,500941,2700,973466,906988,66478
4687,87,500941,2950,974819,907343,67476
4688,88,500997,2400,975969,908096,67873
4688,88,500997,3250,977566,909146,68420
4688,88,500997,2050,978169,909443,68726
4688,88,500997,3750,979766,910440,69326
4688,88,500997,3750,982419,911593,70826
4688,88,500997,3500,982969,911996,70973
4688,88,500997,6200,986069,912388,73681
4688,88,500997,3000,989969,912546,77423
4688,88,500997,4200,989369,913293,76076
4688,88,500997,2400,991319,913943,77376
4688,88,500997,3050,994866,914393,80473
4688,88,500997,2750,992469,914993,77476
4687,87,500941,4250,994366,915443,78923
4689,90,501242,3200,998219,915746,82473
4689,90,501242,4000,997866,916493,81373
4689,90,501242,4200,999916,917288,82628
4689,90,501242,500,802030,917890,-115860
4689,90,501242,50,801880,918490,-116610
4689,90,501242,500,802380,919143,-116763
4689,90,501242,50,802080,919988,-117908
4689,90,501242,50,802130,920493,-118363
4689,90,501242,50,802180,920743,-118563
4689,90,501242,50,802230,921243,-119013
4689,90,501242,50,802280,921440,-119160
4689,90,501242,500,802780,921743,-118963
4689,90,501242,50,802430,922243,-119813
4689,90,501242,50,802480,922993,-120513
4690,88,501435,500,802980,923738,-120758
4690,88,501435,50,802830,924288,-121458
4690,88,501435,500,803330,924843,-121513
4690,88,501435,50,803030,925343,-122313
4690,88,501435,50,803080,926193,-123113
4690,88,501435,500,803580,927243,-123663
4690,88,501435,50,803380,927793,-124413
4691,85,501604,500,803880,928388,-124508
4691,85,501604,500,804080,928993,-124913
4691,85,501604,50,803930,929596,-125666
4691,85,501604,50,803980,930290,-126310
4691,85,501604,500,804480,931188,-126708
4691,85,501604,500,804580,931688,-127108
4691,85,501604,50,804530,932196,-127666
4691,85,501604,50,804580,932743,-128163
4691,85,501604,500,805080,933696,-128616
4691,85,501604,500,805080,934290,-129210
4691,85,501604,50,805130,934538,-129408
4691,85,501604,500,805580,934896,-129316
4691,85,501604,50,805180,935238,-130058
4691,85,501604,500,805680,935643,-129963
4692,88,501725,500,806080,936596,-130516
4692,88,501725,500,806180,937096,-130916
4692,88,501725,500,806580,938146,-131566
4692,88,501725,50,806230,938593,-132363
4692,88,501725,50,806280,939038,-132758
4692,88,501725,500,806780,939393,-132613
4692,88,501725,500,807080,940390,-133310
4692,88,501725,500,807280,940688,-133408
4692,88,501725,500,807580,941493,-133913
4692,88,501725,500,807780,942040,-134260
4692,88,501725,500,808080,942593,-134513
4692,88,501725,50,807830,943040,-135210
4692,88,501725,50,807880,943743,-135863
4693,82,501877,50,807930,944038,-136108
4693,82,501877,500,808430,944643,-136213
4693,82,501877,500,808580,945293,-136713
4693,82,501877,50,808480,946143,-137663
4693,82,501877,50,808530,947143,-138613
4693,82,501877,50,808580,947893,-139313
4693,82,501877,50,808630,948388,-139758
4693,82,501877,500,809080,948840,-139760
4693,82,501877,500,809130,949196,-140066
4694,86,501942,50,809130,949746,-140616
4694,86,501942,50,809180,949943,-140763
4694,86,501942,50,809180,950490,-141310
4694,86,501942,500,809680,951296,-141616
4694,86,501942,50,809230,952393,-143163
4694,86,501942,50,809280,952846,-143566
4694,86,501942,500,809780,953793,-144013
4694,86,501942,50,809730,954438,-144708
4694,86,501942,500,810230,955093,-144863
4694,86,501942,500,810280,955340,-145060
4694,86,501942,500,810730,955988,-145258
4694,86,501942,50,810330,956538,-146208
4693,82,501877,50,810380,956940,-146560
4695,81,502131,500,810880,957643,-146763
4695,81,502131,500,811230,958238,-147008
4695,81,502131,50,810930,958590,-147660
4695,81,502131,500,811430,959640,-148210
4695,81,502131,50,811280,959796,-148516
4695,81,502131,500,811780,960690,-148910
4695,81,502131,50,811480,960993,-149513
4695,81,502131,500,811980,961543,-149563
4695,81,502131,50,811830,961888,-150058
4695,81,502131,500,812330,962490,-150160
4695,81,502131,500,812480,963438,-150958
4696,87,502141,50,812380,964143,-151763
4696,87,502141,500,812880,964746,-151866
4696,87,502141,50,812530,965638,-153108
4696,87,502141,50,812580,966193,-153613
4696,87,502141,500,813080,966796,-153716
4696,87,502141,50,812930,967388,-154458
4696,87,502141,500,813430,967946,-154516
4696,87,502141,50,813130,968843,-155713
4696,87,502141,50,813180,969596,-156416
4696,87,502141,500,813680,970343,-156663
4696,87,502141,50,813480,970843,-157363
4696,87,502141,50,813530,971246,-157716
4696,87,502141,500,814030,971488,-157458
4697,81,502190,50,813730,972246,-158516
4697,81,502190,50,813780,972843,-159063
4697,81,502190,500,814280,973040,-158760
4697,81,502190,500,814530,973443,-158913
4697,81,502190,500,814780,974038,-159258
4697,81,502190,50,814580,974590,-160010
4697,81,502190,500,815080,975590,-160510
4697,81,502190,500,815280,976090,-160810
4697,81,502190,50,815130,976843,-161713
4695,81,502131,50,815180,977588,-162408
4695,81,502131,500,815680,978240,-162560
4696,87,502141,500,815780,978643,-162863
4696,87,502141,50,815730,979340,-163610
4697,81,502190,500,816230,979838,-163608
4698,80,502455,500,816280,981193,-164913
4698,80,502455,50,816280,981793,-165513
4698,80,502455,50,816330,982393,-166063
4698,80,502455,500,816780,982493,-165713
4698,80,502455,50,816380,983393,-167013
4698,80,502455,500,816880,984190,-167310
4698,80,502455,50,816830,984788,-167958
4698,80,502455,500,817330,985443,-168113
4698,80,502455,50,816930,985888,-168958
4698,80,502455,500,817430,986296,-168866
4698,80,502455,500,817830,986693,-168863
4698,80,502455,50,817480,987238,-169758
4698,80,502455,500,817980,987490,-169510
4698,80,502455,50,817880,987843,-169963
4699,89,502525,500,818380,988343,-169963
4699,89,502525,50,818030,988743,-170713
4699,89,502525,500,818530,989338,-170808
4699,89,502525,50,818430,989796,-171366
4699,89,502525,500,818930,990446,-171516
4699,89,502525,50,818580,991446,-172866
4699,89,502525,500,819080,992293,-173213
4699,89,502525,50,818980,992596,-173616
4698,80,502455,500,819480,993343,-173863
4699,89,502525,50,819130,993893,-174763
4700,83,502710,500,819630,994493,-174863
4700,83,502710,500,819980,994990,-175010
4700,83,502710,50,819680,995990,-176310
4700,83,502710,500,820180,996646,-176466
4700,83,502710,50,820030,998043,-178013
4700,83,502710,500,820530,998388,-177858
4700,83,502710,500,820680,999043,-178363
4700,83,502710,50,820580,999946,-179366
4700,83,502710,500,821080,999988,-178908
4701,85,502837,50,820730,681430,139300
4701,85,502837,50,820780,682580,138200
4701,85,502837,500,821280,685130,136150
4701,85,502837,500,821580,687730,133850
4701,85,502837,50,821330,688580,132750
4701,85,502837,500,821830,690330,131500
4701,85,502837,500,822080,691080,131000
4701,85,502837,500,822330,692680,129650
4701,85,502837,500,822580,694180,128400
4701,85,502837,50,822380,696280,126100
4702,80,503002,50,822430,697880,124550
4702,80,503002,50,822480,699480,123000
4702,80,503002,50,822530,702080,120450
4702,80,503002,500,823030,703330,119700
4702,80,503002,500,823080,705430,117650
4702,80,503002,50,823080,706480,116600
4702,80,503002,500,823580,707530,116050
4702,80,503002,500,823580,709230,114350
4702,80,503002,50,823630,711780,111850
4703,86,503013,500,824080,713430,110650
4703,86,503013,500,824130,714580,109550
4703,86,503013,500,824580,715830,108750
4703,86,503013,500,824630,716780,107850
4703,86,503013,500,825080,717430,107650
4703,86,503013,500,825130,718730,106400
4703,86,503013,500,825580,720330,105250
4704,89,503093,500,825630,722380,103250
4704,89,503093,50,825630,723430,102200
4704,89,503093,50,825680,724230,101450
4704,89,503093,500,826130,726330,99800
4704,89,503093,3150,825730,727430,98300
4704,89,503093,800,826230,728080,98150
4704,89,503093,1950,826180,729580,96600
4704,89,503093,2200,826680,730380,96300
4704,89,503093,2800,826730,732780,93950
4704,89,503093,4300,826730,734380,92350
4704,89,503093,1900,826780,736430,90350
4704,89,503093,2050,827230,737530,89700
4704,89,503093,1850,827280,738280,89000
4705,80,503098,2200,827280,739280,88000
4705,80,503098,4300,827330,742030,85300
4705,80,503098,2150,827780,743130,84650
4705,80,503098,4300,827830,744230,83600
4705,80,503098,2750,827830,746880,80950
4705,80,503098,1850,827880,748430,79450
4703,86,503013,1600,828330,749480,78850
4703,86,503013,3200,828380,750880,77500
4706,81,503133,2450,828380,751830,76550
4706,81,503133,4150,828880,752980,75900
4706,81,503133,2650,828880,753680,75200
4706,81,503133,3700,829380,754980,74400
4706,81,503133,2950,828930,756130,72800
4706,81,503133,3350,828980,756880,72100
4706,81,503133,3300,829030,757930,71100
4706,81,503133,3400,829080,759430,69650
4706,81,503133,3300,829130,761730,67400
4707,86,503156,2900,829630,763780,65850
4707,86,503156,4700,829880,765380,64500
4707,86,503156,3850,830130,766380,63750
4707,86,503156,1800,830380,767680,62700
4707,86,503156,4300,830630,768830,61800
4707,86,503156,4250,830430,771030,59400
4707,86,503156,6300,830930,772980,57950
4707,86,503156,3050,830680,773830,56850
4707,86,503156,4800,830730,775130,55600
4707,86,503156,2750,830780,777030,53750
4707,86,503156,6450,831280,777330,53950
4707,86,503156,3600,831430,779380,52050
4704,89,503093,1750,831780,780580,51200
4704,89,503093,4700,831930,781780,50150
4708,85,503203,3200,832280,783380,48900
4708,85,503203,2350,831980,784830,47150
4708,85,503203,4450,832030,786880,45150
4708,85,503203,3750,832530,788180,44350
4708,85,503203,2850,832780,790130,42650
4708,85,503203,2900,832580,791930,40650
4708,85,503203,3600,833080,794030,39050
4706,81,503133,1350,833280,795030,38250
4706,81,503133,4300,833130,796880,36250
4709,82,503243,6250,833180,797830,35350
4709,82,503243,1850,833230,799030,34200
4709,82,503243,4350,833280,800080,33200
4709,82,503243,3400,833780,800730,33050
4709,82,503243,2350,833330,804030,29300
4709,82,503243,4150,833830,805630,28200
4709,82,503243,5450,834280,807780,26500
4709,82,503243,2350,833880,808830,25050
4709,82,503243,3850,833930,810280,23650
4709,82,503243,3800,834430,811330,23100
4709,82,503243,3800,834330,813180,21150
4707,86,503156,2250,834380,814280,20100
4707,86,503156,2150,834430,814880,19550
4710,80,503336,750,834480,816030,18450
4710,80,503336,3450,834480,818280,16200
4710,80,503336,3400,834980,820230,14750
4710,80,503336,5650,834980,821280,13700
4710,80,503336,4300,835480,822330,13150
4710,80,503336,2800,835480,824730,10750
4710,80,503336,3350,835980,825780,10200
4710,80,503336,1700,835980,827430,8550
4710,80,503336,1950,836480,828980,7500
4710,80,503336,4250,836480,830030,6450
4710,80,503336,1850,836530,831430,5100
4709,82,503243,3900,836530,833130,3400
4709,82,503243,2950,837030,834780,2250
4710,80,503336,2250,836580,836630,-50
4711,83,503560,3700,836630,837980,-1350
4711,83,503560,4050,836680,838530,-1850
4711,83,503560,4200,837180,840030,-2850
4711,83,503560,3850,837080,841080,-4000
4711,83,503560,2450,837130,843230,-6100
4711,83,503560,1250,837180,845680,-8500
4711,83,503560,2750,837230,846880,-9650
4711,83,503560,3350,837230,848880,-11650
4711,83,503560,3700,837280,851180,-13900
4711,83,503560,3200,837280,852480,-15200
4711,83,503560,1800,837330,852680,-15350
4712,84,503566,4900,837330,854780,-17450
4712,84,503566,4400,837380,855880,-18500
4712,84,503566,2200,837830,857180,-19350
4712,84,503566,4300,837880,858830,-20950
4712,84,503566,3350,838330,860830,-22500
4712,84,503566,1750,837930,862080,-24150
4712,84,503566,5050,838430,864180,-25750
4712,84,503566,4900,838830,866730,-27900
4712,84,503566,3800,838480,868230,-29750
4712,84,503566,3150,838530,868180,-29650
4712,84,503566,1300,838580,869230,-30650
4712,84,503566,2350,839080,871380,-32300
4712,84,503566,3900,839330,872680,-33350
4712,84,503566,2800,839580,873330,-33750
4713,82,503576,4250,839830,875580,-35750
4713,82,503576,2300,839630,877230,-37600
4713,82,503576,2650,839680,879180,-39500
4713,82,503576,3800,840180,880630,-40450
4713,82,503576,4350,840330,882280,-41950
4712,84,503566,1850,840230,883830,-43600
4712,84,503566,4350,840730,884480,-43750
4712,84,503566,5300,840380,885530,-45150
4713,82,503576,4700,840430,886830,-46400
4714,80,503866,2300,840480,888430,-47950
4714,80,503866,4050,840980,890980,-50000
4714,80,503866,2850,840780,891980,-51200
4714,80,503866,800,840830,893130,-52300
4714,80,503866,1650,841330,895180,-53850
4714,80,503866,2250,841030,895780,-54750
4714,80,503866,4300,841530,897930,-56400
4714,80,503866,1850,841830,898580,-56750
4714,80,503866,1750,841580,900780,-59200
4714,80,503866,2200,842080,902180,-60100
4714,80,503866,2550,841880,903730,-61850
4715,88,503868,4350,841930,905730,-63800
4715,88,503868,2800,842430,906880,-64450
4715,88,503868,1600,842130,908330,-66200
4715,88,503868,3100,842630,910030,-67400
4715,88,503868,2350,842480,910180,-67700
4715,88,503868,3450,842980,911680,-68700
4715,88,503868,3350,842680,913330,-70650
4715,88,503868,2250,843180,914530,-71350
4715,88,503868,4000,843030,916580,-73550
4715,88,503868,2150,843080,917380,-74300
4715,88,503868,2700,843580,918730,-75150
4715,88,503868,3850,843680,921330,-77650
4715,88,503868,2200,844080,922880,-78800
4716,89,503878,2850,843730,923980,-80250
4716,89,503878,2800,844230,924530,-80300
4716,89,503878,1700,844130,925930,-81800
4716,89,503878,1750,844630,927980,-83350
4716,89,503878,3350,844730,928830,-84100
4716,89,503878,5200,845130,930330,-85200
4716,89,503878,3900,845230,931430,-86200
4716,89,503878,3350,845180,933230,-88050
4716,89,503878,3200,845680,935680,-90000
4716,89,503878,2650,845730,936980,-91250
4716,89,503878,4700,846180,939130,-92950
4716,89,503878,2800,845780,940180,-94400
4716,89,503878,1900,845830,941930,-96100
4716,89,503878,2300,845880,943030,-97150
4714,80,503866,2800,845930,943680,-97750
4715,88,503868,3900,845980,945680,-99700
4717,89,504031,3850,846030,947780,-101750
4717,89,504031,3300,846530,949430,-102900
4717,89,504031,3400,846230,951730,-105500
4717,89,504031,1800,846280,953130,-106850
4717,89,504031,1200,846330,954280,-107950
4717,89,504031,1800,846830,955980,-109150
4717,89,504031,3750,846580,957980,-111400
4717,89,504031,2650,846630,958980,-112350
4717,89,504031,2050,846680,959630,-112950
4717,89,504031,4100,847180,961730,-114550
4718,85,504318,2900,847330,963830,-116500
4718,85,504318,1900,847230,964780,-117550
4718,85,504318,5400,847280,967830,-120550
4718,85,504318,3000,847780,969030,-121250
4718,85,504318,4150,847380,970530,-123150
4719,88,504346,3250,847880,972330,-124450
4719,88,504346,3750,848280,973430,-125150
4719,88,504346,2900,848380,974530,-126150
4719,88,504346,4350,848780,974980,-126200
4719,88,504346,4750,848430,976580,-128150
4719,88,504346,1950,848480,978280,-129800
4719,88,504346,2750,848980,979880,-130900
4719,88,504346,750,848830,981830,-133000
4720,83,504410,3150,848880,984030,-135150
4720,83,504410,3950,848930,985630,-136700
4720,83,504410,850,848980,986880,-137900
4720,83,504410,3950,849030,988430,-139400
4720,83,504410,2750,849480,989930,-140450
4720,83,504410,1650,849530,991630,-142100
4720,83,504410,3750,849980,992680,-142700
4720,83,504410,2700,850030,995480,-145450
4720,83,504410,1700,850480,997180,-146700
4720,83,504410,1650,850530,998780,-148250
4720,83,504410,1650,850980,999430,-148450
4720,83,504410,3350,851030,999980,-148950
4720,83,504410,1650,851030,990930,-139900
4718,85,504318,1950,851080,992480,-141400
4718,85,504318,3900,851080,994230,-143150
4719,88,504346,6900,851130,995280,-144150
4719,88,504346,3450,851130,996780,-145650
4721,88,504517,2650,851630,997830,-146200
4721,88,504517,2400,852891,999530,-146639
4721,88,504517,2800,852176,999780,-147604
4721,88,504517,2250,853226,986480,-133254
4721,88,504517,1800,857141,988030,-130889
4722,86,504769,3250,857176,988630,-131454
4722,86,504769,5750,858176,990580,-132404
4722,86,504769,3900,859876,991080,-131204
4722,86,504769,4450,862126,992180,-130054
4722,86,504769,2800,863226,992930,-129704
4722,86,504769,3650,864791,993980,-129189
4722,86,504769,2450,867226,996080,-128854
4722,86,504769,3900,867691,997080,-129389
4722,86,504769,3650,870241,998280,-128039
4722,86,504769,3200,870526,999930,-129404
4723,83,504857,3300,872076,999980,-127904
4723,83,504857,4300,874041,709430,164611
4723,83,504857,3700,876576,709680,166896
4723,83,504857,2800,876741,709930,166811
4723,83,504857,4800,878891,709730,169161
4723,83,504857,6800,881976,710230,171746
4723,83,504857,2800,883576,710430,173146
4723,83,504857,1600,887341,710730,176611
4723,83,504857,5700,887841,710930,176911
4724,85,504865,2300,887776,710780,176996
4724,85,504865,3400,889526,710830,178696
4724,85,504865,2200,890241,710880,179361
4724,85,504865,2450,891341,711380,179961
4724,85,504865,3200,892941,710980,181961
4724,85,504865,1700,895241,711580,183661
4724,85,504865,3250,894976,712080,182896
4724,85,504865,1400,897226,712380,184846
4724,85,504865,3500,897726,712580,185146
4724,85,504865,4750,899841,712880,186961
4725,90,504868,4750,902026,712630,189396
4725,90,504868,3900,905576,712680,192896
4725,90,504868,450,903876,712730,191146
4725,90,504868,3800,905941,712780,193161
4725,90,504868,3550,908591,711480,197111
4725,90,504868,1700,910191,711880,198311
4725,90,504868,1700,908776,711530,197246
4722,86,504769,5150,912791,712830,199961
4722,86,504769,4150,913776,713330,200446
4722,86,504769,2400,914276,713380,200896
4726,82,504891,3400,915926,713830,202096
4726,82,504891,3650,917541,713880,203661
4726,82,504891,1250,918076,713880,204196
4726,82,504891,2350,920826,714380,206446
4726,82,504891,3800,920991,713930,207061
4726,82,504891,2150,921991,714430,207561
4726,82,504891,3300,924241,714430,209811
4726,82,504891,2000,923976,714930,209046
4727,81,504937,3300,925526,714480,211046
4727,81,504937,4750,935491,714530,220961
4727,81,504937,2200,928576,714580,213996
4727,81,504937,3300,936091,714630,221461
4727,81,504937,4700,931941,715130,216811
4727,81,504937,3000,936591,714980,221611
4727,81,504937,4700,935326,715480,219846
4727,81,504937,3650,938376,715180,223196
4727,81,504937,3400,940741,715230,225511
4723,83,504857,2100,940726,715280,225446
4725,90,504868,4650,942826,715780,227046
4728,82,504972,3300,944441,715980,228461
4728,82,504972,3300,951426,715830,235596
4728,82,504972,3600,952391,716330,236061
4728,82,504972,5900,949691,716030,233661
4728,82,504972,2150,951976,716080,235896
4728,82,504972,1750,952476,716130,236346
4728,82,504972,1700,955491,716630,238861
4728,82,504972,5350,958791,716380,242411
4728,82,504972,2350,956526,716430,240096
4728,82,504972,4650,958526,716930,241596
4726,82,504891,2700,960126,717130,242996
4729,84,505002,4500,962191,716980,245211
4729,84,505002,4000,963941,717030,246911
4729,84,505002,2900,965226,717530,247696
4729,84,505002,1700,965791,717180,248611
4729,84,505002,4950,968041,717630,250411
4729,84,505002,2400,969176,717680,251496
4729,84,505002,2300,970291,717730,252561
4729,84,505002,4950,972441,718180,254261
4729,84,505002,3500,973926,717780,256146
4729,84,505002,3250,975341,717830,257511
4729,84,505002,4800,977676,718330,259346
4730,89,505119,3150,979176,718230,260946
4730,89,505119,1300,979876,718730,261146
4730,89,505119,4200,981691,718830,262861
4730,89,505119,3450,985541,719230,266311
4730,89,505119,1750,984241,717680,266561
4730,89,505119,3950,986691,717580,269111
4730,89,505119,1350,986226,718880,267346
4730,89,505119,2200,987376,719380,267996
4730,89,505119,2950,990141,719730,270411
4730,89,505119,2750,989726,719880,269846
4731,86,505151,2850,991526,719780,271746
4731,86,505151,4200,995276,720280,274996
4731,86,505151,4450,995491,719930,275561
4731,86,505151,2700,996826,719980,276846
4731,86,505151,3350,998391,720480,277911
4731,86,505151,2950,999976,720780,279196
4731,86,505151,500,865280,720530,144750
4731,86,505151,500,865530,721030,144500
4730,89,505119,50,865330,721330,144000
4732,80,505488,500,865830,721530,144300
4732,80,505488,50,865580,721380,144200
4732,80,505488,50,865630,721430,144200
4732,80,505488,50,865680,721480,144200
4732,80,505488,50,865730,721530,144200
4732,80,505488,50,865780,722030,143750
4732,80,505488,500,866280,721580,144700
4732,80,505488,50,865880,721630,144250
4732,80,505488,50,865930,722130,143800
4732,80,505488,500,866430,722530,143900
4732,80,505488,50,866330,722580,143750
4733,90,505548,500,866830,723080,143750
4733,90,505548,500,866930,723130,143800
4733,90,505548,500,867330,723130,144200
4733,90,505548,500,867430,723630,143800
4733,90,505548,50,867380,723630,143750
4733,90,505548,500,867880,723680,144200
4733,90,505548,500,867930,723680,144250
4733,90,505548,500,868380,723730,144650
4733,90,505548,500,868430,723730,144700
4733,90,505548,50,868430,723780,144650
4732,80,505488,500,868930,723780,145150
4734,88,505606,500,868930,723830,145100
4734,88,505606,50,868980,723830,145150
4734,88,505606,50,868980,724330,144650
4734,88,505606,500,869480,720830,148650
4734,88,505606,500,869480,724880,144600
4734,88,505606,50,869530,724880,144650
4734,88,505606,500,869980,725380,144600
4734,88,505606,50,869580,725380,144200
4734,88,505606,500,870080,725880,144200
4733,90,505548,50,870030,725880,144150
4733,90,505548,500,870530,725930,144600
4733,90,505548,50,870130,725930,144200
4733,90,505548,500,870630,725980,144650
4735,85,505785,500,871030,722630,148400
4735,85,505785,50,870680,726430,144250
4735,85,505785,500,871180,726480,144700
4735,85,505785,50,871080,726930,144150
4735,85,505785,500,871580,726980,144600
4735,85,505785,500,871680,726980,144700
4735,85,505785,50,871630,727030,144600
4735,85,505785,50,871680,727030,144650
4735,85,505785,500,872180,727530,144650
4735,85,505785,50,871730,727530,144200
4735,85,505785,500,872230,728030,144200
4735,85,505785,50,872230,727580,144650
4735,85,505785,500,872730,725491,147239
4736,84,505824,500,872730,726641,146089
4736,84,505824,50,872780,727291,145489
4736,84,505824,500,873230,728541,144689
4736,84,505824,500,873280,730091,143189
4736,84,505824,50,873280,730991,142289
4736,84,505824,500,873780,732491,141289
4736,84,505824,500,873780,733941,139839
4736,84,505824,50,873830,735991,137839
4736,84,505824,500,874280,737991,136289
4737,82,505912,500,874330,738491,135839
4737,82,505912,500,874780,740091,134689
4737,82,505912,50,874380,742141,132239
4737,82,505912,500,874880,743441,131439
4737,82,505912,50,874830,744641,130189
4737,82,505912,500,875330,746091,129239
4737,82,505912,50,874930,747191,127739
4737,82,505912,500,875430,748291,127139
4737,82,505912,50,875380,750091,125289
4737,82,505912,50,875430,752091,123339
4737,82,505912,50,875480,754291,121189
4737,82,505912,50,875480,756291,119189
4737,82,505912,50,875530,757541,117989
4737,82,505912,50,875530,758141,117389
4737,82,505912,50,875580,761141,114439
4736,84,505824,50,875580,762591,112989
4736,84,505824,500,876080,763691,112389
4738,90,505980,500,876080,764941,111139
4738,90,505980,500,876580,766191,110389
4738,90,505980,500,876580,767341,109239
4738,90,505980,500,877080,768891,108189
4738,90,505980,500,877080,770441,106639
4738,90,505980,500,877580,771441,106139
4738,90,505980,500,877580,773391,104189
4738,90,505980,500,878080,775041,103039
4739,90,505991,500,878080,777791,100289
4739,90,505991,50,878130,779391,98739
4739,90,505991,50,878130,781591,96539
4739,90,505991,50,878180,784241,93939
4739,90,505991,50,878180,785691,92489
4737,82,505912,50,878230,786941,91289
4740,89,506047,500,878680,787591,91089
4740,89,506047,50,878280,788891,89389
4740,89,506047,50,878330,789991,88339
4740,89,506047,50,878380,791591,86789
4740,89,506047,500,878880,793491,85389
4740,89,506047,500,879180,795541,83639
4740,89,506047,50,878930,797241,81689
4740,89,506047,500,879430,799791,79639
4740,89,506047,500,879680,800841,78839
4738,90,505980,50,879480,803041,76439
4739,90,505991,500,879980,805041,74939
4739,90,505991,50,879730,806891,72839
4740,89,506047,500,880230,808991,71239
4741,81,506342,50,880030,809691,70339
4741,81,506342,500,880530,810791,69739
4741,81,506342,500,880730,812791,67939
4741,81,506342,50,880580,813291,67289
4741,81,506342,50,880630,813941,66689
4741,81,506342,500,881130,815491,65639
4741,81,506342,500,881230,816991,64239
4741,81,506342,500,881630,818541,63089
4741,81,506342,500,881730,820641,61089
4741,81,506342,50,881680,821891,59789
4741,81,506342,50,881730,823541,58189
4741,81,506342,50,881780,825041,56739
4741,81,506342,500,882230,828141,54089
4741,81,506342,50,881830,828641,53189
4742,89,506566,500,882330,830091,52239
4742,89,506566,500,882730,831091,51639
4742,89,506566,50,882380,832341,50039
4742,89,506566,500,882880,833991,48889
4742,89,506566,500,883230,835241,47989
4742,89,506566,500,883380,836891,46489
4742,89,506566,50,883280,839341,43939
4742,89,506566,500,883780,841091,42689
4742,89,506566,50,883430,842791,40639
4742,89,506566,50,883480,843341,40139
4742,89,506566,50,883530,845291,38239
4742,89,506566,500,884030,846491,37539
4743,80,506677,50,883830,847341,36489
4743,80,506677,500,884330,849591,34739
4743,80,506677,500,884530,851191,33339
4743,80,506677,50,884380,852641,31739
4743,80,506677,500,884880,853391,31489
4743,80,506677,50,884580,854491,30089
4743,80,506677,50,884630,855991,28639
4743,80,506677,50,884680,857141,27539
4743,80,506677,500,885180,858691,26489
4743,80,506677,50,884930,859591,25339
4743,80,506677,500,885430,861141,24289
4743,80,506677,50,885230,863541,21689
4744,87,506963,50,885280,864241,21039
4744,87,506963,500,885780,866391,19389
4744,87,506963,50,885480,867941,17539
4744,87,506963,50,885530,868591,16939
4744,87,506963,500,886030,869691,16339
4744,87,506963,50,885830,871891,13939
4744,87,506963,50,885880,872941,12939
4745,86,507188,500,886380,875091,11289
4745,86,507188,50,886080,876841,9239
4745,86,507188,50,886130,878391,7739
4745,86,507188,500,886630,879491,7139
4745,86,507188,50,886430,881541,4889
4745,86,507188,50,886480,883341,3139
4745,86,507188,50,886530,883891,2639
4745,86,507188,500,887030,885541,1489
4745,86,507188,500,887130,887591,-461
4745,86,507188,50,887080,888791,-1711
4745,86,507188,50,887130,890541,-3411
4746,84,507191,50,887180,892141,-4961
4746,84,507191,50,887180,893791,-6611
4746,84,507191,50,887230,894441,-7211
4746,84,507191,500,887680,896391,-8711
4746,84,507191,50,887280,898091,-10811
4746,84,507191,50,887330,899241,-11911
4746,84,507191,50,887380,901241,-13861
4746,84,507191,500,887880,901891,-14011
4746,84,507191,500,888180,904341,-16161
4746,84,507191,50,887930,905441,-17511
4746,84,507191,50,887980,907641,-19661
4746,84,507191,50,888030,909241,-21211
4745,86,507188,50,888080,910491,-22411
4747,88,507368,50,888130,910991,-22861
4747,88,507368,500,888630,912591,-23961
4747,88,507368,500,888680,914141,-25461
4747,88,507368,500,889130,915241,-26111
4747,88,507368,50,888730,916741,-28011
4747,88,507368,50,888780,919491,-30711
4747,88,507368,50,888830,920891,-32061
4747,88,507368,500,889330,921391,-32061
4747,88,507368,500,889630,923391,-33761
4747,88,507368,50,889380,924491,-35111
4747,88,507368,50,889430,926091,-36661
4747,88,507368,500,889930,927141,-37211
4748,80,507539,50,889680,928091,-38411
4748,80,507539,500,890180,930141,-39961
4748,80,507539,500,890430,931391,-40961
4748,80,507539,500,890680,933341,-42661
4748,80,507539,50,890480,935191,-44711
4748,80,507539,500,890980,936391,-45411
4748,80,507539,50,890730,937041,-46311
4748,80,507539,500,891230,938191,-46961
4748,80,507539,50,891030,939341,-48311
4748,80,507539,500,891530,940491,-48961
4748,80,507539,50,891280,941541,-50261
4748,80,507539,50,891330,942241,-50911
4748,80,507539,500,891830,942841,-51011
4748,80,507539,500,892030,945391,-53361
4748,80,507539,500,892330,947591,-55261
4748,80,507539,500,892530,949491,-56961
4748,80,507539,500,892830,949591,-56761
4749,84,507765,50,892580,951641,-59061
4749,84,507765,500,893080,954341,-61261
4749,84,507765,50,892880,956041,-63161
4749,84,507765,500,893380,956841,-63461
4749,84,507765,50,893130,957891,-64761
4749,84,507765,50,893180,959741,-66561
4749,84,507765,500,893680,960941,-67261
4749,84,507765,500,893880,962691,-68811
4749,84,507765,500,894180,964391,-70211
4749,84,507765,50,893930,964941,-71011
4749,84,507765,500,894430,966741,-72311
4749,84,507765,500,894680,968441,-73761
4749,84,507765,50,894480,971041,-76561
4749,84,507765,50,894530,973141,-78611
4750,81,507904,500,895030,973841,-78811
4750,81,507904,50,894730,975391,-80661
4750,81,507904,500,895230,975941,-80711
4750,81,507904,500,895530,977991,-82461
4750,81,507904,50,895280,980091,-84811
4750,81,507904,50,895330,981091,-85761
4750,81,507904,50,895380,983641,-88261
4750,81,507904,500,895880,985291,-89411
4750,81,507904,500,896030,987641,-91611
4750,81,507904,500,896380,989191,-92811
4750,81,507904,50,896080,990741,-94661
4751,83,508129,50,896130,991891,-95761
4751,83,508129,500,896630,993091,-96461
4751,83,508129,50,896430,993791,-97361
4751,83,508129,50,896480,994891,-98411
4751,83,508129,50,896530,995591,-99061
4751,83,508129,50,896580,997141,-100561
4751,83,508129,500,897080,998341,-101261
4751,83,508129,500,897130,999191,-102061
4751,83,508129,50,897130,999991,-102861
4751,83,508129,500,897630,756530,141100
4752,83,508261,50,897180,757030,140150
4752,83,508261,500,897680,757030,140650
4752,83,508261,50,897680,757530,140150
4752,83,508261,500,898180,757530,140650
4752,83,508261,500,898180,758030,140150
4753,81,508352,500,898680,757580,141100
4753,81,508352,50,898230,758080,140150
4753,81,508352,50,898280,758080,140200
4753,81,508352,50,898330,758580,139750
4753,81,508352,50,898380,759080,139300
4753,81,508352,500,898880,759080,139800
4753,81,508352,500,899180,759580,139600
4753,81,508352,500,899380,759580,139800
4753,81,508352,50,899230,759630,139600
4753,81,508352,500,899730,760080,139650
4753,81,508352,50,899430,759680,139750
4753,81,508352,500,899930,760180,139750
4753,81,508352,50,899780,760130,139650
4753,81,508352,50,899830,760180,139650
4753,81,508352,500,900330,760230,140100
4754,81,508543,50,899980,760680,139300
4754,81,508543,500,900480,760730,139750
4754,81,508543,500,900830,761180,139650
4754,81,508543,50,900530,761230,139300
4754,81,508543,50,900580,761680,138900
4754,81,508543,50,900630,761730,138900
4754,81,508543,50,900680,756480,144200
4754,81,508543,50,900730,756530,144200
4754,81,508543,50,900780,758580,142200
4755,86,508548,500,901280,762230,139050
4755,86,508548,50,900880,762230,138650
4755,86,508548,50,900930,762280,138650
4755,86,508548,50,900980,762730,138250
4755,86,508548,50,901030,762330,138700
4755,86,508548,50,901080,762380,138700
4756,80,508561,50,901130,762180,138950
4756,80,508561,500,901630,762430,139200
4756,80,508561,500,901780,762930,138850
4756,80,508561,50,901680,762780,138900
4756,80,508561,500,902180,762830,139350
4756,80,508561,500,902280,762880,139400
4756,80,508561,50,902230,763380,138850
4756,80,508561,500,902730,763430,139300
4757,89,508597,500,902780,763880,138900
4757,89,508597,50,902780,763930,138850
4757,89,508597,500,903280,763930,139350
4757,89,508597,500,903280,764430,138850
4757,89,508597,50,903330,764430,138900
4757,89,508597,500,903780,764480,139300
4757,89,508597,500,903830,764930,138900
4757,89,508597,50,903830,764980,138850
4757,89,508597,500,904330,764980,139350
4757,89,508597,50,903880,765480,138400
4757,89,508597,500,904380,765480,138900
4757,89,508597,500,904830,765530,139300
4757,89,508597,50,904430,765980,138450
4754,81,508543,50,904480,766030,138450
4754,81,508543,500,904980,766530,138450
4755,86,508548,50,904880,766530,138350
4755,86,508548,500,905380,767030,138350
4756,80,508561,50,905030,767030,138000
4756,80,508561,500,905530,767080,138450
4756,80,508561,500,905880,767080,138800
4758,83,508696,500,906030,767130,138900
4758,83,508696,50,905930,767180,138750
4758,83,508696,500,906430,767230,139200
4758,83,508696,50,906080,767280,138800
4758,83,508696,50,906130,767330,138800
4758,83,508696,50,906180,767830,138350
4758,83,508696,500,906680,768080,138600
4758,83,508696,50,906480,767880,138600
4758,83,508696,50,906530,768380,138150
4758,83,508696,500,907030,766480,140550
4758,83,508696,500,907180,767580,139600
4757,89,508597,50,907080,768130,138950
4759,87,508922,50,907130,768180,138950
4759,87,508922,50,907180,768680,138500
4759,87,508922,500,907680,768880,138800
4759,87,508922,500,907680,768730,138950
4759,87,508922,500,908180,768780,139400
4759,87,508922,500,908180,769280,138900
4759,87,508922,500,908680,768930,139750
4759,87,508922,50,908230,769430,138800
4759,87,508922,500,908730,769780,138950
4759,87,508922,500,909180,769930,139250
4759,87,508922,50,908780,769830,138950
4759,87,508922,50,908830,769880,138950
4760,88,508943,50,908880,770380,138500
4760,88,508943,500,909380,769980,139400
4760,88,508943,500,909680,770480,139200
4760,88,508943,50,909430,770430,139000
4760,88,508943,50,909480,770480,139000
4760,88,508943,500,909980,770530,139450
4760,88,508943,50,909730,770980,138750
4760,88,508943,50,909780,771030,138750
4760,88,508943,50,909830,771480,138350
4760,88,508943,500,910330,771530,138800
4760,88,508943,500,910480,771980,138500
4761,85,508956,500,910830,772030,138800
4761,85,508956,500,910980,772480,138500
4761,85,508956,500,911330,772080,139250
4761,85,508956,500,911480,772580,138900
4761,85,508956,500,911830,772530,139300
4761,85,508956,50,911530,773030,138500
4762,88,508961,500,912030,773080,138950
4762,88,508961,500,912330,773080,139250
4762,88,508961,500,912530,773130,139400
4762,88,508961,500,912830,773680,139150
4762,88,508961,500,913030,773730,139300
4762,88,508961,50,912880,774180,138700
4762,88,508961,500,913380,773780,139600
4762,88,508961,50,913080,773830,139250
4762,88,508961,500,913580,774330,139250
4762,88,508961,50,913430,774230,139200
4762,88,508961,500,913930,774280,139650
4762,88,508961,500,914080,774330,139750
4762,88,508961,50,913980,774380,139600
4760,88,508943,50,914030,774380,139650
4761,85,508956,500,914530,773580,140950
4763,85,509139,50,914130,773180,140950
4763,85,509139,50,914180,773680,140500
4763,85,509139,500,914680,773630,141050
4763,85,509139,50,914580,774880,139700
4763,85,509139,500,915080,774880,140200
4763,85,509139,500,915180,775380,139800
4763,85,509139,50,915130,774930,140200
4763,85,509139,50,915180,775430,139750
4763,85,509139,500,915680,775430,140250
4763,85,509139,500,915680,775930,139750
4763,85,509139,50,915730,775480,140250
4764,89,509173,500,916180,775980,140200
4764,89,509173,50,915780,776430,139350
4764,89,509173,50,915830,776480,139350
4764,89,509173,500,916330,776530,139800
4764,89,509173,500,916680,776580,140100
4764,89,509173,50,916380,776630,139750
4763,85,509139,50,916430,776680,139750
4763,85,509139,500,916930,776730,140200
4764,89,509173,500,917180,777230,139950
4765,80,509401,50,916980,776980,140000
4765,80,509401,500,917480,777480,140000
4765,80,509401,500,917680,777730,139950
4765,80,509401,50,917530,778030,139500
4765,80,509401,500,918030,778530,139500
4765,80,509401,50,917730,778280,139450
4765,80,509401,50,917780,778330,139450
4765,80,509401,50,917830,778380,139450
4765,80,509401,500,918330,778430,139900
4765,80,509401,50,918080,778930,139150
4765,80,509401,50,918130,779030,139100
4765,80,509401,500,918630,776930,141700
4765,80,509401,50,918380,777980,140400
4766,85,509407,50,918430,778230,140200
4766,85,509407,500,918930,779430,139500
4766,85,509407,500,919130,779530,139600
4766,85,509407,500,919430,779480,139950
4766,85,509407,500,919630,779530,140100
4766,85,509407,50,919480,779580,139900
4766,85,509407,50,919530,779580,139950
4766,85,509407,500,920030,780080,139950
4766,85,509407,50,919680,779630,140050
4766,85,509407,500,920180,779680,140500
4766,85,509407,500,920530,780180,140350
4766,85,509407,50,920230,780580,139650
4767,80,509505,50,920280,780230,140050
4767,80,509505,50,920330,780730,139600
4767,80,509505,50,920380,781080,139300
4767,80,509505,500,920880,781230,139650
4767,80,509505,500,921030,781580,139450
4767,80,509505,50,920930,781730,139200
4767,80,509505,500,921430,782080,139350
4767,80,509505,50,921080,782230,138850
4767,80,509505,500,921580,782130,139450
4766,85,509407,500,921930,782180,139750
4766,85,509407,500,922080,782680,139400
4767,80,509505,500,922430,782280,140150
4767,80,509505,50,922130,782780,139350
4767,80,509505,50,922180,783744,138436
4768,83,509610,50,922230,784791,137439
4768,83,509610,50,922280,786391,135889
4768,83,509610,50,922330,788444,133886
4768,83,509610,50,922380,790041,132339
4768,83,509610,50,922430,791144,131286
4768,83,509610,50,922480,793241,129239
4768,83,509610,500,922930,795241,127689
4768,83,509610,500,922980,797744,125236
4769,86,509773,50,922980,799341,123639
4769,86,509773,50,923030,801341,121689
4769,86,509773,500,923480,801941,121539
4769,86,509773,500,923530,803194,120336
4769,86,509773,500,923980,804741,119239
4769,86,509773,50,923580,806891,116689
4769,86,509773,500,924080,808441,115639
4769,86,509773,50,924030,809591,114439
4769,86,509773,50,924080,810394,113686
4769,86,509773,50,924130,811444,112686
4770,88,509919,50,924130,813544,110586
4770,88,509919,50,924180,814291,109889
4770,88,509919,500,924630,815744,108886
4770,88,509919,50,924230,817394,106836
4770,88,509919,500,924730,817944,106786
4770,88,509919,500,925130,819594,105536
4770,88,509919,50,924780,820691,104089
4771,90,509990,500,925280,823694,101586
4771,90,509990,50,925180,825694,99486
4771,90,509990,50,925230,826991,98239
4771,90,509990,50,925280,828694,96586
4771,90,509990,50,925330,829744,95586
4771,90,509990,500,925780,831241,94539
4771,90,509990,50,925380,831994,93386
4771,90,509990,500,925880,833541,92339
4771,90,509990,500,926280,834944,91336
4770,88,509919,50,925930,837341,88589
4772,88,510078,50,925980,838441,87539
4772,88,510078,500,926480,839494,86986
4772,88,510078,500,926780,840491,86289
4772,88,510078,50,926530,841694,84836
4772,88,510078,500,927030,843741,83289
4772,88,510078,50,926830,845544,81286
4772,88,510078,50,926880,847991,78889
4772,88,510078,50,926930,849091,77839
4772,88,510078,50,926980,851291,75689
4772,88,510078,50,927030,852091,74939
4772,88,510078,50,927080,854594,72486
4772,88,510078,500,927530,856094,71436
4771,90,509990,500,927580,858244,69336
4772,88,510078,50,927580,859844,67736
4773,80,510195,500,928080,860041,68039
4773,80,510195,500,928080,862641,65439
4773,80,510195,500,928580,864291,64289
4773,80,510195,500,928580,865491,63089
4773,80,510195,50,928630,866741,61889
4773,80,510195,500,929080,867941,61139
4773,80,510195,50,928680,869594,59086
4773,80,510195,50,928730,871191,57539
4773,80,510195,500,929230,872694,56536
4773,80,510195,500,929580,873344,56236
4774,87,510282,50,929280,874894,54386
4774,87,510282,50,929330,876241,53089
4774,87,510282,500,929830,877794,52036
4774,87,510282,500,930080,878591,51489
4774,87,510282,50,929880,879741,50139
4773,80,510195,500,930380,880791,49589
4775,87,510573,50,930130,881744,48386
4775,87,510573,50,930180,883541,46639
4775,87,510573,500,930680,885494,45186
4775,87,510573,500,930880,887041,43839
4775,87,510573,50,930730,888791,41939
4775,87,510573,500,931230,889841,41389
4775,87,510573,500,931380,891441,39939
4775,87,510573,500,931730,894091,37639
4775,87,510573,500,931880,895741,36139
4775,87,510573,500,932230,897891,34339
4775,87,510573,50,931930,899544,32386
4776,87,510602,500,932430,899694,32736
4776,87,510602,50,932280,900791,31489
4776,87,510602,50,932330,903294,29036
4776,87,510602,500,932830,904394,28436
4776,87,510602,500,932930,904541,28389
4776,87,510602,50,932880,906291,26589
4776,87,510602,50,932930,907794,25136
4776,87,510602,50,932980,908894,24086
4775,87,510573,500,933430,910491,22939
4775,87,510573,500,933480,912591,20889
4776,87,510602,50,933480,913591,19889
4777,89,510759,500,933980,914241,19739
4777,89,510759,500,933980,915294,18686
4777,89,510759,500,934480,916794,17686
4777,89,510759,50,934030,918241,15789
4777,89,510759,500,934530,919941,14589
4777,89,510759,500,934980,920644,14336
4777,89,510759,500,935030,922694,12336
4777,89,510759,50,935030,924191,10839
4777,89,510759,500,935530,925144,10386
4777,89,510759,50,935080,926841,8239
4778,87,511091,500,935580,928544,7036
4778,87,511091,50,935580,930991,4589
4778,87,511091,50,935630,932894,2736
4778,87,511091,50,935630,933691,1939
4778,87,511091,500,936130,935044,1086
4778,87,511091,500,936130,936541,-411
4778,87,511091,500,936630,937591,-961
4778,87,511091,50,936180,939191,-3011
4778,87,511091,50,936230,940191,-3961
4779,89,511103,500,936730,941691,-4961
4779,89,511103,50,936680,943291,-6611
4779,89,511103,50,936730,944544,-7814
4779,89,511103,500,937230,946094,-8864
4779,89,511103,50,936780,947394,-10614
4779,89,511103,50,936830,949191,-12361
4779,89,511103,500,937330,950791,-13461
4779,89,511103,500,937730,952891,-15161
4779,89,511103,50,937380,954391,-17011
4779,89,511103,50,937430,956491,-19061
4780,84,511113,50,937480,957541,-20061
4780,84,511113,500,937980,959191,-21211
4780,84,511113,500,938230,959944,-21714
4780,84,511113,500,938480,960494,-22014
4780,84,511113,50,938280,962544,-24264
4780,84,511113,50,938330,963044,-24714
4780,84,511113,50,938380,963794,-25414
4780,84,511113,500,938880,964591,-25711
4781,81,511139,50,938530,965894,-27364
4781,81,511139,50,938580,967041,-28461
4781,81,511139,50,938630,968641,-30011
4780,84,511113,50,938680,970044,-31364
4780,84,511113,500,939180,971041,-31861
4780,84,511113,50,938930,972091,-33161
4782,87,511228,500,939430,974091,-34661
4782,87,511228,50,939230,975394,-36164
4782,87,511228,50,939280,976944,-37664
4782,87,511228,500,939780,977994,-38214
4782,87,511228,50,939480,978941,-39461
4782,87,511228,50,939530,980844,-41314
4782,87,511228,500,940030,982591,-42561
4782,87,511228,50,939830,984091,-44261
4782,87,511228,500,940330,985191,-44861
4782,87,511228,50,940080,987394,-47314
4781,81,511139,50,940130,990041,-49911
4782,87,511228,500,940630,991994,-51364
4783,84,511425,500,940830,993694,-52864
4783,84,511425,50,940680,994991,-54311
4783,84,511425,500,941180,996394,-55214
4783,84,511425,50,940880,998341,-57461
4783,84,511425,500,941380,999541,-58161
4783,84,511425,50,941230,999994,-58764
4783,84,511425,50,941280,803380,137900
4784,87,511454,500,941780,803430,138350
4784,87,511454,500,941880,803430,138450
4784,87,511454,500,942280,803930,138350
4784,87,511454,50,941930,803930,138000
4784,87,511454,500,942430,803980,138450
4784,87,511454,500,942780,801680,141100
4784,87,511454,500,942930,804030,138900
4784,87,511454,500,943280,804480,138800
4784,87,511454,500,943430,804530,138900
4784,87,511454,50,943330,804530,138800
4784,87,511454,50,943380,805030,138350
4784,87,511454,50,943430,804580,138850
4784,87,511454,500,943930,804630,139300
4784,87,511454,50,943480,804680,138800
4784,87,511454,50,943530,805180,138350
4784,87,511454,50,943580,803980,139600
4784,87,511454,500,944080,805680,138400
4784,87,511454,500,944430,805630,138800
4785,83,511518,500,944580,806130,138450
4785,83,511518,500,944930,805730,139200
4785,83,511518,50,944630,806230,138400
4785,83,511518,50,944680,806630,138050
4785,83,511518,500,945180,806280,138900
4785,83,511518,50,944980,806330,138650
4785,83,511518,500,945480,806380,139100
4783,84,511425,50,945230,806880,138350
4786,88,511532,500,945730,806680,139050
4786,88,511532,50,945530,805080,140450
4786,88,511532,500,946030,805580,140450
4786,88,511532,500,946230,806930,139300
4786,88,511532,500,946530,806980,139550
4786,88,511532,50,946280,807480,138800
4786,88,511532,50,946330,807280,139050
4786,88,511532,50,946380,807780,138600
4786,88,511532,50,946430,807980,138450
4786,88,511532,50,946480,808280,138200
4786,88,511532,500,946980,808480,138500
4786,88,511532,50,946580,808780,137800
4786,88,511532,500,947080,808530,138550
4786,88,511532,50,947030,806730,140300
4787,86,511576,500,947530,807230,140300
4787,86,511576,50,947130,809080,138050
4787,86,511576,500,947630,808830,138800
4787,86,511576,500,948030,809330,138700
4787,86,511576,500,948130,809580,138550
4785,83,511518,500,948530,809830,138700
4785,83,511518,50,948180,809630,138550
4785,83,511518,500,948680,809680,139000
4786,88,511532,500,949030,809730,139300
4787,86,511576,500,949180,810230,138950
4787,86,511576,50,949080,809880,139200
4788,86,511691,50,949130,810380,138750
4788,86,511691,500,949630,810280,139350
4788,86,511691,50,949230,810780,138450
4788,86,511691,500,949730,810430,139300
4788,86,511691,500,950130,808580,141550
4788,86,511691,50,949780,810830,138950
4788,86,511691,500,950280,810880,139400
4788,86,511691,500,950630,810930,139700
4788,86,511691,50,950330,811430,138900
4788,86,511691,50,950380,811030,139350
4788,86,511691,50,950430,811530,138900
4788,86,511691,50,950480,811930,138550
4788,86,511691,500,950980,810480,140500
4788,86,511691,500,951130,810980,140150
4789,84,511764,50,951030,812030,139000
4789,84,511764,50,951080,812430,138650
4789,84,511764,50,951130,812530,138600
4789,84,511764,500,951630,812930,138700
4789,84,511764,50,951180,813030,138150
4789,84,511764,500,951680,812980,138700
4789,84,511764,50,951680,813030,138650
4788,86,511691,500,952180,813080,139100
4788,86,511691,50,951730,813530,138200
4790,84,511970,50,951780,813130,138650
4790,84,511970,500,952280,813180,139100
4790,84,511970,500,952680,813230,139450
4790,84,511970,50,952330,813280,139050
4790,84,511970,500,952830,813330,139500
4790,84,511970,50,952730,813380,139350
4790,84,511970,50,952780,813430,139350
4790,84,511970,500,953280,813930,139350
4790,84,511970,500,953330,813580,139750
4791,88,512091,500,953780,814080,139700
4791,88,512091,50,953380,813980,139400
4791,88,512091,500,953880,814480,139400
4791,88,512091,50,953830,814130,139700
4791,88,512091,50,953880,814630,139250
4791,88,512091,500,954380,814530,139850
4791,88,512091,500,954380,815030,139350
4791,88,512091,50,954430,815130,139300
4792,89,512215,550,954430,815530,138900
4792,89,512215,3250,954930,815630,139300
4792,89,512215,4750,954930,816030,138900
4792,89,512215,3600,955346,816130,139216
4792,89,512215,750,954937,816530,138407
4792,89,512215,1100,954987,816180,138807
4792,89,512215,3200,955487,816230,139257
4793,84,512270,3250,955396,816280,139116
4793,84,512270,3400,955446,816330,139116
4793,84,512270,3200,955496,816830,138666
4793,84,512270,2050,955987,816580,139407
4793,84,512270,4550,955546,816630,138916
4793,84,512270,4900,955596,816780,138816
4793,84,512270,1300,955646,817280,138366
4793,84,512270,3100,956146,817330,138816
4793,84,512270,1650,956037,817780,138257
4794,82,512418,4900,956537,817830,138707
4794,82,512418,1300,956196,817830,138366
4794,82,512418,2200,956696,817880,138816
4794,82,512418,6300,956587,816680,139907
4794,82,512418,2800,957087,816730,140357
4794,82,512418,1600,957196,817880,139316
4794,82,512418,2400,957137,817930,139207
4794,82,512418,1300,957187,817930,139257
4794,82,512418,1200,957687,818430,139257
4794,82,512418,3250,957696,817980,139716
4794,82,512418,5000,957737,818030,139707
4794,82,512418,4400,958196,818530,139666
4794,82,512418,2900,957787,818480,139307
4794,82,512418,4950,957837,818980,138857
4794,82,512418,3600,958337,819030,139307
4794,82,512418,1150,958246,819480,138766
4795,86,512591,4200,958296,819080,139216
4795,86,512591,5950,958796,819130,139666
4795,86,512591,2200,958387,819630,138757
4795,86,512591,1600,958437,819530,138907
4795,86,512591,3700,958937,820130,138807
4795,86,512591,1800,958846,820080,138766
4795,86,512591,3250,958896,820580,138316
4795,86,512591,3750,959396,820180,139216
4795,86,512591,4700,959437,820230,139207
4795,86,512591,3450,959896,820730,139166
4795,86,512591,2950,959487,821080,138407
4795,86,512591,4150,959987,820780,139207
4795,86,512591,3050,959946,820830,139116
4795,86,512591,3250,960446,820880,139566
4796,82,512833,1750,960487,821380,139107
4796,82,512833,3300,960496,821130,139366
4796,82,512833,5450,960987,820030,140957
4796,82,512833,2850,960546,821680,138866
4796,82,512833,2850,960596,821430,139166
4796,82,512833,2200,961096,821930,139166
4796,82,512833,1800,961037,822180,138857
4796,82,512833,1400,961537,822430,139107
4796,82,512833,2850,961596,822680,138916
4796,82,512833,2150,962037,822930,139107
4797,81,512836,3650,962096,823180,138916
4797,81,512836,3800,962537,822980,139557
4797,81,512836,2900,962146,823480,138666
4797,81,512836,3300,962646,823230,139416
4797,81,512836,3700,962587,821180,141407
4797,81,512836,3700,963087,823730,139357
4797,81,512836,2800,963146,823980,139166
4797,81,512836,3200,963587,824230,139357
4796,82,512833,2900,963196,824030,139166
4796,82,512833,1600,963246,824080,139166
4797,81,512836,3300,963296,824580,138716
4798,80,513107,3200,963796,824280,139516
4798,80,513107,3350,964087,824780,139307
4798,80,513107,2800,964296,825080,139216
4798,80,513107,2650,964137,825280,138857
4798,80,513107,3100,964637,825580,139057
4798,80,513107,2100,964796,825780,139016
4798,80,513107,1350,964687,825630,139057
4798,80,513107,3150,965187,825680,139507
4799,86,513179,3250,964846,825730,139116
4799,86,513179,2300,964896,826230,138666
4799,86,513179,1700,965396,825830,139566
4799,86,513179,3700,965687,825880,139807
4799,86,513179,3300,965446,825930,139516
4799,86,513179,2200,965946,826430,139516
4799,86,513179,4150,966187,826280,139907
4800,87,513179,3200,965996,826330,139666
4800,87,513179,3450,966496,826830,139666
4800,87,513179,4100,966687,826930,139757
4800,87,513179,2900,966546,826880,139666
4800,87,513179,2250,966596,827380,139216
4800,87,513179,4650,967096,827430,139666
4800,87,513179,4800,967187,827430,139757
4800,87,513179,3300,967596,827930,139666
4798,80,513107,5150,967687,827480,140207
4798,80,513107,1750,968096,827980,140116
4800,87,513179,3750,967737,827980,139757
4800,87,513179,1850,968237,828030,140207
4800,87,513179,5100,968596,828030,140566
4801,87,513374,1750,968737,828530,140207
4801,87,513374,2750,968646,828080,140566
4801,87,513374,4700,969146,828130,141016
4801,87,513374,2750,968787,828630,140157
4801,87,513374,3150,969287,829030,140257
4801,87,513374,2350,969646,829130,140516
4801,87,513374,1850,969337,829530,139807
4801,87,513374,3700,969387,829630,139757
4801,87,513374,1300,969437,830030,139407
4801,87,513374,4200,969937,830130,139807
4801,87,513374,2200,969696,830080,139616
4801,87,513374,4150,970196,830580,139616
4802,83,513410,5350,970437,830630,139807
4802,83,513410,2450,970246,830630,139616
4802,83,513410,2850,970296,831130,139166
4802,83,513410,4400,970796,830680,140116
4802,83,513410,2750,970937,831180,139757
4802,83,513410,3150,971296,831180,140116
4802,83,513410,2850,971437,831230,140207
4803,88,513667,2800,971346,831680,139666
4803,88,513667,4350,971846,831280,140566
4803,88,513667,1300,971487,831330,140157
4803,88,513667,3750,971537,832180,139357
4803,88,513667,1750,971587,831880,139707
4803,88,513667,3800,972087,832380,139707
4803,88,513667,2700,971896,832680,139216
4803,88,513667,4000,971946,832880,139066
4803,88,513667,3700,972446,833180,139266
4803,88,513667,2250,972137,832930,139207
4803,88,513667,1600,972637,832980,139657
4803,88,513667,4700,972946,833030,139916
4803,88,513667,4350,973137,833680,139457
4803,88,513667,5850,973446,833580,139866
4803,88,513667,5400,973637,833630,140007
4804,81,514043,5750,973946,833680,140266
4804,81,514043,4150,974137,833730,140407
4804,81,514043,4800,973996,834180,139816
4804,81,514043,1750,974046,834230,139816
4804,81,514043,1800,974096,834680,139416
4804,81,514043,1800,974596,834730,139866
4804,81,514043,2700,974187,835180,139007
4805,88,514143,2450,974237,831830,142407
4805,88,514143,3800,974737,833530,141207
4805,88,514143,4250,974646,834780,139866
4805,88,514143,3700,975146,834830,140316
4805,88,514143,4350,975237,834880,140357
4805,88,514143,2850,975646,835380,140266
4805,88,514143,3300,975737,835680,140057
4805,88,514143,3650,976146,835880,140266
4806,84,514193,3000,975787,835730,140057
4806,84,514193,1250,975837,836230,139607
4806,84,514193,3650,976337,835930,140407
4806,84,514193,2200,976196,835980,140216
4806,84,514193,5950,976696,836030,140666
4806,84,514193,2250,976387,836530,139857
4806,84,514193,3350,976887,836280,140607
4806,84,514193,2700,976746,836330,140416
4806,84,514193,3900,977246,836380,140866
4806,84,514193,2200,976937,836880,140057
4806,84,514193,3900,977437,836580,140857
4806,84,514193,2250,977296,837080,140216
4806,84,514193,1800,977346,836930,140416
4806,84,514193,2700,977846,837430,140416
4806,84,514193,1350,977937,837580,140357
4806,84,514193,3850,978346,837480,140866
4806,84,514193,3250,978437,837980,140457
4806,84,514193,4800,978846,837630,141216
4807,88,514225,3450,978487,838180,140307
4807,88,514225,4450,978987,838680,140307
4807,88,514225,4400,978896,838980,139916
4807,88,514225,2750,978946,838730,140216
4807,88,514225,3800,978996,838780,140216
4807,88,514225,2500,979487,838830,140657
4805,88,514143,3700,979496,839330,140166
4808,86,514311,1600,979537,839030,140507
4808,86,514311,4200,979546,839080,140466
4808,86,514311,5700,980037,839580,140457
4808,86,514311,3700,980046,838130,141916
4808,86,514311,3650,980537,838480,142057
4808,86,514311,3950,980546,839380,141166
4808,86,514311,4350,980587,839430,141157
4808,86,514311,2900,980596,839930,140666
4808,86,514311,2250,981087,840080,141007
4808,86,514311,3800,980646,839980,140666
4808,86,514311,3150,980696,840030,140666
4808,86,514311,6250,980746,840080,140666
4808,86,514311,2450,980796,840580,140216
4807,88,514225,5650,980846,840130,140716
4809,86,514831,2800,981346,840180,141166
4809,86,514831,1800,981137,840680,140457
4809,86,514831,1700,981187,841080,140107
4809,86,514831,3250,981687,841180,140507
4809,86,514831,2800,981846,841130,140716
4809,86,514831,3850,981737,841180,140557
4809,86,514831,2250,981787,841680,140107
4809,86,514831,2650,982287,841680,140607
4809,86,514831,2450,981896,842180,139716
4809,86,514831,5200,982396,841730,140666
4809,86,514831,2150,982787,842230,140557
4810,82,514948,2300,982446,842230,140216
4810,82,514948,4150,982946,842280,140666
4810,82,514948,1250,983287,842280,141007
4811,87,514960,1350,982996,842330,140666
4811,87,514960,3150,983496,842330,141166
4811,87,514960,5650,983787,842380,141407
4811,87,514960,1450,983546,842830,140716
4811,87,514960,1800,983596,842430,141166
4811,87,514960,2850,983646,842930,140716
4811,87,514960,2200,983696,843330,140366
4811,87,514960,2300,983746,843430,140316
4811,87,514960,4100,984246,843830,140416
4811,87,514960,2750,984287,843480,140807
4812,86,514977,2750,984746,843980,140766
4812,86,514977,4750,984337,843880,140457
4812,86,514977,3400,984387,844380,140007
4812,86,514977,1350,984437,844030,140407
4812,86,514977,3700,984487,844080,140407
4812,86,514977,2950,984537,844130,140407
4810,82,514948,5600,985037,845130,139907
4810,82,514948,2900,984796,845380,139416
4810,82,514948,800,984846,845180,139666
4812,86,514977,3350,984896,845680,139216
4813,84,515167,2200,984946,845430,139516
4813,84,515167,3300,985446,845930,139516
4813,84,515167,3500,985537,845730,139807
4813,84,515167,700,985496,846230,139266
4813,84,515167,3700,985996,845980,140016
4813,84,515167,2800,986037,846280,139757
4813,84,515167,2050,986496,846330,140166
4813,84,515167,4400,986537,846830,139707
4813,84,515167,3950,986546,846530,140016
4813,84,515167,2400,986587,847080,139507
4814,85,515577,1200,986596,846880,139716
4814,85,515577,3750,987087,847380,139707
4814,85,515577,5200,987096,847130,139966
4814,85,515577,3750,987137,847630,139507
4814,85,515577,1850,987146,847430,139716
4814,85,515577,2750,987187,847930,139257
4814,85,515577,3800,987196,847680,139516
4814,85,515577,4450,987687,847730,139957
4814,85,515577,850,987246,847780,139466
4814,85,515577,2700,987746,848280,139466
4814,85,515577,3650,988187,848430,139757
4814,85,515577,2700,988246,848330,139916
4814,85,515577,3150,988687,848830,139857
4814,85,515577,4850,988746,848480,140266
4814,85,515577,2550,988737,848980,139757
4814,85,515577,4850,989237,849330,139907
4815,87,515929,2750,988796,849480,139316
4815,87,515929,3250,989296,849380,139916
4815,87,515929,2650,989737,849880,139857
4815,87,515929,4600,989796,849980,139816
4815,87,515929,4150,989787,849930,139857
4815,87,515929,3650,990287,850430,139857
4815,87,515929,4900,990296,850480,139816
4815,87,515929,3750,990337,850530,139807
4815,87,515929,1400,990346,850530,139816
4815,87,515929,2850,990837,851030,139807
4815,87,515929,1250,990396,851030,139366
4815,87,515929,1400,990446,851530,138916
4815,87,515929,2300,990946,851080,139866
4816,80,515968,3100,991337,851580,139757
4816,80,515968,3850,990996,851580,139416
4816,80,515968,3700,991496,852080,139416
4816,80,515968,4350,991837,852080,139757
4816,80,515968,4250,991996,852580,139416
4816,80,515968,4650,992337,852580,139757
4816,80,515968,2850,992046,852630,139416
4816,80,515968,2400,992096,853080,139016
4816,80,515968,2650,992146,853130,139016
4816,80,515968,2800,992196,853130,139066
4815,87,515929,5750,992246,853180,139066
4815,87,515929,3300,992746,853630,139116
4817,89,516089,2350,992837,853680,139157
4817,89,516089,3600,992796,854130,138666
4817,89,516089,3300,993296,844630,148666
4817,89,516089,3350,992887,844880,148007
4817,89,516089,6850,997146,846480,150666
4818,82,516092,3050,997187,846580,150607
4819,81,516136,5450,996596,850480,146116
4820,83,516305,8050,999837,854180,145657
4821,80,516454,2200,999846,854180,145666
6927,81,727612,2850,982130,854680,127450
6927,81,727612,3800,983730,854230,129500
6927,81,727612,3000,985230,854730,130500
6927,81,727612,2750,989080,855180,133900
6927,81,727612,4950,989630,855680,133950
6927,81,727612,2700,989030,855730,133300
6927,81,727612,3600,991230,855730,135500
6927,81,727612,1350,991830,855780,136050
6928,81,727944,2400,995030,855780,139250
6928,81,727944,5700,995680,856280,139400
6928,81,727944,3350,997380,855830,141550
6928,81,727944,3950,999280,856330,142950
6928,81,727944,1600,999880,856330,143550
6928,81,727944,500,957130,856380,100750
6928,81,727944,50,957080,856830,100250
6929,85,727964,500,957580,856430,101150
6929,85,727964,500,957630,856480,101150
6929,85,727964,500,958080,856530,101550
6929,85,727964,500,958130,855230,102900
6929,85,727964,50,958130,856880,101250
6929,85,727964,500,958630,857380,101250
6929,85,727964,500,958630,857530,101100
6929,85,727964,500,959130,857430,101700
6929,85,727964,50,958680,857930,100750
6929,85,727964,50,958730,857580,101150
6929,85,727964,50,958780,857630,101150
6930,86,728005,500,959280,858130,101150
6930,86,728005,50,959180,858430,100750
6930,86,728005,500,959680,858180,101500
6930,86,728005,50,959330,858230,101100
6930,86,728005,50,959380,858280,101100
6930,86,728005,50,959430,858330,101100
6930,86,728005,50,959480,858830,100650
6929,85,727964,500,959980,858930,101050
6931,81,728086,50,959730,857030,102700
6931,81,728086,50,959780,859430,100350
6931,81,728086,50,959830,859380,100450
6931,81,728086,500,960330,859880,100450
6931,81,728086,50,960030,859930,100100
6931,81,728086,500,960530,859930,100600
6930,86,728005,500,960830,859980,100850
6930,86,728005,50,960580,859980,100600
6932,88,728170,50,960630,859330,101300
6932,88,728170,50,960680,860080,100600
6932,88,728170,500,961180,860130,101050
6932,88,728170,50,960880,860180,100700
6932,88,728170,50,960930,860680,100250
6932,88,728170,500,961430,860530,100900
6932,88,728170,50,961230,860580,100650
6932,88,728170,1050,961730,860630,101100
6931,81,728086,1100,961930,861130,100800
6931,81,728086,600,961780,860730,101050
6933,82,728190,3800,962280,861280,101000
6933,82,728190,2750,961980,862930,99050
6933,82,728190,5300,962480,863930,98550
6933,82,728190,2850,962780,865030,97750
6933,82,728190,2350,962530,866730,95800
6933,82,728190,2700,963030,868130,94900
6933,82,728190,2800,962830,869680,93150
6933,82,728190,2850,962880,871430,91450
6933,82,728190,2800,963380,872780,90600
6932,88,728170,3150,963080,876630,86450
6932,88,728170,3750,963130,878680,84450
6932,88,728170,4250,963180,879730,83450
6934,87,728299,2800,963680,880830,82850
6934,87,728299,2650,963880,882380,81500
6934,87,728299,1750,963730,884480,79250
6934,87,728299,1250,963780,886730,77050
6934,87,728299,3150,964280,888830,75450
6934,87,728299,3800,964380,890930,73450
6934,87,728299,2750,964780,891030,73750
6934,87,728299,3200,964880,892780,72100
6934,87,728299,1950,964830,893580,71250
6934,87,728299,2800,964880,895130,69750
6934,87,728299,3350,965380,896280,69100
6935,86,728396,4650,965380,897380,68000
6935,86,728396,3800,965880,898480,67400
6935,86,728396,3800,965880,899830,66050
6935,86,728396,4300,965930,901330,64600
6935,86,728396,2650,965930,903030,62900
6935,86,728396,2350,966430,904530,61900
6935,86,728396,4250,965980,906030,59950
6935,86,728396,2250,966030,907680,58350
6935,86,728396,3700,966530,909380,57150
6935,86,728396,3800,966930,910680,56250
6934,87,728299,4550,966580,912130,54450
6934,87,728299,4700,967080,913530,53550
6935,86,728396,2600,967430,914530,52900
6936,84,728541,2200,967130,915880,51250
6936,84,728541,5750,967180,917130,50050
6936,84,728541,3300,967230,918730,48500
6936,84,728541,850,967730,919980,47750
6936,84,728541,2350,967480,923530,43950
6936,84,728541,2650,967980,925230,42750
6936,84,728541,3650,968230,926430,41800
6936,84,728541,1800,968480,928180,40300
6936,84,728541,4200,968730,929730,39000
6936,84,728541,2500,968530,930730,37800
6936,84,728541,3800,969030,931830,37200
6936,84,728541,1400,968780,932480,36300
6936,84,728541,4400,969280,933430,35850
6937,87,728547,1800,969530,934630,34900
6937,87,728547,3900,969780,935780,34000
6937,87,728547,3350,969580,938230,31350
6937,87,728547,1800,969630,940030,29600
6937,87,728547,3800,970130,942530,27600
6937,87,728547,1850,969830,943130,26700
6937,87,728547,1350,969880,943630,26250
6937,87,728547,3800,969930,946880,23050
6937,87,728547,5600,969980,950030,19950
6937,87,728547,2650,970030,950630,19400
6937,87,728547,2750,970080,952830,17250
6938,80,728590,1850,970130,955330,14800
6938,80,728590,4400,970180,957080,13100
6938,80,728590,4750,970630,959080,11550
6938,80,728590,2750,970230,960180,10050
6938,80,728590,3650,970730,961730,9000
6938,80,728590,3250,971130,962780,8350
6938,80,728590,1000,970780,964530,6250
6938,80,728590,6300,971280,966130,5150
6939,88,728743,3750,971630,967680,3950
6939,88,728743,3700,971330,969030,2300
6939,88,728743,2850,971380,969630,1750
6939,88,728743,2250,971880,971780,100
6939,88,728743,2900,972130,973480,-1350
6939,88,728743,2200,972380,975030,-2650
6939,88,728743,3200,972180,976880,-4700
6939,88,728743,2200,972680,977930,-5250
6939,88,728743,6300,972880,978980,-6100
6939,88,728743,2650,973180,980730,-7550
6939,88,728743,3200,972930,982630,-9700
6940,80,728814,3900,972980,983680,-10700
6940,80,728814,2650,973030,985780,-12750
6940,80,728814,3100,973530,987930,-14400
6940,80,728814,2200,973680,989530,-15850
6940,80,728814,2200,973580,992630,-19050
6940,80,728814,3750,974080,993780,-19700
6940,80,728814,1600,973730,995030,-21300
6940,80,728814,2700,973780,996180,-22400
6940,80,728814,2250,973830,996880,-23050
6940,80,728814,2600,974330,997880,-23550
6940,80,728814,1400,974130,999980,-25850
6941,84,728834,2250,974630,758880,215750
6941,84,728834,3650,974830,760680,214150
6941,84,728834,4150,974680,761780,212900
6941,84,728834,2250,975180,763480,211700
6941,84,728834,2450,975330,764330,211000
6941,84,728834,2750,975680,765680,210000
6941,84,728834,2200,975830,766430,209400
6941,84,728834,4050,975730,767680,208050
6941,84,728834,2700,976230,768780,207450
6940,80,728814,2250,975880,769830,206050
6941,84,728834,5450,976380,770230,206150
6942,90,729047,5300,976280,771230,205050
6942,90,729047,2300,976780,771880,204900
6942,90,729047,3600,976430,773580,202850
6942,90,729047,5750,976480,774730,201750
6942,90,729047,3300,976530,774980,201550
6942,90,729047,5150,976580,777030,199550
6942,90,729047,2800,976630,778580,198050
6942,90,729047,6350,976680,779830,196850
6942,90,729047,2350,976730,780980,195750
6942,90,729047,4850,977230,781530,195700
6943,87,729192,3250,977280,782630,194650
6943,87,729192,2650,977730,783130,194600
6943,87,729192,3750,977780,784280,193500
6943,87,729192,3200,978230,785430,192800
6943,87,729192,3150,978280,786580,191700
6943,87,729192,2400,978280,788130,190150
6943,87,729192,3350,978780,788780,190000
6943,87,729192,2200,978330,789880,188450
6944,82,729522,2950,978380,790930,187450
6944,82,729522,2300,978430,791530,186900
6944,82,729522,2750,978930,793130,185800
6944,82,729522,3800,979280,794280,185000
6944,82,729522,4800,979430,794830,184600
6944,82,729522,2200,979330,796330,183000
6944,82,729522,3300,979380,797830,181550
6944,82,729522,3950,979430,798880,180550
6944,82,729522,3200,979930,800480,179450
6944,82,729522,1800,979930,801530,178400
6944,82,729522,2450,980430,802530,177900
6944,82,729522,3300,979980,803980,176000
6945,89,729893,4200,980030,804630,175400
6945,89,729893,2600,980530,805730,174800
6945,89,729893,2650,980480,807130,173350
6945,89,729893,4700,980980,808180,172800
6945,89,729893,3100,980580,809380,171200
6945,89,729893,2100,981080,811980,169100
6945,89,729893,5550,981480,814180,167300
6945,89,729893,2350,981130,816130,165000
6945,89,729893,3350,981180,817480,163700
6946,86,729907,2900,981680,818580,163100
6946,86,729907,4750,981530,819730,161800
6946,86,729907,3300,981580,820430,161150
6946,86,729907,4250,981630,821130,160500
6946,86,729907,2300,982130,823280,158850
6946,86,729907,4200,982180,824380,157800
6946,86,729907,2850,982630,824980,157650
6946,86,729907,4100,983075,826630,156445
6946,86,729907,2650,984525,828130,156395
6945,89,729893,2400,984575,829580,154995
6946,86,729907,1550,984595,830730,153865
6947,80,730116,4700,986745,831880,154865
6947,80,730116,3850,989545,834080,155465
6947,80,730116,3650,990045,834930,155115
6947,80,730116,4150,992095,837130,154965
6947,80,730116,2250,993245,838630,154615
6947,80,730116,2300,994075,840330,153745
6947,80,730116,1250,994595,841180,153415
6947,80,730116,3750,997675,842330,155345
6947,80,730116,3900,998175,843180,154995
6948,81,730156,3800,999795,844880,154915
6948,81,730156,550,999845,845930,153915
6948,81,730156,500,985330,846930,138400
6948,81,730156,500,985730,847930,137800
6948,81,730156,50,985380,848530,136850
6948,81,730156,50,985430,850230,135200
6948,81,730156,50,985480,851480,134000
6947,80,730116,500,985980,852480,133500
6948,81,730156,500,986230,853280,132950
6948,81,730156,500,986480,853980,132500
6949,81,730322,500,986730,855180,131550
6949,81,730322,50,986530,855680,130850
6949,81,730322,500,987030,856380,130650
6949,81,730322,500,987230,858030,129200
6949,81,730322,50,987080,859080,128000
6949,81,730322,50,987130,860230,126900
6950,88,730407,500,987630,861230,126400
6950,88,730407,500,987730,863280,124450
6950,88,730407,500,988130,863830,124300
6950,88,730407,50,987780,865380,122400
6950,88,730407,50,987830,866030,121800
6950,88,730407,50,987880,868580,119300
6951,88,730444,50,987930,869280,118650
6951,88,730444,50,987980,870730,117250
6951,88,730444,500,988480,871230,117250
6951,88,730444,500,988630,872280,116350
6951,88,730444,500,988980,873480,115500
6951,88,730444,500,989130,875430,113700
6950,88,730407,500,989480,877080,112400
6952,80,730523,50,989180,877830,111350
6952,80,730523,500,989680,879830,109850
6952,80,730523,500,989980,882480,107500
6952,80,730523,500,990180,883680,106500
6952,80,730523,500,990480,885780,104700
6952,80,730523,50,990230,887330,102900
6952,80,730523,500,990730,888130,102600
6952,80,730523,500,990980,889730,101250
6952,80,730523,500,991230,892230,99000
6952,80,730523,500,991480,892830,98650
6952,80,730523,50,991280,893830,97450
6952,80,730523,500,991780,895030,96750
6952,80,730523,500,991980,897480,94500
6951,88,730444,50,991830,899330,92500
6953,80,730556,50,991880,900080,91800
6953,80,730556,50,991930,901980,89950
6953,80,730556,50,991980,902730,89250
6953,80,730556,500,992480,905330,87150
6953,80,730556,50,992030,906480,85550
6953,80,730556,500,992530,907580,84950
6952,80,730523,50,992530,909080,83450
6953,80,730556,500,993030,910730,82300
6954,81,731038,500,993030,911980,81050
6954,81,731038,50,993080,912830,80250
6954,81,731038,500,993530,914430,79100
6954,81,731038,50,993130,915780,77350
6954,81,731038,500,993630,917130,76500
6954,81,731038,50,993580,918980,74600
6954,81,731038,50,993630,919980,73650
6954,81,731038,50,993680,921130,72550
6954,81,731038,500,994130,923680,70450
6954,81,731038,500,994180,926280,67900
6954,81,731038,500,994630,927980,66650
6954,81,731038,50,994230,929030,65200
6954,81,731038,50,994280,930580,63700
6954,81,731038,500,994780,932280,62500
6954,81,731038,500,995130,933080,62050
6954,81,731038,50,994830,934180,60650
6954,81,731038,500,995330,935730,59600
6954,81,731038,50,995180,937280,57900
6955,90,731162,500,995680,939380,56300
6955,90,731162,50,995380,940080,55300
6955,90,731162,50,995430,941130,54300
6955,90,731162,500,995930,943180,52750
6955,90,731162,50,995730,944230,51500
6955,90,731162,500,996230,946080,50150
6955,90,731162,500,996430,947580,48850
6955,90,731162,50,996280,948680,47600
6955,90,731162,500,996780,949430,47350
6955,90,731162,50,996480,950780,45700
6955,90,731162,500,996980,952430,44550
6955,90,731162,50,996830,954430,42400
6955,90,731162,50,996880,955130,41750
6955,90,731162,500,997380,956280,41100
6955,90,731162,500,997480,959330,38150
6956,81,731827,50,997430,960380,37050
6956,81,731827,50,997480,961630,35850
6956,81,731827,500,997980,962680,35300
6956,81,731827,500,997980,964330,33650
6956,81,731827,50,998030,966080,31950
6956,81,731827,50,998030,967080,30950
6956,81,731827,50,998080,968330,29750
6956,81,731827,50,998080,969580,28500
6956,81,731827,50,998130,971880,26250
6956,81,731827,500,998580,973280,25300
6956,81,731827,500,998630,974630,24000
6957,85,731849,50,998630,976730,21900
6957,85,731849,500,999130,978230,20900
6957,85,731849,50,998680,979530,19150
6957,85,731849,500,999180,980580,18600
6957,85,731849,500,999630,981330,18300
6957,85,731849,50,999230,982930,16300
6957,85,731849,50,999280,984880,14400
6957,85,731849,500,999780,986930,12850
6957,85,731849,50,999830,987480,12350
6957,85,731849,50,999880,988030,11850
6958,81,732058,50,999930,989580,10350
6958,81,732058,50,999980,990480,9500
5697,81,601515,500,893030,992280,-99250
5697,81,601515,50,892669,993780,-101111
5697,81,601515,500,893169,994830,-101661
5697,81,601515,500,893530,996930,-103400
5697,81,601515,500,893669,998680,-105011
5697,81,601515,50,893580,999830,-106250
5697,81,601515,50,893630,999730,-106100
5697,81,601515,500,894130,865230,28900
5697,81,601515,500,894169,866030,28139
5697,81,601515,50,894180,867080,27100
5695,89,601448,50,894219,867580,26639
5695,89,601448,500,894680,869630,25050
5696,81,601476,50,894269,870180,24089
5696,81,601476,50,894319,871930,22389
5696,81,601476,500,894819,873740,21079
5697,81,601515,500,895180,875343,19837
5698,90,601644,500,895319,875843,19476
5698,90,601644,50,895230,877190,18040
5698,90,601644,50,895280,878693,16587
5698,90,601644,50,895330,879743,15587
5698,90,601644,50,895369,880990,14379
5698,90,601644,50,895380,882040,13340
5698,90,601644,500,895869,883593,12276
5698,90,601644,500,895880,884240,11640
5698,90,601644,500,896369,885340,11029
5698,90,601644,500,896380,887040,9340
5699,90,601801,50,896419,888643,7776
5699,90,601801,500,896880,889840,7040
5699,90,601801,50,896469,891590,4879
5699,90,601801,500,896969,893943,3026
5699,90,601801,500,897380,895540,1840
5699,90,601801,50,897019,896593,426
5699,90,601801,500,897519,898690,-1171
5699,90,601801,500,897880,900693,-2813
5699,90,601801,50,897569,902840,-5271
5699,90,601801,50,897619,904440,-6821
5699,90,601801,50,897669,905540,-7871
5700,83,601886,500,898169,907040,-8871
5700,83,601886,50,897930,909243,-11313
5700,83,601886,50,897980,909793,-11813
5700,83,601886,500,898480,910893,-12413
5700,83,601886,50,898219,912443,-14224
5700,83,601886,500,898719,914643,-15924
5700,83,601886,500,898980,916140,-17160
5700,83,601886,50,898769,917193,-18424
5700,83,601886,500,899269,919940,-20671
5700,83,601886,50,899030,922393,-23363
5699,90,601801,500,899530,922540,-23010
5701,90,601905,50,899319,923593,-24274
5701,90,601905,500,899819,923893,-24074
5701,90,601905,50,899580,925443,-25863
5701,90,601905,50,899630,927340,-27710
5701,90,601905,50,899680,928090,-28410
5701,90,601905,50,899730,931643,-31913
5701,90,601905,50,899780,933243,-33463
5701,90,601905,500,900280,935890,-35610
5701,90,601905,50,899869,936540,-36671
5701,90,601905,500,900369,938140,-37771
5701,90,601905,50,900330,939190,-38860
5701,90,601905,500,900830,941593,-40763
5701,90,601905,500,900869,942593,-41724
5701,90,601905,500,901330,944040,-42710
5702,81,601940,50,900919,945093,-44174
5702,81,601940,50,900969,946640,-45671
5702,81,601940,500,901469,947690,-46221
5702,81,601940,500,901830,949193,-47363
5702,81,601940,50,901519,950340,-48821
5702,81,601940,50,901569,951193,-49624
5702,81,601940,50,901619,953640,-52021
5702,81,601940,50,901669,955543,-53874
5702,81,601940,50,901719,956690,-54971
5702,81,601940,50,901769,958293,-56524
5702,81,601940,500,902269,959990,-57721
5702,81,601940,50,901880,961393,-59513
5703,84,601978,50,901930,962940,-61010
5703,84,601978,500,902430,964440,-62010
5703,84,601978,50,902319,967190,-64871
5703,84,601978,50,902369,967843,-65474
5703,84,601978,500,902869,968390,-65521
5703,84,601978,500,902930,969440,-66510
5703,84,601978,50,902919,971090,-68171
5703,84,601978,50,902969,972090,-69121
5703,84,601978,500,903430,974093,-70663
5703,84,601978,500,903469,975593,-72124
5703,84,601978,500,903930,976693,-72763
5703,84,601978,500,903969,978243,-74274
5703,84,601978,500,904430,979940,-75510
5701,90,601905,500,904469,982190,-77721
5701,90,601905,500,904930,983390,-78460
5701,90,601905,500,904969,985193,-80224
5701,90,601905,50,904980,986043,-81063
5704,83,602254,50,905019,987643,-82624
5704,83,602254,500,905480,989590,-84110
5704,83,602254,500,905519,991393,-85874
5704,83,602254,50,905530,992093,-86563
5704,83,602254,500,906019,993890,-87871
5704,83,602254,50,905580,994843,-89263
5704,83,602254,50,905630,995893,-90263
5704,83,602254,500,906130,997890,-91760
5704,83,602254,500,906519,998540,-92021
5705,85,602418,50,906180,999693,-93513
5705,85,602418,50,906230,871830,34400
5705,85,602418,500,906730,871880,34850
5705,85,602418,500,907019,872380,34639
5705,85,602418,50,906780,872030,34750
5705,85,602418,500,907280,872530,34750
5705,85,602418,500,907519,872430,35089
5705,85,602418,50,907330,872930,34400
5705,85,602418,50,907380,873030,34350
5705,85,602418,50,907430,872980,34450
5706,81,602473,500,907930,873030,34900
5706,81,602473,50,907569,873530,34039
5706,81,602473,50,907619,873530,34089
5706,81,602473,50,907669,873580,34089
5706,81,602473,50,907719,873580,34139
5706,81,602473,50,907769,874080,33689
5706,81,602473,50,907819,871980,35839
5706,81,602473,50,907869,873630,34239
5706,81,602473,500,908369,873680,34689
5706,81,602473,500,908430,873730,34700
5706,81,602473,50,908419,874230,34189
5705,85,602418,500,908919,874580,34339
5707,82,602533,500,908930,874280,34650
5707,82,602533,50,908969,874330,34639
5707,82,602533,50,908980,874830,34150
5707,82,602533,50,909019,874630,34389
5707,82,602533,50,909030,874680,34350
5707,82,602533,50,909069,875180,33889
5707,82,602533,50,909080,874880,34200
5707,82,602533,50,909119,875480,33639
5707,82,602533,50,909130,875680,33450
5707,82,602533,50,909169,875980,33189
5707,82,602533,500,909630,876180,33450
5707,82,602533,50,909219,876030,33189
5707,82,602533,500,909719,876080,33639
5706,81,602473,500,910130,876580,33550
5708,82,602818,500,910219,876230,33989
5708,82,602818,500,910630,876280,34350
5708,82,602818,500,910719,876780,33939
5708,82,602818,500,911130,874930,36200
5708,82,602818,500,911219,874980,36239
5708,82,602818,500,911630,877080,34550
5708,82,602818,50,911269,876830,34439
5708,82,602818,500,911769,876880,34889
5708,82,602818,500,912130,876930,35200
5708,82,602818,500,912269,877430,34839
5708,82,602818,500,912630,877130,35500
5709,80,602828,50,912319,877180,35139
5709,80,602828,50,912369,877680,34689
5709,80,602828,500,912869,877480,35389
5709,80,602828,500,913130,877980,35150
5710,87,602828,50,912919,877730,35189
5710,87,602828,500,913419,877780,35639
5710,87,602828,50,913180,877830,35350
5710,87,602828,500,913680,878330,35350
5710,87,602828,50,913469,878030,35439
5710,87,602828,500,913969,878080,35889
5710,87,602828,50,913730,878130,35600
5710,87,602828,50,913780,878630,35150
5710,87,602828,500,914280,878380,35900
5710,87,602828,500,914469,878430,36039
5710,87,602828,500,914780,878480,36300
5710,87,602828,500,914969,878530,36439
5711,85,602863,500,915280,878580,36700
5711,85,602863,50,915019,879080,35939
5711,85,602863,500,915519,878680,36839
5711,85,602863,50,915330,879180,36150
5711,85,602863,50,915380,879580,35800
5711,85,602863,50,915430,879680,35750
5711,85,602863,50,915480,880080,35400
5711,85,602863,500,915980,879730,36250
5708,82,602818,500,916019,880230,35789
5712,87,602923,500,916480,880130,36350
5712,87,602923,50,916069,880630,35439
5712,87,602923,50,916119,880730,35389
5712,87,602923,500,916619,881130,35489
5712,87,602923,500,916980,880780,36200
5712,87,602923,500,917119,881280,35839
5712,87,602923,500,917480,881630,35850
5712,87,602923,500,917619,881330,36289
5709,80,602828,500,917980,882130,35850
5710,87,602828,50,917669,881880,35789
5711,85,602863,50,917719,881930,35789
5711,85,602863,50,917769,881980,35789
5712,87,602923,500,918269,882480,35789
5712,87,602923,500,918480,882630,35850
5713,85,603216,50,918319,882530,35789
5713,85,603216,50,918369,883030,35339
5713,85,603216,500,918869,882680,36189
5713,85,603216,50,918530,881830,36700
5713,85,603216,500,919030,883680,35350
5713,85,603216,50,918919,883580,35339
5713,85,603216,500,919419,884080,35339
5713,85,603216,500,919530,884180,35350
5713,85,603216,50,919469,884130,35339
5713,85,603216,50,919519,884180,35339
5713,85,603216,500,920019,884680,35339
5713,85,603216,500,920030,884230,35800
5714,83,603452,500,920519,884280,36239
5714,83,603452,500,920530,884330,36200
5714,83,603452,50,920569,883180,37389
5714,83,603452,500,921030,883530,37500
5714,83,603452,500,921069,884380,36689
5714,83,603452,50,921080,884430,36650
5714,83,603452,500,921569,884930,36639
5714,83,603452,500,921580,884730,36850
5715,88,603481,500,922069,885230,36839
5715,88,603481,50,921630,885430,36200
5715,88,603481,50,921680,885280,36400
5715,88,603481,500,922180,885780,36400
5715,88,603481,500,922569,885930,36639
5715,88,603481,500,922680,885830,36850
5715,88,603481,50,922619,885880,36739
5715,88,603481,50,922669,886380,36289
5715,88,603481,50,922719,885980,36739
5715,88,603481,500,923180,886480,36700
5715,88,603481,50,922769,886880,35889
5714,83,603452,50,922819,886980,35839
5714,83,603452,500,923319,887380,35939
5714,83,603452,500,923680,887480,36200
5716,90,603607,500,923819,887880,35939
5716,90,603607,50,923730,887980,35750
5716,90,603607,50,923780,888380,35400
5716,90,603607,500,924280,888030,36250
5716,90,603607,500,924319,888530,35789
5716,90,603607,50,924330,888880,35450
5716,90,603607,50,924369,889030,35339
5716,90,603607,500,924830,888930,35900
5716,90,603607,50,924419,888980,35439
5716,90,603607,500,924919,889030,35889
5716,90,603607,50,924880,889080,35800
5716,90,603607,500,925380,889530,35850
5716,90,603607,500,925419,889580,35839
5716,90,603607,50,925430,889580,35850
5716,90,603607,500,925919,889630,36289
5716,90,603607,50,925480,889680,35800
5716,90,603607,50,925530,889680,35850
5716,90,603607,500,926030,890180,35850
5717,88,603674,50,925969,890180,35789
5717,88,603674,500,926469,890230,36239
5717,88,603674,50,926080,890230,35850
5717,88,603674,50,926130,890730,35400
5717,88,603674,500,926630,890730,35900
5717,88,603674,500,926969,890780,36189
5717,88,603674,50,926680,890830,35850
5717,88,603674,500,927180,891280,35900
5717,88,603674,500,927469,890880,36589
5717,88,603674,50,927230,891380,35850
5717,88,603674,50,927280,891330,35950
5717,88,603674,500,927780,891830,35950
5717,88,603674,50,927519,891880,35639
5718,84,603676,50,927569,889630,37939
5718,84,603676,50,927619,890780,36839
5718,84,603676,50,927669,892380,35289
5718,84,603676,500,928169,892880,35289
5718,84,603676,50,927830,892880,34950
5718,84,603676,500,928330,892930,35400
5718,84,603676,50,928219,892930,35289
5718,84,603676,50,928269,893430,34839
5718,84,603676,500,928769,892980,35789
5718,84,603676,500,928830,893030,35800
5718,84,603676,500,929269,893530,35739
5718,84,603676,50,928880,892330,36550
5718,84,603676,500,929380,892380,37000
5718,84,603676,500,929769,893930,35839
5719,81,603730,500,929880,893580,36300
5719,81,603730,500,930269,893630,36639
5719,81,603730,50,929930,894130,35800
5719,81,603730,50,929980,893980,36000
5719,81,603730,500,930480,894030,36450
5719,81,603730,500,930769,894530,36239
5719,81,603730,50,930530,894630,35900
5719,81,603730,50,930580,894580,36000
5719,81,603730,50,930630,895080,35550
5720,90,603732,500,931130,895130,36000
5720,90,603732,50,930819,895130,35689
5720,90,603732,500,931319,895630,35689
5720,90,603732,50,931180,895180,36000
5720,90,603732,500,931680,895230,36450
5720,90,603732,500,931819,895280,36539
5720,90,603732,500,932180,895330,36850
5721,84,603757,500,932319,895830,36489
5721,84,603757,50,932230,895680,36550
5721,84,603757,50,932280,895930,36350
5721,84,603757,50,932330,896430,35900
5721,84,603757,500,932819,896680,36139
5721,84,603757,500,932830,896480,36350
5722,88,603767,500,933319,896530,36789
5722,88,603767,50,932880,897030,35850
5722,88,603767,50,932930,896730,36200
5722,88,603767,50,932980,896780,36200
5722,88,603767,50,933030,896180,36850
5722,88,603767,500,933530,895880,37650
5722,88,603767,500,933819,897530,36289
5722,88,603767,50,933580,897330,36250
5722,88,603767,500,934080,897830,36250
5722,88,603767,500,934319,897580,36739
5722,88,603767,50,934130,898080,36050
5722,88,603767,50,934180,898330,35850
5722,88,603767,500,934680,898130,36550
5717,88,603674,50,934369,898180,36189
5718,84,603676,500,934869,898230,36639
5720,90,603732,500,935180,898280,36900
5722,88,603767,500,935369,898330,37039
5722,88,603767,50,935230,898380,36850
5723,86,603957,500,935730,897280,38450
5723,86,603957,50,935419,898430,36989
5723,86,603957,50,935469,898480,36989
5723,86,603957,50,935519,898980,36539
5723,86,603957,50,935569,898880,36689
5723,86,603957,50,935619,899380,36239
5723,86,603957,50,935669,899030,36639
5724,85,603977,50,935719,899080,36639
5724,85,603977,500,936219,899580,36639
5724,85,603977,50,935780,899430,36350
5724,85,603977,50,935830,899930,35900
5724,85,603977,500,936330,900080,36250
5724,85,603977,50,936269,900430,35839
5724,85,603977,500,936769,898830,37939
5724,85,603977,50,936380,900480,35900
5724,85,603977,50,936430,900530,35900
5725,89,604057,500,936930,901030,35900
5725,89,604057,50,936819,900630,36189
5725,89,604057,50,936869,900680,36189
5725,89,604057,50,936919,901180,35739
5725,89,604057,50,936969,901080,35889
5725,89,604057,500,937430,901130,36300
5725,89,604057,50,937019,901630,35389
5725,89,604057,50,937069,901680,35389
5724,85,603977,50,937119,901680,35439
5726,89,604086,500,937619,902180,35439
5726,89,604086,50,937480,901730,35750
5726,89,604086,500,937980,902230,35750
5726,89,604086,50,937669,902230,35439
5726,89,604086,500,938169,900580,37589
5726,89,604086,500,938480,902730,35750
5726,89,604086,500,938669,902280,36389
5726,89,604086,500,938980,902780,36200
5726,89,604086,500,939169,903230,35939
5726,89,604086,500,939480,902830,36650
5726,89,604086,50,939219,902880,36339
5726,89,604086,500,939719,902930,36789
5726,89,604086,500,939980,903430,36550
5726,89,604086,500,940219,903730,36489
5726,89,604086,50,940030,903480,36550
5726,89,604086,50,940080,903980,36100
5727,82,604131,50,940130,903780,36350
5727,82,604131,50,940180,904280,35900
5727,82,604131,500,940680,904030,36650
5727,82,604131,50,940269,904080,36189
5727,82,604131,500,940769,904130,36639
5727,82,604131,500,941180,904630,36550
5727,82,604131,50,940819,904330,36489
5727,82,604131,50,940869,904380,36489
5727,82,604131,500,941369,904430,36939
5727,82,604131,50,941230,904930,36300
5725,89,604057,50,941280,905130,36150
5726,89,604086,500,941780,905430,36350
5726,89,604086,500,941869,905630,36239
5728,84,604208,50,941830,905480,36350
5728,84,604208,500,942330,905530,36800
5728,84,604208,500,942369,906030,36339
5728,84,604208,50,942380,906130,36250
5728,84,604208,50,942419,906080,36339
5728,84,604208,50,942430,906580,35850
5728,84,604208,50,942469,906630,35839
5728,84,604208,500,942930,907080,35850
5728,84,604208,50,942519,907130,35389
5727,82,604131,50,942569,907580,34989
5728,84,604208,500,943069,907180,35889
5729,90,604326,500,943430,907230,36200
5729,90,604326,50,943119,907730,35389
5729,90,604326,50,943169,907630,35539
5729,90,604326,500,943669,908130,35539
5729,90,604326,500,943930,908230,35700
5729,90,604326,500,944169,908180,35989
5729,90,604326,50,943980,908680,35300
5729,90,604326,50,944030,908280,35750
5729,90,604326,500,944530,909280,35250
5730,81,604421,50,944219,909230,34989
5730,81,604421,500,944719,909280,35439
5730,81,604421,500,945030,909330,35700
5730,81,604421,500,945219,909330,35889
5730,81,604421,50,945080,909830,35250
5730,81,604421,50,945130,909830,35300
5731,89,604476,50,945180,910330,34850
5731,89,604476,500,945680,910330,35350
5731,89,604476,50,945269,908780,36489
5731,89,604476,50,945319,909180,36139
5731,89,604476,500,945819,910380,35439
5731,89,604476,50,945730,910380,35350
5731,89,604476,500,946230,910880,35350
5732,87,604517,50,945869,910430,35439
5732,87,604517,500,946369,910930,35439
5732,87,604517,500,946730,911380,35350
5732,87,604517,50,946419,911430,34989
5732,87,604517,50,946469,911880,34589
5730,81,604421,500,946969,911480,35489
5730,81,604421,500,947230,912430,34800
5733,80,604561,500,947469,912480,34989
5733,80,604561,50,947280,912930,34350
5733,80,604561,500,947780,912980,34800
5733,80,604561,500,947969,913430,34539
5733,80,604561,50,947830,913480,34350
5733,80,604561,500,948330,913930,34400
5733,80,604561,500,948469,913980,34489
5733,80,604561,50,948380,913980,34400
5733,80,604561,500,948880,914480,34400
5733,80,604561,500,948969,914480,34489
5734,82,604606,50,948930,914530,34400
5734,82,604606,500,949430,911980,37450
5734,82,604606,500,949469,911930,37539
5734,82,604606,500,949930,914980,34950
5734,82,604606,500,949969,914580,35389
5734,82,604606,500,950430,915080,35350
5734,82,604606,500,950469,915480,34989
5734,82,604606,50,950480,915130,35350
5734,82,604606,50,950519,915630,34889
5734,82,604606,500,950980,915980,35000
5734,82,604606,500,951019,916130,34889
5735,83,604612,500,951480,916480,35000
5735,83,604612,500,951519,916630,34889
5735,83,604612,50,951530,916980,34550
5735,83,604612,500,952019,916680,35339
5735,83,604612,500,952030,916730,35300
5735,83,604612,500,952519,917230,35289
5735,83,604612,500,952530,917480,35050
5732,87,604517,50,952569,917280,35289
5732,87,604517,50,952580,917780,34800
5734,82,604606,500,953069,917530,35539
5734,82,604606,50,952630,917580,35050
5734,82,604606,500,953130,918180,34950
5735,83,604612,50,953119,919580,33539
5736,85,604949,50,953169,920930,32239
5736,85,604949,500,953630,923330,30300
5736,85,604949,50,953219,925580,27639
5736,85,604949,50,953269,928080,25189
5736,85,604949,50,953319,929180,24139
5736,85,604949,50,953369,930880,22489
5736,85,604949,500,953869,932280,21589
5736,85,604949,50,953680,932480,21200
5736,85,604949,50,953730,933580,20150
5736,85,604949,500,954230,935180,19050
5737,82,605255,50,953919,936230,17689
5737,82,605255,500,954419,938330,16089
5737,82,605255,500,954730,939780,14950
5737,82,605255,50,954469,941730,12739
5737,82,605255,500,954969,943830,11139
5737,82,605255,50,954780,945580,9200
5737,82,605255,500,955280,945680,9600
5737,82,605255,500,955469,946780,8689
5737,82,605255,50,955330,947980,7350
5737,82,605255,50,955380,949530,5850
5737,82,605255,50,955430,950730,4700
5738,87,605444,50,955480,951180,4300
5738,87,605444,500,955969,952880,3089
5738,87,605444,50,955530,954530,1000
5738,87,605444,50,955580,955580,0
5738,87,605444,500,956080,956730,-650
5738,87,605444,500,956469,958330,-1861
5738,87,605444,50,956130,959430,-3300
5738,87,605444,500,956630,960180,-3550
5738,87,605444,500,956969,961230,-4261
5739,90,605542,500,957130,962780,-5650
5739,90,605542,500,957469,964480,-7011
5739,90,605542,50,957180,965780,-8600
5739,90,605542,50,957230,967030,-9800
5739,90,605542,500,957730,967680,-9950
5739,90,605542,50,957519,968430,-10911
5739,90,605542,500,958019,970030,-12011
5739,90,605542,50,957780,971780,-14000
5739,90,605542,50,957830,972480,-14650
5739,90,605542,50,957880,974030,-16150
5739,90,605542,500,958380,975580,-17200
5738,87,605444,50,958069,976680,-18611
5740,89,605547,500,958569,977830,-19261
5740,89,605547,500,958880,980780,-21900
5740,89,605547,50,958619,981780,-23161
5740,89,605547,500,959119,984030,-24911
5740,89,605547,500,959380,985980,-26600
5740,89,605547,500,959619,987030,-27411
5740,89,605547,500,959880,988680,-28800
5740,89,605547,500,960119,990530,-30411
5740,89,605547,500,960380,992330,-31950
5740,89,605547,50,960169,994380,-34211
5741,85,605578,500,960669,995430,-34761
5741,85,605578,500,960880,997080,-36200
5741,85,605578,50,960719,998530,-37811
5741,85,605578,50,960769,998980,-38211
5741,85,605578,500,961269,999780,-38511
5741,85,605578,50,960930,924130,36800
5741,85,605578,500,961430,924630,36800
5741,85,605578,500,961769,924630,37139
5741,85,605578,500,961930,925130,36800
5741,85,605578,50,961819,925130,36689
5742,87,605580,500,962319,925630,36689
5742,87,605580,500,962430,925630,36800
5742,87,605580,50,962369,926130,36239
5742,87,605580,50,962419,926130,36289
5742,87,605580,50,962469,926630,35839
5742,87,605580,50,962480,926630,35850
5742,87,605580,500,962969,926680,36289
5742,87,605580,50,962530,927180,35350
5742,87,605580,500,963030,926730,36300
5742,87,605580,50,963019,927230,35789
5742,87,605580,50,963069,927680,35389
5742,87,605580,500,963530,927280,36250
5742,87,605580,500,963569,927780,35789
5739,90,605542,50,963580,926680,36900
5739,90,605542,50,963619,928180,35439
5741,85,605578,500,964080,928280,35800
5742,87,605580,50,963669,928680,34989
5742,87,605580,500,964169,928330,35839
5743,89,606005,50,964130,928380,35750
5743,89,606005,500,964630,928430,36200
5743,89,606005,500,964669,928480,36189
5743,89,606005,50,964680,928980,35700
5743,89,606005,50,964719,928730,35989
5743,89,606005,500,965180,928780,36400
5743,89,606005,500,965219,928830,36389
5743,89,606005,500,965680,929330,36350
5743,89,606005,50,965269,929480,35789
5743,89,606005,500,965769,929830,35939
5743,89,606005,50,965730,929980,35750
5743,89,606005,500,966230,929880,36350
5743,89,606005,500,966269,929930,36339
5743,89,606005,50,966280,930430,35850
5743,89,606005,500,966769,930480,36289
5744,83,606189,500,966780,930480,36300
5744,83,606189,500,967269,930530,36739
5744,83,606189,500,967280,930980,36300
5744,83,606189,500,967769,930580,37189
5744,83,606189,50,967330,931080,36250
5744,83,606189,50,967380,931480,35900
5744,83,606189,50,967430,931580,35850
5744,83,606189,500,967930,931980,35950
5744,83,606189,500,968269,932080,36189
5745,82,606295,500,968430,932030,36400
5745,82,606295,500,968769,932530,36239
5745,82,606295,500,968930,932130,36800
5745,82,606295,500,969269,932180,37089
5745,82,606295,50,968980,932230,36750
5745,82,606295,50,969030,932730,36300
5745,82,606295,50,969080,933030,36050
5745,82,606295,500,969580,933230,36350
5745,82,606295,500,969769,933530,36239
5745,82,606295,500,970080,933730,36350
5745,82,606295,500,970269,934030,36239
5746,84,606668,500,970580,934230,36350
5746,84,606668,50,970319,934080,36239
5746,84,606668,50,970369,934130,36239
5746,84,606668,50,970419,934630,35789
5746,84,606668,50,970469,934280,36189
5746,84,606668,500,970969,934330,36639
5746,84,606668,50,970630,934380,36250
5746,84,606668,500,971130,934880,36250
5747,84,606954,50,971019,935130,35889
5747,84,606954,50,971069,934930,36139
5747,84,606954,500,971569,935430,36139
5747,84,606954,50,971180,935180,36000
5747,84,606954,500,971680,935630,36050
5747,84,606954,500,972069,935680,36389
5747,84,606954,500,972180,935730,36450
5747,84,606954,50,972119,936180,35939
5747,84,606954,50,972169,936230,35939
5748,81,607200,500,972669,936680,35989
5748,81,607200,500,972680,936280,36400
5748,81,607200,50,972719,936330,36389
5748,81,607200,500,973180,936380,36800
5748,81,607200,500,973219,935680,37539
5748,81,607200,500,973680,935480,38200
5749,86,607271,500,973719,935530,38189
5749,86,607271,500,974180,935580,38600
5749,86,607271,50,973769,936880,36889
5749,86,607271,50,973819,936730,37089
5749,86,607271,500,974319,937230,37089
5749,86,607271,500,974680,936930,37750
5749,86,607271,50,974369,937430,36939
5749,86,607271,50,974419,937280,37139
5749,86,607271,50,974469,937330,37139
5749,86,607271,50,974519,937380,37139
5748,81,607200,50,974569,937430,37139
5750,83,607321,500,975069,937930,37139
5750,83,607321,50,974730,937930,36800
5750,83,607321,500,975230,938430,36800
5750,83,607321,50,975119,938430,36689
5750,83,607321,500,975619,938480,37139
5750,83,607321,500,975730,938480,37250
5750,83,607321,50,975669,938530,37139
5750,83,607321,50,975719,939030,36689
5750,83,607321,500,976219,939030,37189
5751,84,607378,50,975780,939530,36250
5751,84,607378,500,976280,939080,37200
5751,84,607378,500,976719,939580,37139
5751,84,607378,50,976330,939580,36750
5751,84,607378,50,976380,940080,36300
5751,84,607378,50,976430,939630,36800
5751,84,607378,50,976480,939680,36800
5751,84,607378,50,976530,940180,36350
5751,84,607378,50,976580,938530,38050
5751,84,607378,500,977080,940130,36950
5751,84,607378,500,977219,940180,37039
5751,84,607378,500,977580,940680,36900
5751,84,607378,50,977269,940680,36589
5751,84,607378,500,977769,940730,37039
5751,84,607378,50,977630,940730,36900
5752,86,607520,500,978130,940780,37350
5752,86,607520,50,977819,941230,36589
5752,86,607520,50,977869,941280,36589
5752,86,607520,50,977919,941730,36189
5752,86,607520,50,977969,941780,36189
5752,86,607520,2200,979180,941780,37400
5753,90,607894,4300,984169,942280,41889
5754,89,607956,5950,984380,942280,42100
5755,86,608138,1450,985019,942330,42689
5756,86,608364,2850,986530,942780,43750
5757,86,608474,1650,987469,942380,45089
5758,83,608518,1750,988130,942880,45250
5759,82,608720,4400,991319,943280,48039
5760,82,608754,1700,990980,942930,48050
5761,84,608995,4100,993369,943430,49939
5762,89,609043,2850,994880,943330,51550
5763,81,609332,2750,999769,943380,56389
5764,87,609366,2150,997080,943880,53200
5765,90,609366,3000,998580,943480,55100
5766,85,609406,2250,999719,943530,56189
6564,85,689958,500,862280,943580,-81300
6564,85,689958,500,862330,943630,-81300
6565,80,689991,50,862330,944130,-81800
6565,80,689991,500,862830,943930,-81100
6565,80,689991,50,862380,943980,-81600
6565,80,689991,50,862430,944030,-81600
6565,80,689991,50,862480,944530,-82050
6565,80,689991,50,862530,944630,-82100
6565,80,689991,500,863030,945080,-82050
6565,80,689991,500,863330,944680,-81350
6565,80,689991,50,863080,944730,-81650
6565,80,689991,500,863580,944780,-81200
6565,80,689991,50,863380,944830,-81450
6565,80,689991,500,863880,944880,-81000
6565,80,689991,50,863630,944930,-81300
6565,80,689991,50,863680,945430,-81750
6566,83,690022,50,863730,945130,-81400
6566,83,690022,50,863780,944580,-80800
6566,83,690022,50,863830,945680,-81850
6566,83,690022,50,863880,945930,-82050
6566,83,690022,50,863930,946180,-82250
6566,83,690022,50,863930,946430,-82500
6566,83,690022,500,864430,946680,-82250
6566,83,690022,50,863980,946480,-82500
6566,83,690022,50,864030,946530,-82500
6566,83,690022,50,864080,947030,-82950
6566,83,690022,500,864580,947180,-82600
6566,83,690022,500,864930,947080,-82150
6566,83,690022,500,865080,947130,-82050
6566,83,690022,500,865430,945180,-79750
6564,85,689958,50,865130,947230,-82100
6564,85,689958,500,865630,947280,-81650
6565,80,689991,50,865480,947330,-81850
6566,83,690022,50,865530,947830,-82300
6567,84,690122,50,865580,948130,-82550
6567,84,690122,50,865630,948330,-82700
6567,84,690122,500,866130,948630,-82500
6567,84,690122,500,866130,948380,-82250
6567,84,690122,500,866630,948430,-81800
6567,84,690122,50,866180,948480,-82300
6567,84,690122,500,866680,947630,-80950
6567,84,690122,50,866680,948730,-82050
6567,84,690122,50,866730,949230,-82500
6568,84,690289,50,866730,949480,-82750
6568,84,690289,50,866780,949730,-82950
6568,84,690289,500,867230,949530,-82300
6568,84,690289,50,866830,950030,-83200
6568,84,690289,50,866880,950230,-83350
6568,84,690289,50,866930,950080,-83150
6568,84,690289,50,866980,950130,-83150
6568,84,690289,500,867480,950180,-82700
6568,84,690289,50,867280,950230,-82950
6568,84,690289,50,867330,950280,-82950
6568,84,690289,500,867830,950730,-82900
6569,84,690340,50,867530,948980,-81450
6569,84,690340,50,867580,948680,-81100
6569,84,690340,500,868080,950330,-82250
6569,84,690340,50,867880,950830,-82950
6569,84,690340,50,867930,950780,-82850
6569,84,690340,500,868430,950830,-82400
6570,87,690372,50,868130,950880,-82750
6570,87,690372,500,868630,950880,-82250
6570,87,690372,500,868930,950930,-82000
6570,87,690372,500,869130,950930,-81800
6570,87,690372,50,868980,950980,-82000
6570,87,690372,50,869030,950980,-81950
6570,87,690372,500,869530,951480,-81950
6568,84,690289,50,869180,951030,-81850
6571,90,690451,500,869680,951530,-81850
6571,90,690451,50,869580,951530,-81950
6571,90,690451,500,870080,952030,-81950
6571,90,690451,500,870180,952030,-81850
6571,90,690451,500,870580,952080,-81500
6571,90,690451,500,870680,952530,-81850
6571,90,690451,500,871080,952580,-81500
6571,90,690451,500,871180,953030,-81850
6571,90,690451,50,871130,953080,-81950
6570,87,690372,500,871630,953530,-81900
6570,87,690372,500,871680,953130,-81450
6572,82,690509,500,872130,953180,-81050
6572,82,690509,500,872180,953680,-81500
6572,82,690509,50,872180,953580,-81400
6572,82,690509,50,872230,953630,-81400
6572,82,690509,50,872230,954130,-81900
6572,82,690509,50,872280,953730,-81450
6572,82,690509,500,872730,953780,-81050
6572,82,690509,50,872330,954280,-81950
6572,82,690509,50,872380,954630,-82250
6572,82,690509,500,872880,954330,-81450
6572,82,690509,500,873230,954830,-81600
6572,82,690509,500,873380,954680,-81300
6572,82,690509,50,873280,955180,-81900
6572,82,690509,500,873780,954880,-81100
6573,87,690643,50,873430,954930,-81500
6573,87,690643,500,873930,955430,-81500
6573,87,690643,500,874280,955680,-81400
6573,87,690643,500,874430,955480,-81050
6573,87,690643,500,874780,955980,-81200
6573,87,690643,500,874930,955730,-80800
6573,87,690643,50,874830,955780,-80950
6573,87,690643,50,874880,955830,-80950
6573,87,690643,50,874930,956030,-81100
6573,87,690643,500,875430,956080,-80650
6573,87,690643,50,874980,956130,-81150
6573,87,690643,500,875480,956180,-80700
6573,87,690643,500,875930,956680,-80750
6573,87,690643,50,875530,956830,-81300
6573,87,690643,500,876030,956730,-80700
6573,87,690643,500,876430,957230,-80800
6573,87,690643,50,876080,957330,-81250
6574,83,690745,50,876130,957280,-81150
6574,83,690745,50,876180,957330,-81150
6574,83,690745,50,876230,957380,-81150
6574,83,690745,500,876730,957830,-81100
6574,83,690745,500,876930,957430,-80500
6574,83,690745,500,877230,956330,-79100
6574,83,690745,500,877430,957930,-80500
6575,87,690900,500,877730,957880,-80150
6575,87,690900,500,877930,958380,-80450
6575,87,690900,50,877780,957980,-80200
6575,87,690900,500,878280,958030,-79750
6575,87,690900,500,878430,958080,-79650
6575,87,690900,500,878780,958580,-79800
6576,81,691128,500,878930,958880,-79950
6576,81,691128,500,879280,958630,-79350
6576,81,691128,50,878980,958680,-79700
6576,81,691128,50,879030,958730,-79700
6576,81,691128,50,879080,958780,-79700
6576,81,691128,500,879580,958830,-79250
6576,81,691128,500,879780,958880,-79100
6576,81,691128,50,879630,959380,-79750
6576,81,691128,50,879680,959380,-79700
6576,81,691128,50,879730,959880,-80150
6576,81,691128,500,880230,959880,-79650
6577,84,691326,500,880280,960380,-80100
6577,84,691326,50,880280,960380,-80100
6577,84,691326,500,880780,960880,-80100
6577,84,691326,500,880780,960430,-79650
6578,90,691338,500,881280,960930,-79650
6578,90,691338,50,880830,961380,-80550
6578,90,691338,50,880880,961430,-80550
6578,90,691338,50,880930,961880,-80950
6578,90,691338,500,881430,961480,-80050
6578,90,691338,500,881780,961980,-80200
6578,90,691338,500,881930,961930,-80000
6578,90,691338,50,881830,962430,-80600
6578,90,691338,500,882330,962030,-79700
6578,90,691338,50,881980,962080,-80100
6578,90,691338,500,882480,962580,-80100
6579,84,691638,500,882830,962480,-79650
6579,84,691638,500,882980,962980,-80000
6579,84,691638,500,883330,963080,-79750
6579,84,691638,500,883480,963030,-79550
6579,84,691638,50,883380,963530,-80150
6580,86,691731,500,883880,963130,-79250
6580,86,691731,50,883530,963630,-80100
6580,86,691731,500,884030,963580,-79550
6580,86,691731,500,884380,963630,-79250
6580,86,691731,50,884080,964130,-80050
6580,86,691731,500,884580,964130,-79550
6580,86,691731,50,884430,964180,-79750
6580,86,691731,50,884480,964180,-79700
6580,86,691731,500,884980,964680,-79700
6580,86,691731,500,885080,964230,-79150
6579,84,691638,500,885480,964280,-78800
6581,83,691764,500,885580,964330,-78750
6581,83,691764,50,885530,964380,-78850
6581,83,691764,50,885580,964880,-79300
6581,83,691764,50,885630,965180,-79550
6581,83,691764,50,885630,964930,-79300
6581,83,691764,50,885680,965430,-79750
6581,83,691764,500,886130,965230,-79100
6581,83,691764,500,886180,965280,-79100
6582,86,691782,500,886630,965330,-78700
6582,86,691782,500,886680,965830,-79150
6582,86,691782,500,887130,965930,-78800
6582,86,691782,500,887180,966330,-79150
6582,86,691782,500,887630,965980,-78350
6582,86,691782,500,887680,966030,-78350
6582,86,691782,500,888130,966380,-78250
6582,86,691782,500,888180,966880,-78700
6582,86,691782,500,888630,967030,-78400
6582,86,691782,500,888680,967380,-78700
6583,80,691800,500,889130,967080,-77950
6583,80,691800,500,889180,967580,-78400
6583,80,691800,50,889180,967880,-78700
6583,80,691800,50,889230,967630,-78400
6583,80,691800,50,889230,967680,-78450
6583,80,691800,500,889730,967730,-78000
6583,80,691800,500,889730,967780,-78050
6583,80,691800,50,889780,968380,-78600
6583,80,691800,50,889780,968830,-79050
6583,80,691800,50,889830,968430,-78600
6583,80,691800,500,890280,968930,-78650
6583,80,691800,500,890330,968880,-78550
6583,80,691800,500,890780,968930,-78150
6583,80,691800,500,890830,969430,-78600
6584,90,691805,50,890830,966530,-75700
6584,90,691805,500,891330,967830,-76500
6584,90,691805,500,891330,968330,-77000
6584,90,691805,50,891380,968980,-77600
6584,90,691805,500,891830,969480,-77650
6584,90,691805,50,891430,969930,-78500
6584,90,691805,50,891480,969980,-78500
6585,87,691808,500,891980,970430,-78450
6585,87,691808,500,892330,970030,-77700
6585,87,691808,50,892030,970080,-78050
6585,87,691808,500,892530,970580,-78050
6585,87,691808,50,892380,970480,-78100
6585,87,691808,500,892880,970980,-78100
6585,87,691808,50,892580,970630,-78050
6585,87,691808,500,893080,970680,-77600
6585,87,691808,500,893380,971030,-77650
6580,86,691731,500,893580,971080,-77500
6586,81,691837,50,893430,971130,-77700
6586,81,691837,500,893930,971180,-77250
6586,81,691837,500,894080,971230,-77150
6586,81,691837,500,894430,971680,-77250
6586,81,691837,50,894130,971730,-77600
6586,81,691837,50,894180,971730,-77550
6586,81,691837,50,894230,972230,-78000
6586,81,691837,50,894280,972230,-77950
6586,81,691837,500,894780,972730,-77950
6586,81,691837,500,894930,972830,-77900
6581,83,691764,500,895280,973330,-78050
6587,86,691867,50,894980,973730,-78750
6587,86,691867,50,895030,973380,-78350
6587,86,691867,500,895530,973880,-78350
6587,86,691867,50,895330,974230,-78900
6587,86,691867,50,895380,974380,-79000
6587,86,691867,500,895880,974280,-78400
6587,86,691867,500,896030,974330,-78300
6587,86,691867,500,896380,974830,-78450
6587,86,691867,500,896530,971180,-74650
6583,80,691800,50,896430,972730,-76300
6584,90,691805,500,896930,972780,-75850
6587,86,691867,500,897030,973230,-76200
6588,90,692022,50,896980,974430,-77450
6588,90,692022,500,897480,974930,-77450
6588,90,692022,500,897530,974880,-77350
6588,90,692022,500,897980,974930,-76950
6588,90,692022,50,897580,975430,-77850
6588,90,692022,600,958530,975430,-16900
6588,90,692022,1750,955180,975930,-20750
6588,90,692022,2700,956180,975480,-19300
6588,90,692022,3450,957680,975530,-17850
6588,90,692022,1850,959680,975580,-15900
6589,86,692303,2550,960230,976080,-15850
6589,86,692303,2900,961580,975980,-14400
6589,86,692303,2850,963080,976480,-13400
6589,86,692303,4800,965330,976580,-11250
6589,86,692303,4350,967586,976980,-9394
6589,86,692303,4850,969792,977080,-7288
6589,86,692303,1300,970486,977030,-6544
6589,86,692303,1950,971542,977080,-5538
6589,86,692303,1750,973886,977580,-3694
6590,84,692303,3800,974292,977580,-3288
6590,84,692303,3250,976342,978080,-1738
6590,84,692303,1550,976036,977630,-1594
6590,84,692303,1900,977942,978130,-188
6590,84,692303,4200,978942,978580,362
6590,84,692303,4800,981142,978180,2962
6590,84,692303,3900,983186,978230,4956
6589,86,692303,4750,986292,978280,8012
6589,86,692303,2450,986486,978780,7706
6590,84,692303,4350,991492,978630,12862
6591,84,692520,3350,991636,979130,12506
6591,84,692520,3250,991136,979280,11856
6591,84,692520,3250,994936,979180,15756
6591,84,692520,2200,995392,979680,15712
6591,84,692520,2350,994342,981230,13112
6591,84,692520,3300,997736,982530,15206
6591,84,692520,2300,998042,984380,13662
6591,84,692520,4200,999986,985380,14606
6591,84,692520,500,900880,986480,-85600
6591,84,692520,50,900880,987930,-87050
6591,84,692520,500,901380,988680,-87300
6592,84,692825,50,900930,990280,-89350
6592,84,692825,50,900980,991430,-90450
6592,84,692825,50,901030,992480,-91450
6592,84,692825,500,901530,993080,-91550
6592,84,692825,500,901880,994130,-92250
6592,84,692825,500,902030,995330,-93300
6592,84,692825,500,902380,996780,-94400
6593,84,693167,50,902080,999080,-97000
6593,84,693167,50,902130,999980,-97850
6593,84,693167,500,902630,981930,-79300
6593,84,693167,500,902880,981980,-79100
6593,84,693167,50,902680,982030,-79350
6593,84,693167,500,903180,982080,-78900
6593,84,693167,50,902930,982130,-79200
6593,84,693167,500,903430,982580,-79150
6593,84,693167,500,903680,982630,-78950
6593,84,693167,500,903930,981530,-77600
6594,84,693212,50,903730,981580,-77850
6594,84,693212,500,904230,982080,-77850
6594,84,693212,50,903980,983080,-79100
6594,84,693212,500,904480,982680,-78200
6594,84,693212,50,904280,982730,-78450
6594,84,693212,50,904330,982780,-78450
6594,84,693212,50,904380,983280,-78900
6594,84,693212,500,904880,983580,-78700
6594,84,693212,50,904530,983330,-78800
6594,84,693212,500,905030,983380,-78350
6593,84,693167,50,904930,983880,-78950
6594,84,693212,500,905430,984080,-78650
6595,90,693376,500,905530,984380,-78850
6595,90,693376,50,905480,984130,-78650
6595,90,693376,50,905530,984630,-79100
6595,90,693376,50,905580,984430,-78850
6595,90,693376,50,905580,984930,-79350
6595,90,693376,50,905630,985130,-79500
6595,90,693376,50,905630,985430,-79800
6595,90,693376,50,905680,985180,-79500
6595,90,693376,500,906130,985680,-79550
6595,90,693376,500,906180,985930,-79750
6595,90,693376,500,906630,986180,-79550
6596,80,693401,50,906230,985980,-79750
6596,80,693401,50,906280,986480,-80200
6596,80,693401,50,906330,986230,-79900
6596,80,693401,500,906830,986280,-79450
6596,80,693401,50,906680,986330,-79650
6596,80,693401,50,906730,986380,-79650
6596,80,693401,50,906780,986880,-80100
6596,80,693401,50,906830,986530,-79700
6597,81,693429,50,906880,987030,-80150
6597,81,693429,500,907330,987380,-80050
6597,81,693429,500,907380,987530,-80150
6597,81,693429,50,907380,987430,-80050
6597,81,693429,500,907880,987930,-80050
6597,81,693429,500,907880,987580,-79700
6597,81,693429,50,907930,988080,-80150
6597,81,693429,50,907930,987980,-80050
6597,81,693429,500,908430,988480,-80050
6597,81,693429,50,907980,988130,-80150
6597,81,693429,500,908480,988630,-80150
6597,81,693429,500,908930,988530,-79600
6597,81,693429,50,908530,989030,-80500
6598,87,693618,50,908580,989080,-80500
6598,87,693618,500,909080,989130,-80050
6598,87,693618,500,909430,989180,-79750
6598,87,693618,50,909130,989180,-80050
6598,87,693618,50,909180,989230,-80050
6598,87,693618,50,909230,989680,-80450
6598,87,693618,50,909280,989130,-79850
6598,87,693618,500,909780,989730,-79950
6598,87,693618,50,909480,990230,-80750
6599,85,693707,50,909530,990230,-80700
6599,85,693707,50,909580,990280,-80700
6599,85,693707,50,909630,990280,-80650
6599,85,693707,500,910130,990330,-80200
6599,85,693707,500,910280,989730,-79450
6599,85,693707,50,910180,990780,-80600
6599,85,693707,500,910680,990380,-79700
6600,88,693729,50,910330,990430,-80100
6600,88,693729,500,910830,990930,-80100
6600,88,693729,50,910730,991280,-80550
6600,88,693729,500,911230,990980,-79750
6600,88,693729,500,911330,991480,-80150
6600,88,693729,50,911280,991330,-80050
6600,88,693729,50,911330,991830,-80500
6600,88,693729,50,911380,991980,-80600
6600,88,693729,500,911830,992330,-80500
6600,88,693729,50,911430,992480,-81050
6600,88,693729,50,911480,992830,-81350
6599,85,693707,500,911980,992980,-81000
6600,88,693729,50,911880,992880,-81000
6601,89,693829,500,912380,993380,-81000
6601,89,693829,500,912480,993480,-81000
6601,89,693829,500,912880,993430,-80550
6601,89,693829,50,912530,993930,-81400
6601,89,693829,500,913030,993530,-80500
6601,89,693829,500,913380,994030,-80650
6601,89,693829,500,913530,994430,-80900
6601,89,693829,500,913880,994530,-80650
6601,89,693829,50,913580,994480,-80900
6601,89,693829,500,914080,994980,-80900
6601,89,693829,500,914380,994580,-80200
6602,88,693927,500,914580,994630,-80050
6602,88,693927,50,914430,995130,-80700
6602,88,693927,50,914480,995480,-81000
6602,88,693927,50,914530,995630,-81100
6602,88,693927,50,914580,995980,-81400
6602,88,693927,50,914630,995680,-81050
6602,88,693927,500,915080,996180,-81100
6602,88,693927,50,914680,996030,-81350
6601,89,693829,50,914730,996080,-81350
6601,89,693829,50,914780,996130,-81350
6603,88,694036,50,914830,996630,-81800
6603,88,694036,50,914880,996680,-81800
6603,88,694036,50,914930,996680,-81750
6603,88,694036,50,914980,996730,-81750
6603,88,694036,50,915030,997180,-82150
6603,88,694036,50,915080,996780,-81700
6604,80,694053,500,915580,996830,-81250
6604,80,694053,500,915580,997330,-81750
6604,80,694053,50,915630,997280,-81650
6604,80,694053,500,916080,997780,-81700
6604,80,694053,500,916130,997380,-81250
6604,80,694053,50,916130,997880,-81750
6604,80,694053,50,916180,997830,-81650
6603,88,694036,50,916180,998330,-82150
6603,88,694036,50,916230,997230,-81000
6605,82,694378,500,916680,998380,-81700
6605,82,694378,500,916730,998830,-82100
6605,82,694378,50,916730,998430,-81700
6605,82,694378,50,916780,998480,-81700
6605,82,694378,500,917230,998980,-81750
6605,82,694378,50,916830,998880,-82050
6605,82,694378,500,917330,999380,-82050
6605,82,694378,500,917730,999480,-81750
6605,82,694378,50,917380,999530,-82150
6605,82,694378,50,917430,999580,-82150
6605,82,694378,50,917480,999930,-82450
6606,86,694382,500,917980,999880,-81900
