job_id,tasks_num_of_single_job,task_generation_time,total_time,complation_time,complation_time_ordered,shortened_completion_time
0,89,468,119500,7058,6968,90
1,84,2130,87000,8679,11819,-3140
2,84,2800,77000,9719,13279,-3560
3,86,3553,73000,14428,13339,1089
4,88,3699,64000,14129,14159,-30
5,85,4404,92500,14489,18779,-4290
6,87,5434,83500,15529,15559,-30
7,80,6269,80000,17449,17319,130
8,90,7503,100000,19629,18839,790
9,89,7539,114500,21029,20529,500
10,81,8819,90500,22949,21699,1250
11,90,10094,75000,24288,22879,1409
12,80,11307,80000,26529,24279,2250
13,80,11507,75000,27029,24339,2690
14,82,11671,61000,28449,25159,3290
15,88,11772,79000,29788,26109,3679
16,82,12168,76000,26698,27419,-721
17,85,13025,72500,28198,28419,-221
18,87,14120,88500,30129,28469,1660
19,80,15402,75000,32529,30979,1550
20,84,15509,97000,33689,32919,770
21,87,15796,88500,35288,35339,-51
22,87,22665,88500,34459,38199,-3740
23,87,23201,98500,36179,37029,-850
24,83,25408,86500,37529,39419,-1890
25,81,25976,100500,39449,40839,-1390
26,86,26950,83000,40788,41659,-871
27,81,29064,115500,43529,46279,-2750
28,90,29629,75000,41629,47159,-5530
29,85,30024,87500,44418,48029,-3611
30,90,31010,95000,47179,51839,-4660
31,90,32724,70000,46036,45269,767
32,89,33112,84500,50449,49419,1030
33,90,34622,95000,50039,52659,-2620
34,84,37761,67000,50319,52789,-2470
35,81,38691,105500,58179,57279,900
36,86,38969,103000,61038,59029,2009
37,88,38987,114000,60029,63659,-3630
38,82,39132,101000,61449,68279,-6830
39,82,39977,91000,63679,68339,-4660
40,86,40294,73000,66949,69159,-2210
41,84,40722,92000,59609,70029,-10420
42,84,40940,77000,68288,73779,-5491
43,80,42056,75000,70529,65919,4610
44,88,45686,79000,73788,66949,6839
45,83,46195,86500,76029,74659,1370
47,87,47044,93500,77949,79279,-1330
47,87,47044,63000,71918,71839,79
48,86,47564,63000,72039,72079,-40
49,88,47668,69000,72929,74979,-2050
50,89,47831,84500,80179,79339,840
51,81,47936,60500,77418,71729,5689
52,86,48625,63000,81529,80159,1370
53,82,49778,71000,82029,80289,1740
54,83,52395,61500,87029,69209,17820
55,86,52604,93000,90288,81029,9259
56,84,52970,87000,93029,84779,8250
57,87,54503,98500,94449,81309,13140
58,80,56304,95000,96679,84839,11840
59,81,56576,65500,98029,80979,17050
60,84,57449,92000,98529,85659,12870
61,89,60450,114500,99949,88229,11720
62,84,61552,97000,101288,90339,10949
63,82,64160,91000,103529,93729,9800
64,88,64733,74000,83347,94088,-10741
65,89,68767,94500,106788,96939,9849
66,88,68916,84000,107679,97748,9931
67,90,70223,95000,110949,97809,13140
68,90,73554,90000,90299,103248,-12949
69,84,74957,77000,112288,96789,15499
70,90,75289,130000,113179,104729,8450
71,88,75665,94000,100339,100468,-129
72,90,78428,75000,100379,107939,-7560
73,88,79695,69000,101259,108748,-7489
74,88,80722,109000,101668,105419,-3751
75,87,81934,83500,97929,108809,-10880
76,89,83267,69500,114529,110588,3941
77,80,84926,95000,115029,114248,781
78,89,85654,84500,117788,107809,9979
79,87,85745,73500,105839,114309,-8470
80,90,86100,115000,120029,113309,6720
81,85,87081,82500,112259,116088,-3829
82,82,87449,121000,123288,119748,3540
83,85,91023,102500,125529,118799,6730
84,85,93098,87500,128788,121229,7559
85,88,93924,109000,129679,124439,5240
86,84,97060,67000,131029,116779,14250
87,84,99864,77000,131529,124579,6950
88,83,100794,101500,132949,125248,7701
89,86,101814,103000,135179,129939,5240
90,85,102044,77500,121819,130748,-8929
91,80,102089,75000,120367,132229,-11862
92,88,103172,109000,136529,132588,3941
94,84,103292,93500,127839,136309,-8470
94,84,103292,81500,137029,137729,-700
95,88,105123,74000,138449,130659,7790
96,87,105398,88500,143949,138088,5861
97,81,106191,75500,146179,135159,11020
98,82,106201,111000,147529,140939,6590
99,83,106222,66500,128469,142158,-13689
100,85,106915,112500,149449,144658,4791
102,80,108894,92000,134259,144659,-10400
102,80,108894,64500,150788,143588,7200
103,84,109900,62000,134976,138469,-3493
104,88,110625,119000,151679,147248,4431
105,81,112599,90500,153029,145339,7690
106,85,113225,117500,154949,148729,6220
107,85,114015,102500,157179,149088,8091
108,82,114074,81000,158529,151939,6590
109,81,114435,70500,159029,152809,6220
110,84,115661,92000,161788,154229,7559
111,88,116526,64000,164029,149449,14580
112,90,117002,80000,164529,154919,9610
113,89,119470,119500,149469,155468,-5999
114,81,120805,100500,165949,160469,5480
115,81,122825,70500,168179,160509,7670
116,83,123612,81500,169529,160968,8561
117,83,124118,86500,170029,165919,4110
118,88,124872,99000,155086,166009,-10923
119,89,125493,89500,172788,166468,6320
120,85,125550,87500,173679,171509,2170
121,88,126761,94000,161536,171968,-10432
122,86,127780,78000,175029,171968,3061
123,83,131454,81500,175529,169559,5970
124,82,133303,76000,178288,176969,1319
125,81,135756,50500,167036,162979,4057
126,82,137609,86000,180529,173799,6730
127,87,138483,83500,183788,177009,6779
128,84,139880,82000,165418,174079,-8661
129,89,141793,74500,184679,175059,9620
130,89,144309,104500,186529,178339,8190
131,86,144738,98000,172898,182419,-9521
132,88,145787,89000,173035,182469,-9434
133,84,146393,72000,176969,180029,-3060
134,84,147616,82000,187949,184659,3290
135,90,149187,105000,192029,180559,11470
136,90,149344,90000,193449,187919,5530
137,87,152667,93500,194788,189279,5509
138,87,155173,78500,195679,190159,5520
139,85,155535,77500,197029,190289,6740
140,80,156847,75000,180609,194779,-14170
141,80,159227,70000,184035,180248,3787
142,86,159437,83000,187819,195789,-7970
143,86,160181,98000,187969,198919,-10950
144,82,165665,96000,200288,199009,1279
145,82,166882,91000,201179,204419,-3240
146,82,167595,81000,204449,204469,-20
147,83,170972,86500,208029,201309,6720
148,80,171374,75000,206679,200339,6340
149,86,173604,68000,193189,201579,-8390
150,81,176789,70500,208529,206799,1730
151,85,178933,102500,211288,207079,4209
152,87,179275,73500,196929,208059,-11130
153,80,179525,70000,197109,204509,-7400
154,80,180844,80000,215449,212299,3150
155,90,180998,70000,213529,212309,1220
156,82,181120,81000,214029,211339,2690
157,88,182836,84000,202429,213559,-11130
158,80,183208,65000,216788,217799,-1011
159,83,188099,71500,204469,216839,-12370
160,80,188769,80000,217679,217809,-130
161,83,191108,76500,219029,219059,-30
162,90,191324,90000,219529,223299,-3770
163,86,192368,88000,220949,226299,-5350
164,87,193578,123500,222288,229079,-6791
165,81,199161,85500,223179,234299,-11120
166,90,200288,85000,226449,234579,-8130
167,89,202066,99500,227788,237299,-9511
168,88,204115,69000,213369,227779,-14410
169,89,205747,104500,230029,239809,-9780
170,87,206035,108500,230529,240079,-9550
171,90,206308,75000,222036,241059,-19023
172,89,208374,74500,231949,233279,-1330
173,87,208805,83500,226469,234159,-7690
175,89,213036,80500,234179,245299,-11120
175,89,213036,84000,223129,245309,-22180
176,86,215541,93000,229929,245579,-15650
177,89,216251,99500,237449,246559,-9110
178,88,216618,114000,241529,240529,1000
179,81,216634,70500,241029,229439,11590
180,86,217607,88000,242949,248299,-5350
181,89,218091,89500,244288,244339,-51
182,87,219969,68500,237189,250799,-13610
183,88,220448,94000,239129,250809,-11680
184,83,222281,86500,248449,249779,-1330
185,87,222851,98500,249788,252059,-2271
186,87,223686,78500,250679,253799,-3120
187,80,223796,105000,246429,256299,-9870
188,83,224601,86500,246609,256579,-9970
189,82,225368,71000,248959,257559,-8600
190,88,226367,64000,250129,242147,7982
191,80,227623,65000,252029,259299,-7270
192,81,227708,75500,253689,255339,-1650
193,89,228643,79500,255288,261799,-6511
194,85,229345,67500,257429,261809,-4380
195,88,230140,84000,257529,263059,-5530
196,87,232139,88500,258029,267299,-9270
197,89,232438,74500,257609,267309,-9700
198,84,234583,82000,263529,268559,-5030
199,81,234734,75500,263029,270299,-7270
200,87,235791,93500,259959,274059,-14100
201,89,237029,79500,263109,275799,-12690
202,86,237860,83000,264949,259007,5942
203,90,239723,95000,266288,278299,-12011
204,86,245977,103000,271788,266339,5449
205,87,246126,78500,268529,267289,1240
206,88,247698,64000,265279,278309,-13030
207,85,250287,92500,272679,279559,-6880
208,90,252567,65000,274529,281299,-6770
209,82,253734,76000,275949,265368,10581
210,82,254627,71000,270959,283799,-12840
211,90,255362,75000,277288,272868,4420
212,88,255386,109000,280029,285059,-5030
213,86,256825,78000,281449,286799,-5350
215,88,257702,75000,283679,289299,-5620
215,88,257702,63500,282788,289309,-6521
216,84,258057,92000,285029,290559,-5530
217,84,259625,87000,288288,294799,-6511
218,87,259761,68500,281189,277368,3821
219,82,262680,91000,285109,280616,4493
220,82,262813,86000,290529,294809,-4280
221,87,264041,108500,292449,297799,-5350
222,81,267039,75500,293788,300299,-6511
225,89,271824,68500,296029,284529,11500
225,89,271824,101500,299288,301559,-2271
225,89,271824,103500,290609,303299,-12690
226,85,273448,82500,288585,305799,-17214
227,82,274379,86000,302029,306079,-4050
228,89,274578,84500,301529,295226,6303
229,88,274923,94000,304788,307059,-2271
230,84,275059,97000,303449,308799,-5350
231,81,275759,90500,307029,303948,3081
232,86,278568,88000,307529,311309,-3780
233,86,278603,88000,301429,314299,-12870
234,86,280007,88000,312529,305616,6913
235,81,280276,85500,313029,316809,-3780
236,88,281599,84000,315788,319799,-4011
237,83,282890,71500,305129,322299,-17170
238,83,283484,71500,302079,311116,-9037
239,90,284098,110000,316679,322309,-5630
240,81,285139,90500,318029,322579,-4550
241,90,287798,70000,309950,313647,-3697
242,86,288403,68000,310629,314007,-3378
243,87,288672,98500,321288,317226,4062
244,89,289066,94500,319949,325299,-5350
245,88,289556,89000,316391,328079,-11688
246,88,289751,99000,324029,333309,-9280
247,88,289989,89000,325449,333579,-8130
248,89,291424,89500,318409,334559,-16150
249,88,294191,84000,329029,328558,471
250,81,295442,100500,321891,338809,-16918
252,82,295938,82000,332288,331558,730
252,82,295938,80500,330949,341799,-10850
253,83,297497,101500,333179,344299,-11120
254,85,298469,72500,334529,344579,-10050
255,85,298749,82500,336449,347299,-10850
256,88,299810,84000,338679,349809,-11130
257,80,302254,70000,340029,350079,-10050
258,85,302547,82500,343288,330116,13172
259,89,303040,74500,344179,351059,-6880
260,84,304038,87000,345529,352799,-7270
261,90,304792,75000,334006,335668,-1662
262,80,305289,80000,339929,355309,-15380
263,85,305879,62500,346029,341058,4971
264,84,305974,87000,349679,355579,-5900
265,88,307120,84000,351529,356559,-5030
266,87,307995,68500,338085,360799,-22714
267,82,308065,71000,352949,360809,-7860
268,81,310696,65500,355179,361079,-5900
269,83,310817,76500,354288,362059,-7771
270,80,311497,80000,356529,363799,-7270
271,88,313031,74000,357029,366299,-9270
272,83,313440,76500,348450,358558,-10108
273,89,314541,74500,349085,366309,-17224
274,81,315254,60500,358449,366579,-8130
275,88,316269,99000,359788,369299,-9511
276,89,316465,89500,362529,371809,-9280
277,86,322391,73000,357885,349616,8269
278,82,322768,71000,358116,372079,-13963
279,82,322875,101000,365288,374799,-9511
280,85,325117,72500,366179,355116,11063
281,89,327288,64500,367529,357616,9913
282,90,328471,115000,368029,377579,-9550
283,90,328728,120000,374949,380299,-5350
284,83,329111,86500,371679,382809,-11130
285,88,329780,94000,365891,383079,-17188
286,83,332063,71500,367609,366116,1493
287,90,332950,120000,376288,388299,-12011
288,81,334714,70500,364614,367668,-3054
289,87,335096,73500,368114,388309,-20195
290,80,335463,65000,377179,373668,3511
291,82,337329,96000,379029,391299,-12270
292,89,339447,54500,380449,378168,2281
293,84,339532,92000,375459,393799,-18340
294,87,340064,73500,376629,393809,-17180
295,81,340197,65500,381788,384668,-2880
296,86,341882,73000,382679,396799,-14120
297,82,343186,66000,378616,389168,-10552
298,88,343723,64000,380495,390668,-10173
299,80,344664,90000,384029,399299,-15270
300,87,345160,83500,384529,399579,-15050
301,89,345700,79500,386459,402299,-15840
302,84,346008,77000,387288,404799,-17511
303,82,349330,81000,388179,404809,-16630
304,88,349741,84000,382391,405079,-22688
305,86,351644,68000,389429,406059,-16630
306,80,353897,85000,389609,407799,-18190
307,87,355051,78500,390029,390647,-618
308,89,355799,69500,391189,393616,-2427
310,81,356753,88000,396689,410309,-13620
310,81,356753,90000,394234,399116,-4882
311,90,359375,90000,398629,411559,-12930
312,80,361104,100000,402189,413299,-11110
313,89,361692,119500,404129,415809,-11680
314,86,363403,108000,411429,416079,-4650
315,85,363768,92500,408459,417059,-8600
316,85,364097,82500,396736,421299,-24563
317,87,365147,78500,411609,421309,-9700
318,90,368315,90000,413959,422559,-8600
319,80,369525,60000,403995,424299,-20304
320,86,370490,98000,407736,427079,-19343
321,90,371629,80000,415129,429799,-14670
322,82,372510,86000,408884,432299,-23415
323,81,374595,85500,411384,423778,-12394
324,89,375959,84500,417109,424778,-7669
325,83,376549,86500,418689,432309,-13620
326,83,378493,101500,420629,432579,-11950
327,85,379033,77500,421385,433559,-12174
328,87,379188,63500,422429,435299,-12870
329,80,379518,100000,422609,437809,-15200
330,89,380458,89500,424189,439059,-14870
331,85,381349,92500,420288,443309,-23021
332,81,383202,85500,424959,420135,4824
333,90,384119,95000,428234,432116,-3882
334,90,384221,85000,429193,444559,-15366
335,86,384400,83000,429689,434616,-4927
336,87,384561,103500,433429,446299,-12870
337,82,384667,66000,431629,448799,-17170
338,85,385565,102500,433609,450059,-16450
339,81,385717,70500,429949,451799,-21850
340,90,390400,90000,435959,425788,10171
341,86,391796,78000,435497,454309,-18812
342,85,391886,97500,436788,455559,-18771
343,87,392952,83500,438929,459799,-20870
344,83,395480,76500,439109,440147,-1038
345,89,396580,89500,439529,459809,-20280
346,81,396923,80500,440949,445616,-4667
347,80,397353,65000,440689,440788,-99
348,86,397813,93000,442629,460079,-17450
349,80,398508,70000,444429,461059,-16630
351,81,400069,65000,438193,446288,-8095
351,81,400069,100000,446189,465309,-19120
352,81,402624,80500,453629,451116,2513
353,88,402895,89000,452459,466559,-14100
354,90,402895,75000,450109,468299,-18190
355,83,407676,76500,450844,470799,-19955
356,83,410113,76500,455429,470809,-15380
357,84,410254,102000,455844,471079,-15235
358,90,411159,100000,461344,472059,-10715
359,88,411355,44000,462344,461755,589
360,80,413915,75000,463344,476299,-12955
361,80,414357,90000,464693,476309,-11616
362,82,415297,76000,457959,476579,-18620
363,82,416537,71000,459129,462507,-3378
364,82,420320,81000,463459,477559,-14100
365,90,420958,100000,464629,479299,-14670
366,80,423046,80000,469646,481809,-12163
367,88,423114,74000,471607,458846,12761
368,83,423594,96500,474107,482079,-7972
369,85,424240,92500,475146,483059,-7913
370,89,424528,89500,475107,485898,-10791
371,82,425230,96000,473689,488559,-14870
372,88,426663,69000,469495,488398,-18903
373,87,427194,93500,475629,492897,-17268
374,90,427955,95000,477429,496897,-19468
375,83,430016,91500,479189,499398,-20209
376,84,430106,97000,481129,502397,-21268
377,83,430122,71500,479959,504398,-24439
378,84,431898,67000,482929,506398,-23469
379,89,432041,89500,483109,508898,-25789
381,80,433716,105500,485459,511397,-25938
381,80,433716,79500,484689,512897,-28208
382,82,434448,96000,488429,514897,-26468
383,82,434500,91000,486954,516398,-29444
384,81,435994,80500,489954,519398,-29444
385,81,437808,65500,491193,522397,-31204
386,83,439049,56500,496454,524398,-27944
387,86,439279,73000,496954,525397,-28443
388,82,439908,76000,498454,517374,-18920
389,83,440964,86500,500693,519374,-18681
390,87,443024,108500,505454,521374,-15920
391,85,443038,112500,506193,523874,-17681
392,85,443634,97500,507193,515079,-7886
393,82,444378,96000,507454,516059,-8605
394,86,444673,83000,499486,517799,-18313
395,88,445315,104000,500586,520579,-19993
396,83,446227,91500,503085,506116,-3031
397,87,449564,68500,501217,497456,3761
398,85,451438,127500,506689,523299,-16610
399,82,451929,71000,507459,525799,-18340
400,90,453307,65000,507716,525809,-18093
401,82,456017,66000,510598,493529,17069
402,90,456693,90000,510216,509116,1100
403,81,457211,75500,510609,502839,7770
404,89,457775,104500,512189,526079,-13890
405,87,460056,83500,509179,527059,-17880
406,82,461294,61000,498547,528799,-30252
407,82,463241,86000,514129,512007,2122
408,89,463268,89500,512959,531579,-18620
409,89,463464,64500,506977,534299,-27322
410,84,464064,77000,516109,515226,883
411,90,467357,90000,517689,536809,-19120
412,87,470755,93500,518459,539799,-21340
413,81,471647,75500,519288,542309,-23021
414,88,473975,99000,521529,543559,-22030
415,83,474322,96500,521803,545299,-23496
416,81,475522,70500,524803,522616,2187
417,80,477443,95000,527803,548079,-20276
418,81,477700,85500,528303,528147,156
419,83,477924,76500,528803,550799,-21996
420,89,480189,89500,531803,525789,6014
421,90,481777,95000,534454,553299,-18845
422,90,483728,105000,536954,554559,-17605
423,84,485731,72000,537954,558799,-20845
424,82,486665,71000,540803,558809,-18006
425,83,487682,91500,542303,559079,-16776
426,83,487814,66500,543803,560059,-16256
427,80,488769,65000,532429,561799,-29370
428,85,491386,67500,531237,537018,-5781
429,80,491436,95000,533029,564309,-31280
430,84,492931,102000,535788,567299,-31511
431,90,495366,95000,537929,569809,-31880
432,81,495678,75500,536737,571059,-34322
433,81,497234,75500,540165,575299,-35134
434,85,500068,82500,541548,549995,-8447
435,81,502060,70500,543529,553374,-9845
436,83,502530,106500,543429,575309,-31880
437,84,504142,97000,545665,575579,-29914
438,83,505950,91500,552548,576559,-24011
439,85,506232,82500,552404,578299,-25895
440,80,509733,80000,553237,580799,-27562
441,80,509817,60000,551459,580809,-29350
442,83,510690,81500,551303,581079,-29776
443,88,514906,69000,554564,582059,-27495
444,84,515659,92000,557803,586309,-28506
445,80,516226,80000,561064,547616,13448
446,89,516522,64500,562303,586579,-24276
447,85,517707,82500,565064,589299,-24235
448,89,518395,69500,566564,557839,8725
449,81,519317,95500,569064,559529,9535
450,86,521229,103000,573064,591799,-18735
451,80,521578,70000,575064,591809,-16745
452,88,522555,104000,579564,597299,-17735
453,80,523513,70000,582303,597309,-15006
454,80,524258,55000,585303,564289,21014
455,87,524721,88500,586564,597579,-11015
456,82,525041,61000,586303,600299,-13996
457,86,525866,68000,569706,602799,-33093
458,89,526145,89500,571206,603079,-31873
459,82,527203,96000,572206,572518,-312
460,81,531677,90500,574206,604059,-29853
461,88,532380,84000,576706,608299,-31593
463,85,533104,88500,579206,608309,-29103
463,85,533104,97000,579706,611299,-31593
464,90,534089,100000,580206,613799,-33593
466,87,534672,71000,580679,587495,-6816
466,87,534672,88000,582029,613809,-31780
467,88,534832,109000,585404,615059,-29655
468,80,535359,70000,585288,616799,-31511
469,80,536195,80000,589665,595017,-5352
470,82,536400,56000,587085,598017,-10932
471,82,538640,81000,591085,600518,-9433
472,83,538811,71500,591585,619299,-27714
473,83,539620,66500,594416,619309,-24893
474,87,539975,88500,596416,619579,-23163
475,80,541034,65000,597416,610017,-12601
476,82,541374,71000,595165,620559,-25394
477,85,544646,97500,597179,622299,-25120
478,80,545047,110000,598529,624809,-26280
479,80,545763,75000,599029,625079,-26050
480,81,545802,90500,600665,626059,-25394
481,82,546073,61000,601904,627799,-25895
482,80,548613,80000,601923,630299,-28376
483,86,551822,78000,604923,630579,-25656
484,81,552674,65500,611064,631559,-20495
485,90,552840,65000,612564,633299,-20735
486,81,552878,55500,612064,599616,12448
487,86,554209,63000,613923,599647,14276
488,87,555392,78500,617423,598235,19188
489,82,557004,81000,620564,635809,-15245
490,85,559704,67500,622564,636079,-13515
491,86,561501,68000,625923,606115,19808
492,86,561870,98000,628064,637059,-8995
493,81,562186,95500,629564,612984,16580
494,90,562717,90000,632423,638799,-6376
496,85,565454,70000,633064,617984,15080
496,85,565454,72000,634064,641309,-7245
497,88,565886,94000,625946,641579,-15633
500,85,567193,85500,627316,626115,1201
501,82,567203,112500,629946,642559,-12613
501,82,567203,72500,630446,644299,-13853
501,82,567203,65000,630457,634615,-4158
502,88,567975,69000,626916,636615,-9699
503,90,568163,105000,628205,647079,-18874
504,82,569786,76000,629416,649799,-20383
505,89,571441,109500,630705,652299,-21594
506,89,572424,89500,635705,653559,-17854
507,83,572777,71500,639205,657799,-18594
508,83,573260,81500,641705,657809,-16104
509,83,575599,86500,634904,658079,-23175
510,80,576672,70000,621470,647127,-25657
511,80,577095,70000,623788,649627,-25839
512,90,578573,75000,635048,652127,-17079
513,89,580826,89500,628977,655127,-26150
514,81,581031,100500,635737,659059,-23322
515,81,583048,85500,639165,658627,-19462
516,88,584945,84000,640404,660799,-20395
517,87,586737,83500,637533,663299,-25766
518,85,591958,102500,643564,636226,7338
519,89,592355,94500,650064,663309,-13245
521,86,592562,102500,652533,643616,8917
522,87,592701,78000,652564,643647,8917
522,87,592701,73000,653064,663579,-10515
523,80,592851,70000,654533,646616,7917
524,80,592897,75000,654564,647226,7338
525,82,593716,71000,657533,649116,8417
526,87,594453,93500,660533,666299,-5766
527,87,596607,73500,664564,668799,-4235
528,89,597099,89500,666033,650484,15549
529,89,601991,89500,671564,668809,2755
530,83,602142,76500,672533,669079,3454
531,90,604025,70000,676033,657725,18308
532,88,604223,84000,677064,670059,7005
533,80,607850,85000,678564,661484,17080
534,80,608692,85000,681064,671799,9265
535,82,609139,81000,682564,674309,8255
536,84,610241,82000,684564,674579,9985
537,90,611481,100000,678926,668566,10360
538,89,611484,89500,678426,675559,2867
539,81,611540,75500,678926,674566,4360
540,81,611980,95500,670705,677299,-6594
541,86,613579,73000,674205,678916,-4711
542,90,614868,80000,681036,681916,-880
543,82,615110,56000,683536,685916,-2380
544,90,615452,95000,684205,683484,721
545,89,616923,64500,686205,686725,-520
546,85,617988,87500,672165,688984,-16819
547,82,618205,61000,673404,691225,-17821
548,86,620880,73000,673548,693984,-20436
549,90,621365,145000,675529,691737,-16208
550,80,624910,100000,679737,693737,-14000
551,88,627542,84000,680047,697127,-17080
552,86,628972,78000,683165,699127,-15962
553,90,629095,75000,679679,702127,-22448
554,89,631285,84500,678175,705237,-27062
555,87,632714,98500,684548,708737,-24189
556,86,632975,88000,685675,709737,-24062
557,90,632984,115000,686175,712237,-26062
558,88,633400,89000,685643,714627,-28984
559,82,634155,81000,688175,716237,-28062
560,87,637564,98500,692175,719127,-26952
561,90,637710,80000,693674,694855,-1181
562,83,638412,101500,696175,696355,-180
563,80,638959,80000,698675,698355,320
564,83,639572,76500,699675,700755,-1080
565,80,641270,70000,702674,703355,-681
566,82,642479,81000,707536,704855,2681
567,81,642714,105500,708036,700779,7257
568,84,643492,92000,710536,701616,8920
569,80,643699,80000,711536,702226,9310
570,85,645120,107500,717536,703686,13850
571,88,645381,94000,720036,706416,13620
572,82,645522,81000,721036,708186,12850
573,83,647771,66500,725036,710416,14620
574,90,647905,105000,725036,713416,11620
575,80,650302,80000,728036,715186,12850
576,80,651387,95000,731036,717686,13350
577,83,651813,81500,733536,720186,13350
578,85,652980,62500,737536,722186,15350
579,88,653355,94000,740536,723416,17120
580,89,653488,89500,741036,724916,16120
581,86,654703,88000,743536,728186,15350
582,88,655518,79000,749036,730686,18350
584,80,656201,86000,752536,732916,19620
585,84,656289,70000,753536,734916,18620
585,84,656289,91500,754536,736416,18120
586,88,658440,79000,758536,738916,19620
587,85,658605,87500,758036,741416,16620
588,82,660467,91000,746656,743186,3470
589,81,660525,95500,746705,743835,2870
590,86,661681,83000,728288,745335,-17047
591,87,661789,83500,713929,748484,-34555
592,86,662475,103000,731029,750335,-19306
593,80,664151,80000,734679,751984,-17305
594,89,664616,79500,736529,753484,-16955
596,86,666387,61000,728548,740847,-12299
596,86,666387,82500,737949,744627,-6678
597,80,668210,65000,739288,747347,-8059
598,89,669107,94500,740179,749347,-9168
599,88,670239,104000,733904,750847,-16943
600,87,671663,98500,741529,752627,-11098
601,81,673576,85500,742029,754127,-12098
602,81,674210,85500,741284,756627,-15343
603,83,675790,81500,747784,757847,-10063
604,86,675866,68000,747285,760847,-13562
605,86,676329,78000,749285,762847,-13562
606,87,677064,93500,750785,765127,-14342
607,89,677692,84500,755285,767627,-12342
608,80,677858,85000,756285,770127,-13842
609,83,678532,86500,758784,773347,-14563
610,90,680021,105000,760785,774627,-13842
611,80,681184,60000,762284,776627,-14343
612,87,683403,83500,764784,778347,-13563
613,84,684260,107000,777753,779347,-1594
614,88,685136,99000,780753,781127,-374
616,89,686540,76000,786253,783627,2626
617,84,686582,74500,787253,786127,1126
617,84,686582,96500,787253,787627,-374
618,85,687741,82500,790253,762579,27674
619,81,691646,60500,791253,755779,35474
620,85,694602,47500,795753,755806,39947
621,86,695138,98000,798253,764616,33637
622,82,695941,81000,802753,765299,37454
623,90,696213,110000,803753,770147,33606
624,80,699945,65000,805753,770507,35246
625,88,701439,79000,812253,766484,45769
626,81,701646,65500,814753,768455,46298
628,88,701949,114000,815753,773299,42454
628,88,701949,98500,816753,775455,41298
629,90,702872,75000,821253,777455,43798
630,82,702994,71000,821753,781455,40298
631,90,703363,90000,823253,782984,40269
632,86,704562,93000,824753,791484,33269
633,82,705446,91000,829253,793985,35268
634,90,705509,100000,828753,795485,33268
635,87,706203,88500,831753,796985,34768
636,84,707765,87000,834253,799985,34268
637,90,708955,80000,836253,801985,34268
638,89,710698,79500,798775,804484,-5709
639,89,711452,84500,800276,807485,-7209
640,82,711740,81000,800775,810485,-9710
641,82,713269,86000,789737,813484,-23747
642,87,714961,73500,790047,814984,-24937
643,80,716505,80000,785652,816984,-31332
644,82,716758,101000,794548,817985,-23437
645,84,716936,102000,795237,820484,-25247
646,89,719616,79500,824904,821484,3420
647,84,721875,57000,829404,823985,5419
648,85,722048,87500,831904,825985,5919
649,80,722172,85000,832904,829484,3420
650,90,723200,90000,834905,831485,3420
651,83,724854,91500,838405,834984,3421
652,80,725535,55000,841904,835985,5919
653,83,725880,66500,843404,838485,4919
654,84,726919,87000,846905,840985,5920
655,85,727330,102500,848905,843485,5420
656,90,728485,75000,851904,847485,4419
657,80,729901,100000,855404,849984,5420
658,83,732232,81500,859905,850985,8920
659,80,732648,80000,860904,816967,43937
660,83,735254,91500,864404,819627,44777
661,81,736424,65500,865904,821467,44437
663,83,739094,87000,870905,826308,44597
663,83,739094,81000,870904,829308,41596
664,88,746051,89000,872404,831808,40596
665,86,747560,73000,875904,832808,43096
666,84,748713,87000,882904,835308,47596
667,81,749075,60500,885404,836808,48596
668,88,749243,79000,887404,838467,48937
669,85,749282,62500,886905,840467,46438
670,89,750123,79500,895905,843467,52438
672,83,750230,85500,896904,846627,50277
673,88,750455,91500,897404,849627,47777
673,88,750455,78500,897905,852467,45438
674,84,750795,52000,898404,855467,42937
675,88,751055,94000,897405,857627,39778
676,85,751272,92500,898405,858967,39438
677,89,751909,69500,833737,858808,-25071
678,83,753579,86500,833275,860308,-27033
679,88,754477,94000,835775,863808,-28033
680,88,754846,79000,836775,866308,-29533
681,80,755681,115000,840896,868808,-27912
682,88,756161,114000,842665,871808,-29143
683,82,757737,91000,843904,873808,-29904
684,89,759578,59500,845896,875808,-29912
685,90,761972,90000,848396,877808,-29412
686,90,763514,80000,851396,879808,-28412
687,90,764771,120000,853775,881808,-28033
688,81,765391,100500,855396,881808,-26412
689,89,767061,94500,873873,861726,12147
690,81,767381,100500,874373,863616,10757
691,82,770476,76000,876373,863416,12957
692,90,771358,85000,879873,864416,15457
693,84,772377,67000,882373,861065,21308
694,87,773414,108500,883873,866616,17257
695,90,776334,110000,887373,864064,23309
696,84,778142,87000,892873,865064,27809
697,82,778158,101000,891873,867565,24308
698,81,778719,70500,894373,869064,25309
699,84,779920,72000,896873,871565,25308
700,85,781175,92500,899373,875064,24309
701,87,783441,88500,902373,876565,25808
702,81,784221,95500,905373,878065,27308
703,88,785667,74000,908373,880564,27809
704,86,786413,93000,911873,883065,28808
705,86,786748,98000,912873,887565,25308
707,89,788013,95000,915373,891064,24309
707,89,788013,109000,918373,893565,24808
708,83,788627,71500,921873,895065,26808
709,86,789080,78000,923873,886095,37778
710,90,789386,100000,924373,888595,35778
711,87,790151,73500,925873,892594,33279
712,81,792164,100500,928373,894095,34278
713,88,793159,99000,931873,897095,34778
715,83,793704,92500,934873,900595,34278
715,83,793704,71000,934373,903095,31278
716,85,798404,77500,942373,904594,37779
717,87,798604,88500,943373,906594,36779
718,84,798858,102000,946373,909594,36779
719,84,799087,72000,944873,911595,33278
720,85,799177,92500,945873,914094,31779
721,84,799627,87000,882404,916094,-33690
722,88,801644,109000,883547,917095,-33548
723,80,801798,80000,873506,920094,-46588
724,83,804244,71500,883179,920594,-37415
725,90,805250,95000,886665,923594,-36929
726,86,806660,108000,888048,926095,-38047
727,81,808090,70500,890029,928594,-38565
728,82,808247,81000,890529,930594,-40065
729,88,808930,54000,890152,933594,-43442
730,88,811633,84000,893288,936095,-42807
731,86,812494,78000,898152,939594,-41442
732,86,812937,83000,949515,942595,6920
733,82,812997,86000,949014,945594,3420
734,88,815126,79000,951514,947094,4420
735,83,815795,96500,953515,938026,15489
736,83,820840,111500,957515,940026,17489
737,88,820881,74000,958014,941526,16488
738,80,823461,65000,961015,945026,15989
739,88,824802,99000,965515,947526,17989
740,80,825173,100000,969014,949026,19988
741,88,825384,89000,969514,951026,18488
742,82,827087,121000,972015,952526,19489
743,81,827692,70500,974015,954526,19489
744,88,829939,84000,977515,957526,19989
745,80,830475,85000,979514,959526,19988
746,86,832265,83000,980015,962026,17989
747,85,833148,67500,983015,965526,17489
748,88,833681,114000,985014,969526,15488
749,90,835921,110000,989015,972526,16489
750,89,835924,89500,989014,974026,14988
751,86,837046,78000,992514,975026,17488
752,82,837497,91000,995014,933226,61788
753,81,837630,65500,996515,935116,61399
755,85,838492,48500,999515,935147,64368
756,82,838563,79500,998514,935507,63007
756,82,838563,72500,999514,938116,61398
757,87,838722,67500,999014,940174,58840
758,84,838998,102000,950506,942174,8332
759,85,839969,67500,943146,944674,-1528
761,81,842160,65500,943256,947174,-3918
762,81,845306,81000,945256,949175,-3919
763,82,847651,72000,947256,951674,-4418
763,82,847651,75000,950146,954675,-4529
764,82,850608,70500,952146,958174,-6028
765,83,850964,66000,954756,959675,-4919
766,84,851541,63500,957146,962674,-5528
768,84,852706,55500,960146,964674,-4528
768,84,852706,93000,959646,966675,-7029
770,86,852901,84000,950393,968675,-18282
771,86,853274,76000,950634,969675,-19041
772,84,854939,66000,949893,971674,-21781
774,84,856066,91000,943679,974175,-30496
773,88,855976,76000,945029,977674,-32645
774,84,856066,100000,945529,979674,-34145
775,84,856744,72000,941665,980675,-39010
777,82,859023,60000,943048,982674,-39626
777,82,859023,95500,950529,956834,-6305
778,81,861045,90500,952449,962647,-10198
779,85,861186,82500,947165,963299,-16134
781,83,862241,66500,954679,964334,-9655
781,83,862241,91000,953788,971299,-17511
782,81,862926,85500,956029,971309,-15280
783,81,864552,75500,956983,971334,-14351
784,85,864584,67500,956873,973333,-16460
785,83,865106,86500,959288,974299,-15011
786,81,865780,100500,962483,976809,-14326
787,90,866260,95000,963483,979799,-16316
788,80,868816,80000,968483,982299,-13816
789,90,868846,100000,968983,983559,-14576
790,83,869462,86500,970873,984467,-13594
791,90,871696,95000,973873,987799,-13926
792,90,873392,100000,980873,990347,-9474
793,81,873409,110500,980483,992847,-12364
794,83,873837,81500,981873,994467,-12594
795,85,873923,102500,982873,995847,-12974
797,89,875218,59000,986373,998847,-12474
797,89,875218,69000,986873,999967,-13094
798,83,875844,101500,992373,982116,10257
799,80,876047,55000,991483,971372,20111
801,86,877600,63500,997873,982726,15147
801,86,877600,67500,997373,977205,20168
802,84,878812,92000,999483,993299,6184
803,81,880263,83500,999983,982094,17889
804,86,881593,82000,994626,984616,10010
805,80,882020,88500,996126,993309,2817
806,80,884134,69500,996626,994559,2067
807,86,884630,63000,999275,991094,8181
808,84,885052,80000,999775,996299,3476
809,83,886809,55500,973646,996205,-22559
810,80,889152,66500,993237,998799,-5562
811,80,889528,82000,993547,999705,-6158
812,90,890418,75500,998048,995647,2401
813,81,892708,56000,985449,982417,3032
814,87,893512,70000,990376,985528,4848
815,83,893617,70500,991146,998616,-7470
816,88,896073,98500,999047,990917,8130
817,81,897790,93000,995146,999226,-4080
818,84,899028,56000,998376,995417,2959
819,85,899629,75500,999876,997528,2348
820,89,901491,58000,999634,999917,-283
821,82,901577,77500,997503,998674,-1171
822,89,902052,58000,999503,999785,-282
823,81,904049,56500,993179,991136,2043
824,89,906677,74500,994529,993636,893
825,87,908168,115500,995029,997765,-2736
826,81,910234,63500,996449,999136,-2687
827,82,910436,53500,991293,999636,-8343
828,81,910750,78000,991673,981068,10605
829,88,912281,63000,994673,986288,8385
830,88,913143,88500,997788,986483,11305
831,86,917320,75000,999793,991788,8005
832,80,917793,68500,999293,991983,7310
833,90,918555,72500,999584,997483,2101
835,81,918622,70000,999636,997483,2153
836,87,918642,44000,999286,987356,11930
836,87,918642,78000,999843,990235,9608
837,88,919088,61000,999152,997568,1584
838,88,921397,69500,999756,996235,3521
840,84,927082,56000,997219,999356,-2137
841,87,927727,39000,999257,999856,-599
844,80,928777,51500,999489,999872,-383
845,88,928821,44000,999977,999965,12
847,82,930672,59500,999970,995584,4386
849,86,933899,45500,999923,998584,1339
850,81,936749,56000,999929,999936,-7
850,81,936749,46500,999423,996515,2908
850,81,936749,31500,992459,999049,-6590
850,81,936749,30500,994403,999199,-4796
850,81,936749,26000,996459,999299,-2840
850,81,936749,36000,998459,997681,778
851,88,937372,34500,999959,998940,1019
852,87,938225,30000,999767,999950,-183
853,89,938776,14000,999201,998181,1020
854,90,940078,24500,999084,998515,569
856,86,941044,17500,999614,998681,933
856,86,941044,36500,997939,999015,-1076
857,82,943658,16000,999932,999181,751
858,82,944142,45000,999939,998659,1280
859,82,945142,2500,994469,999515,-5046
860,90,945847,16500,997409,999971,-2562
861,88,947435,8500,998478,999983,-1505
863,85,948891,2000,999978,999529,449
863,85,948891,1000,999478,995094,4384
