job_id,tasks_num_of_single_job,task_generation_time,total_time,complation_time,complation_time_ordered,shortened_completion_time
0,80,31,21550,1086,1182,-96
1,87,70,25950,1582,2084,-502
2,88,217,21050,2733,2734,-1
3,89,245,22000,2636,3286,-650
4,86,337,25450,3234,3786,-552
5,86,361,23650,3224,3731,-507
6,85,371,27200,3033,4484,-1451
7,82,632,23450,3425,4582,-1157
8,82,791,22100,4124,4883,-759
9,90,892,25200,5031,6528,-1497
10,88,1184,22400,5968,8189,-2221
11,87,1357,25950,6021,9683,-3662
12,90,1360,22500,6284,10828,-4544
13,87,1451,24600,6584,14028,-7444
14,81,1552,22500,7271,15678,-8407
15,81,1707,19800,7184,15433,-8249
16,80,1792,23800,7487,9539,-2052
17,89,1975,24700,16382,12139,4243
18,86,1989,24100,10139,13332,-3193
19,83,2200,22600,11339,15389,-4050
20,90,2256,27450,9876,17632,-7756
21,89,2508,26500,10674,8586,2088
22,90,2530,27000,11521,8968,2553
23,81,2652,21150,11424,9468,1956
24,89,2775,22900,9987,10370,-383
25,90,2889,27000,11087,11523,-436
26,87,2897,24150,11087,12018,-931
27,89,3182,22000,12987,12584,403
28,90,3238,23850,12984,14034,-1050
29,80,3274,22900,13083,14734,-1651
30,90,3404,24300,15037,15689,-652
31,88,3457,23300,15636,17239,-1603
32,89,3501,24250,15282,18889,-3607
33,84,3529,23100,15587,20689,-5102
34,86,3789,25450,16136,22284,-6148
35,86,3969,20050,16031,23834,-7803
36,88,4059,25100,17285,25884,-8599
37,86,4079,22750,17034,26484,-9450
38,90,4134,24300,17335,27339,-10004
39,88,4161,23300,18485,28184,-9699
40,90,4251,22950,18435,30289,-11854
41,83,4295,21700,18634,31389,-12755
42,86,4427,19600,16828,33334,-16506
43,84,4690,24450,18887,35089,-16202
44,81,4857,21600,19137,36984,-17847
45,88,5011,27350,23337,38584,-15247
46,88,5092,25550,24437,40089,-15652
47,80,5112,20650,24937,40686,-15749
48,80,5212,26500,29037,41084,-12047
49,85,5259,23150,29237,41739,-12502
50,90,5353,22050,29587,42389,-12802
51,90,5992,19800,31737,25478,6259
52,87,6053,21900,33287,26836,6451
53,86,6112,25000,34587,28436,6151
54,83,6202,24400,35490,30478,5012
55,80,6284,19750,34687,31178,3509
56,85,6286,21800,37183,32336,4847
57,88,6319,24650,37184,34178,3006
58,84,6355,24900,37283,36036,1247
59,85,6363,22250,36944,37736,-792
60,84,6496,21300,37387,38386,-999
61,81,6531,22050,40587,39428,1159
62,88,6573,22850,39737,40486,-749
63,85,6630,16400,40087,41528,-1441
64,88,6933,20600,27975,43128,-15153
65,89,6972,21550,28526,45136,-16610
66,83,7033,23050,29025,46378,-17353
67,86,7255,28600,29776,48536,-18760
68,82,7462,27050,31778,50036,-18258
69,88,7489,23750,32025,51828,-19803
70,82,7494,24800,32026,53428,-21402
71,82,7522,25250,32276,55078,-22802
72,88,7685,26000,36289,56878,-20589
73,88,7734,23300,36939,57378,-20439
74,83,7734,23950,35789,58428,-22639
75,83,7763,18550,36636,60036,-23400
76,81,7803,23400,37686,62328,-24642
77,80,7869,24250,38489,63828,-25339
78,81,7926,25650,38091,66028,-27937
79,82,7953,22550,38382,67078,-28696
80,89,8076,26050,39089,68128,-29039
81,85,8252,23150,39432,69728,-30296
82,89,8514,24250,40286,72378,-32092
83,82,8656,25250,40936,73928,-32992
84,85,8706,23150,41482,74686,-33204
85,80,8741,25600,39776,75736,-35960
86,83,8841,23500,40476,76836,-36360
87,88,8881,22850,41175,77336,-36161
88,80,9118,20200,41725,78528,-36803
89,84,9689,24450,42089,80528,-38439
90,82,9764,23000,42177,82086,-39909
91,82,9827,23450,42689,83186,-40497
92,82,9830,25250,42987,84678,-41691
93,83,9883,22150,43523,37838,5685
94,90,9974,25650,44220,39488,4732
95,89,9988,22000,44041,40724,3317
96,86,10151,26350,45227,42188,3039
97,88,10237,25100,45577,44324,1253
98,84,10280,22650,45870,45888,-18
99,86,10498,22300,46727,46888,-161
100,85,10544,23150,47173,48524,-1351
101,84,10795,25800,44036,51024,-6988
102,80,10933,24700,46137,53124,-6987
103,82,10946,21650,46636,54874,-8238
104,82,10951,23900,46941,56088,-9147
105,80,10991,21100,46441,56524,-10083
106,83,11260,20800,47941,57138,-9197
107,82,11323,22550,53891,58238,-4347
108,87,11350,22350,56041,59338,-3297
109,90,11358,26100,56423,61374,-4951
110,81,11430,22950,58091,61874,-3783
111,86,11501,24100,58023,63474,-5451
112,87,11586,25500,58641,64674,-6033
113,87,11872,20550,59438,66274,-6836
114,80,11916,26500,59285,67824,-8539
115,82,12146,23000,60136,69374,-9238
116,90,12227,26100,60235,71074,-10839
117,90,12355,25200,60686,72374,-11688
118,80,12413,22000,60785,73888,-13103
119,86,12439,23200,61238,74224,-12986
120,89,12831,23350,49385,76824,-27439
121,83,12923,18550,49131,78924,-29793
122,88,13166,21950,49686,78938,-29252
123,89,13345,26950,50286,79988,-29702
124,88,13348,25100,50895,81588,-30693
125,83,13712,20800,51986,82238,-30252
126,80,13747,20650,52031,83738,-31707
127,86,13941,23650,52685,84674,-31989
128,89,13963,24700,52531,85324,-32793
129,83,14083,22600,53936,86838,-32902
130,83,14111,24850,54086,87924,-33838
131,89,14142,25600,54281,89074,-34793
132,84,14280,23550,54545,90674,-36129
133,88,14379,26900,55331,91774,-36443
134,86,14613,23650,55936,93388,-37452
135,82,14753,21650,57238,95488,-38250
136,82,14851,20300,56981,96138,-39157
137,88,15385,24650,60433,97838,-37405
138,88,15476,26900,60388,99074,-38686
139,88,15512,24650,62083,100188,-38105
140,90,15525,24750,62688,102124,-39436
141,82,15557,23000,60395,103124,-42729
142,86,15841,22300,60786,104688,-43902
143,88,15900,24200,61181,106788,-45607
144,90,16002,23400,61445,107888,-46443
145,81,16032,25200,63186,108624,-45438
146,89,16033,26500,63686,110824,-47138
147,83,16109,17650,64736,112938,-48202
148,86,16194,25900,64885,114424,-49539
149,84,16439,22200,65631,115188,-49557
150,85,16562,25400,68036,117288,-49252
151,83,16578,22150,66745,118838,-52093
152,87,16635,25500,68635,120424,-51789
153,85,16649,23150,67985,121024,-53039
154,83,16710,23050,68295,57488,10807
155,80,16720,22900,68586,58486,10100
156,87,16854,28650,70795,59438,11357
157,82,16889,20750,71795,60136,11659
158,88,16898,24650,70686,60738,9948
159,87,16924,23700,71985,61185,10800
160,82,16985,24350,72281,61685,10596
161,87,17097,26850,73035,62336,10699
162,90,17219,25200,74036,62836,11200
163,88,17367,21050,74335,63538,10797
164,83,17592,23500,75086,64288,10798
165,83,17766,19900,75545,65285,10260
166,85,18144,24950,77186,65785,11401
167,85,18236,23150,77035,66636,10399
168,87,18294,23700,67184,66835,349
169,81,18543,22050,67783,67335,448
170,81,18628,22950,68940,67835,1105
171,82,18733,24800,69540,68936,604
172,87,18780,22350,69833,69438,395
173,87,18975,25500,70233,70085,148
174,84,19108,19500,70584,70838,-254
175,86,19287,21850,70896,71135,-239
176,81,19361,25650,71533,71635,-102
177,90,19464,25200,72940,72888,52
178,80,19474,24700,72440,73436,-996
179,84,19559,19950,73583,74186,-603
180,83,19601,24850,73546,74486,-940
181,82,19670,27500,74034,75386,-1352
182,83,19726,23950,76184,76035,149
183,85,19770,24950,75183,76535,-1352
184,81,19786,21150,76246,76886,-640
185,87,19949,23250,77333,77486,-153
186,90,19953,26100,77346,78486,-1140
187,84,20032,24000,77734,79086,-1352
188,90,20073,25650,77933,79788,-1855
189,87,20247,25950,78433,81138,-2705
190,84,20270,20850,80146,81788,-1642
191,81,20296,18900,79083,82388,-3305
192,85,20301,26300,80233,82886,-2653
193,82,20408,23000,83140,83436,-296
194,85,20454,24950,84140,84038,102
195,84,20463,25800,82383,85085,-2702
196,84,20496,23100,83784,85636,-1852
197,89,20509,26500,84283,86235,-1952
198,90,20701,20700,84934,86636,-1702
199,89,20726,28300,85683,86888,-1205
200,84,20799,23100,87233,87888,-655
201,84,20826,23550,87783,88435,-652
202,86,20904,26350,87846,88786,-940
203,85,21137,22250,88883,89088,-205
204,86,21144,24100,89383,89936,-553
205,86,21369,26800,90433,90088,345
206,87,21407,21900,90433,90686,-253
207,87,21760,27750,91046,91088,-42
208,90,21903,25200,91483,91338,145
209,80,21919,17500,91840,91986,-146
210,80,22132,19750,93783,92435,1348
211,84,22171,23100,92890,92838,52
212,87,22178,25950,93390,93438,-48
213,84,22210,21300,95184,94485,699
214,80,22289,22450,95233,95086,147
215,80,22293,23800,95046,95438,-392
216,80,22482,21550,95732,95786,-54
217,83,22487,22150,98834,96188,2646
218,90,22502,25200,98640,97088,1552
219,85,22516,25400,97296,97338,-42
220,83,22526,19900,99690,97836,1854
221,81,22585,21150,99246,98386,860
222,89,22623,23800,99234,98986,248
223,83,22802,19000,101690,99476,2214
224,86,22814,23650,101433,100338,1095
225,84,22864,24000,101883,101526,357
226,86,22964,20950,102496,102029,467
227,85,23360,24950,103190,101838,1352
228,89,23738,22900,100492,102285,-1793
229,88,23741,21050,100932,102885,-1953
230,82,23864,23900,101541,103385,-1844
231,82,23979,23000,102091,103486,-1395
232,80,24088,24250,103142,104238,-1096
233,82,24104,22550,103691,104985,-1294
234,81,24192,24300,104642,105438,-796
235,90,24265,27900,104682,105938,-1256
236,85,24532,23600,105191,106685,-1494
237,80,24542,22450,105242,107735,-2493
238,86,24741,20950,107342,107888,-546
239,86,24804,23200,107832,108438,-606
240,86,24834,24550,107491,109286,-1795
241,86,24851,23650,107991,110338,-2347
242,87,24914,23250,107892,110838,-2946
243,85,25023,24500,108490,111785,-3295
244,87,25055,18750,108592,112286,-3694
245,88,25203,23750,109292,112885,-3593
246,85,25214,24950,109691,113336,-3645
247,85,25453,19100,110041,113886,-3845
248,90,25469,22950,111790,114438,-2648
249,83,25542,23500,112892,115036,-2144
250,84,25551,20400,113041,115936,-2895
251,83,25561,21250,113541,116586,-3045
252,89,25630,24700,113732,117088,-3356
253,86,25645,22750,113741,117588,-3847
254,86,25969,22300,114332,113988,344
255,80,25973,21100,114741,114386,355
256,83,26079,20800,116040,114986,1054
257,83,26169,24400,115982,115486,496
258,81,26240,20700,116590,115783,807
259,85,26297,25850,117082,116188,894
260,80,26678,24250,118240,116883,1357
261,87,26819,22350,119342,117083,2259
262,85,26975,18200,119940,117386,2554
263,81,27189,22500,121141,117688,3453
264,80,27262,24250,121032,118083,2949
265,84,27305,23100,121641,118636,3005
266,89,27338,27850,121992,119382,2610
267,84,27401,23550,119228,119932,-704
268,82,27537,23900,120228,120736,-508
269,84,27741,23550,120578,120936,-358
270,83,27755,22600,115937,119741,-3804
271,80,27815,23350,116087,120687,-4600
272,83,27833,23050,116286,121737,-5451
273,90,28238,27900,118986,122487,-3501
274,89,28300,25150,119841,123387,-3546
275,81,28309,20250,119435,124037,-4602
276,84,28336,23550,119935,113028,6907
277,83,28388,22150,119787,115128,4659
278,90,28473,25650,120336,116689,3647
279,90,28773,25200,120439,118739,1700
280,88,28887,21500,121036,119789,1247
281,81,28944,23850,121685,121578,107
282,80,29421,18850,122235,122439,-204
283,80,29493,21550,122587,125039,-2452
284,85,29525,24950,123091,126228,-3137
285,88,29656,24650,124141,128839,-4698
286,80,29657,24250,124185,130339,-6154
287,88,29667,25100,124237,132439,-8202
288,87,29828,25050,124786,133939,-9153
289,80,30105,20650,126185,135328,-9143
290,83,30113,24850,126689,137739,-11050
291,87,30207,24150,128541,139889,-11348
292,81,30239,22050,127685,140778,-13093
293,84,30246,20400,128536,141328,-12792
294,90,30529,23400,129591,143389,-13798
295,86,30571,21850,129686,144278,-14592
296,88,30873,23750,130339,145839,-15500
297,82,30949,19400,131337,147628,-16291
298,81,30994,20250,131236,149178,-17942
299,82,31173,23000,131685,150178,-18493
300,84,31325,24900,132091,152778,-20687
301,86,31585,19600,133336,154278,-20942
302,80,31598,24250,133285,157778,-24493
303,84,31704,20400,133741,159278,-25537
304,86,31771,22300,134385,160839,-26454
305,80,32146,20200,134935,161839,-26904
306,83,32259,22600,135387,162939,-27552
307,89,32285,27850,136485,165539,-29054
308,90,32400,26550,137085,167039,-29954
309,80,32486,19300,131229,167978,-36749
310,83,32504,23950,130630,169639,-39009
311,90,32562,25650,131189,172028,-40839
312,87,32717,22800,132172,172639,-40467
313,87,32794,20550,131980,174339,-42359
314,80,32818,23350,132672,174927,-42255
315,89,32951,22450,133222,175427,-42205
316,83,32984,21700,135229,175775,-40546
317,86,33033,25000,134425,176427,-42002
318,88,33062,24650,135180,177475,-42295
319,83,33205,22600,135925,177886,-41961
320,86,33453,22300,136730,179077,-42347
321,83,33717,22150,137379,179734,-42355
322,86,33807,23650,138339,180234,-41895
323,85,33837,21800,138730,180836,-42106
324,82,34013,22550,139075,181577,-42502
325,84,34111,23550,139939,182284,-42345
326,87,34484,25500,140729,182886,-42157
327,83,34576,24400,141372,183436,-42064
328,83,35083,25300,141830,184227,-42397
329,83,35196,25300,143980,184827,-40847
330,82,35196,21200,144443,185427,-40984
331,88,35211,24650,144523,185984,-41461
332,85,35235,21800,144543,186786,-42243
333,89,35795,23800,147823,187525,-39702
334,88,35830,25100,147393,188036,-40643
335,87,36136,21000,148973,188586,-39613
336,87,36320,21000,149473,189286,-39813
337,80,36415,22900,150393,189636,-39243
338,87,36535,25500,151523,190177,-38654
339,83,36539,23950,153173,190386,-37213
340,84,36884,20400,154993,190986,-35993
341,81,37042,22950,161543,191986,-30443
342,83,37056,21700,162043,192536,-30493
343,82,37071,22550,162723,192734,-30011
344,87,37302,22350,165643,193236,-27593
345,85,37374,24500,165823,193884,-28061
346,82,37414,27500,168123,194627,-26504
347,86,37488,20500,168623,194934,-26311
348,80,37644,17950,170423,195236,-24813
349,81,37739,21600,170593,195536,-24943
350,87,37868,26400,171643,196336,-24693
351,85,37981,18650,174423,196484,-22061
352,87,38183,23700,176293,197086,-20793
353,81,38206,22950,180593,198086,-17493
354,90,38269,24300,183043,198386,-15343
355,84,38284,28500,183543,198577,-15034
356,90,38329,24750,183773,199336,-15563
357,81,38331,20700,183273,199575,-16302
358,88,38752,26900,186973,200386,-13413
359,90,38824,26100,190223,201034,-10811
360,86,38903,24100,190043,201477,-11434
361,86,39009,25000,193193,202184,-8991
362,87,39054,21450,193693,202586,-8893
363,89,39074,25600,194673,203186,-8513
364,87,39084,24150,195843,204027,-8184
365,83,39178,23950,161589,204884,-43295
366,83,39196,25300,162689,205425,-42736
367,90,39270,23850,162429,205727,-43298
368,80,39319,22450,163239,206575,-43336
369,87,39320,26400,163529,207075,-43546
370,84,39852,23100,164529,208134,-43605
371,85,39858,22250,165225,208577,-43352
372,80,40089,22900,165330,208825,-43495
373,89,40245,23350,165679,209284,-43605
374,86,40288,26350,166275,210025,-43750
375,87,40360,24150,166722,210236,-43514
376,89,40423,23800,167030,210736,-43706
377,83,40607,25300,168080,211777,-43697
378,90,40705,23400,168772,212325,-43553
379,82,40739,25700,169130,212934,-43804
380,90,40864,26550,170272,213825,-43553
381,86,40980,20950,170689,214377,-43688
382,81,41185,22950,171822,214884,-43062
383,90,41260,27450,172229,215384,-43155
384,82,41700,22550,174239,215736,-41497
385,89,41725,22000,174975,216336,-41361
386,87,41752,23250,175072,217086,-42014
387,82,41811,22100,174780,217927,-43147
388,90,41860,20250,176075,218477,-42402
389,83,41872,22150,175839,218775,-42936
390,86,42180,21850,176339,219325,-42986
391,85,42307,29000,176922,219834,-42912
392,84,42449,21750,178338,220384,-42046
393,81,43021,24750,179786,220677,-40891
394,81,43448,24300,181688,221475,-39787
395,87,43545,24600,182188,222227,-40039
396,86,43872,29050,183738,222634,-38896
397,82,43991,20300,185286,223136,-37850
398,82,44003,22550,185488,223684,-38196
399,84,44123,23550,187538,224436,-36898
400,87,44138,25950,189588,225577,-35989
401,90,44244,21150,190688,226425,-35737
402,83,44377,23050,192238,226786,-34548
403,82,44655,21200,193338,227286,-33948
404,90,44964,19350,194136,227484,-33348
405,87,45173,21450,194186,227775,-33589
406,81,45175,22050,195238,228536,-33298
407,85,45409,25850,196236,229086,-32850
408,87,45694,28200,198188,229775,-31587
409,88,45832,24650,199238,230236,-30998
410,90,45992,25200,202686,230677,-27991
411,80,46022,19300,203186,230925,-27739
412,86,46082,20050,202588,231277,-28689
413,86,46144,21400,207188,231686,-24498
414,81,46145,23400,205988,232436,-26448
415,80,46170,20650,207336,233136,-25800
416,89,46312,23800,210388,233586,-23198
417,84,46397,25350,210386,234086,-23700
418,86,46580,21400,212088,234586,-22498
419,84,46639,22200,215486,235534,-20048
420,83,46657,23050,215738,179734,36004
421,85,46681,24050,215238,180684,34554
422,88,46772,22400,217088,181175,35913
423,86,46990,20500,218136,181490,36646
424,89,47017,27850,219686,182334,37352
425,80,47085,24250,221888,183589,38299
426,82,47116,22550,222436,184978,37458
427,80,47557,21100,225336,186528,38808
428,90,47598,27000,225836,187728,38108
429,87,47698,24150,230536,189428,41108
430,81,47735,26100,230586,191978,38608
431,87,47791,25050,231588,192789,38799
432,81,47853,21600,235738,193889,41849
433,86,47911,25450,235786,194989,40797
434,80,47932,25150,236238,197639,38599
435,83,48165,24400,236336,199278,37058
436,82,48339,23000,238388,199889,38499
437,86,48501,24550,239736,200628,39108
438,84,48814,25350,241938,202039,39899
439,87,48866,20550,244436,203189,41247
440,86,48920,23200,243636,204839,38797
441,82,48940,21650,244388,206328,38060
442,80,49149,21550,246038,208328,37710
443,81,49299,23400,247738,209739,37999
444,87,49454,17400,250836,210278,40558
445,89,49467,24700,251288,211889,39399
446,85,49572,24950,252388,213378,39010
447,85,49959,20000,252536,214478,38058
448,80,50003,20650,187987,215628,-27641
449,85,50038,20900,188845,216728,-27883
450,84,50405,22200,189345,217539,-28194
451,89,50744,21550,189938,219128,-29190
452,90,50828,26100,190386,219839,-29453
453,82,50989,23450,190188,220778,-30590
454,87,51083,19650,191283,223189,-31906
455,86,51349,22300,192188,224839,-32651
456,81,51397,21600,192386,225689,-33303
457,88,51736,21950,193188,226789,-33601
458,88,51746,26450,193688,228428,-34740
459,85,51803,22250,195186,229078,-33892
460,87,51845,25950,195686,232089,-36403
461,85,51935,22700,195583,232828,-37245
462,88,52026,26450,197386,236489,-39103
463,83,52080,21250,197288,237628,-40340
464,83,52185,26200,198595,239689,-41094
465,84,52253,25350,199133,241239,-42106
466,80,52319,20650,199038,242078,-43040
467,85,52368,23600,199536,243439,-43903
468,83,52403,21700,200045,244989,-44944
469,84,52510,21300,200545,246078,-45533
470,80,52669,21550,201337,247239,-45902
471,84,52872,20850,201083,247828,-46745
472,80,52896,23350,201688,249878,-48190
473,81,53109,19800,202236,250039,-47803
474,90,53248,23850,203037,251639,-48602
475,84,53256,25800,203537,253278,-49741
476,81,53650,19800,203738,254139,-50401
477,87,53809,24600,205788,256428,-50640
478,86,53843,21850,205595,257078,-51483
479,82,53861,21650,206083,257728,-51645
480,89,53968,24250,206788,259828,-53040
481,87,54212,25050,207936,261539,-53603
482,82,54256,22550,207787,263139,-55352
483,84,54272,25350,208883,264989,-56106
484,84,54328,24900,208787,265728,-56941
485,88,54386,26450,209536,267139,-57603
486,84,54599,23100,209888,268189,-58301
487,83,54669,22600,211695,268678,-56983
488,88,54675,22850,211588,270339,-58751
489,87,54684,29100,212245,271389,-59144
490,83,54782,24400,214095,271939,-57844
491,84,54790,21750,212983,274528,-61545
492,90,54817,27000,214137,277289,-63152
493,84,54880,22650,213983,278928,-64945
494,89,54952,22000,214637,279989,-65352
495,82,55060,20750,215133,281378,-66245
496,84,55126,22200,215795,283528,-67733
497,81,55366,19800,216333,284078,-67745
498,86,55609,21850,217683,285178,-67495
499,84,55695,20400,218095,285678,-67583
500,85,55802,23600,218538,287278,-68740
501,87,55975,25050,219245,288578,-69333
502,81,56339,20250,219945,290278,-70333
503,85,56485,24500,220436,292489,-72053
504,87,56531,22800,222488,294639,-72151
505,86,56594,24550,223083,295739,-72656
506,90,56598,23850,223086,297328,-74242
507,87,56630,22800,223437,297978,-74541
508,80,56675,20200,223686,298889,-75203
509,87,56760,26400,224088,301628,-77540
510,90,56881,27900,224688,303128,-78440
511,87,56934,24150,225533,304139,-78606
512,89,56972,23350,226137,305739,-79602
513,89,57059,26500,226187,308178,-81991
514,87,57109,21000,226533,309989,-83456
515,81,57316,19800,227538,310039,-82501
516,85,57384,18650,227437,311628,-84191
517,83,57511,23500,228537,313128,-84591
518,85,57553,24950,229095,315378,-86283
519,82,57626,22550,229695,317789,-88094
520,83,57675,20350,229737,317778,-88041
521,85,57821,25850,230733,318928,-88195
522,90,57867,27450,232986,321028,-88042
523,81,57934,23400,232987,323078,-90091
524,87,57937,24600,233483,324278,-90795
525,81,57953,19800,233395,324878,-91483
526,81,58150,17550,233587,205588,27999
527,86,58311,22750,234945,205836,29109
528,85,58325,22250,234486,206288,28198
529,82,58340,19850,234938,206485,28453
530,87,58607,24600,236736,206986,29750
531,89,58608,24700,236883,207838,29045
532,89,58635,24250,236645,208490,28155
533,85,58768,20000,237433,208990,28443
534,87,58948,25950,238038,209436,28602
535,89,58971,25150,238445,210040,28405
536,80,59084,20650,238786,210538,28248
537,88,59089,25100,239283,211535,27748
538,87,59288,25500,239833,211686,28147
539,86,59309,25450,240145,213085,27060
540,81,59419,22050,240687,213936,26751
541,82,59450,25250,229181,214836,14345
542,90,59516,23400,230381,215486,14895
543,81,59544,21150,230322,215735,14587
544,88,59928,25100,231726,216536,15190
545,86,59992,26350,232381,217186,15195
546,80,60045,23800,232681,217835,14846
547,89,60201,26500,234047,218385,15662
548,83,60261,22150,234181,219036,15145
549,82,60345,24800,235147,219740,15407
550,80,60368,20650,235031,220086,14945
551,82,60576,24350,236197,221036,15161
552,82,60606,23900,236031,221636,14395
553,87,60761,23250,236826,222286,14540
554,87,61100,26850,237781,222636,15145
555,89,61332,25150,237897,223340,14557
556,85,61449,22700,238331,224186,14145
557,85,61489,24500,238997,224940,14057
558,83,61536,22600,239497,225736,13761
559,82,61604,26600,240231,226388,13843
560,86,61650,23650,240526,227436,13090
561,83,61819,19450,241076,227986,13090
562,83,61827,24850,242226,228488,13738
563,88,61916,21950,242981,228736,14245
564,90,61931,22500,242726,229235,13491
565,87,62108,26400,244597,230086,14511
566,90,62144,25200,244376,230836,13540
567,85,62453,24500,246147,231036,15111
568,89,62539,26500,246722,231590,15132
569,80,62609,18850,246481,232386,14095
570,87,62610,24600,247422,232786,14636
571,89,62673,23350,247922,233088,14834
572,84,63051,27600,248422,233336,15086
573,85,63247,22700,248897,234188,14709
574,84,63365,28500,249431,234436,14995
575,83,63446,26200,250476,235285,15191
576,88,63522,23750,251676,235986,15690
577,83,63522,21250,251272,236486,14786
578,88,63616,25550,251647,236786,14861
579,82,63622,22100,252947,237724,15223
580,81,63712,21600,254326,238883,15443
581,82,63810,23000,255047,241474,13573
582,80,63813,23800,255022,243624,11398
583,90,63929,22500,256597,246033,10564
584,86,63944,28600,256626,247274,9352
585,89,64087,22450,256631,248474,8157
586,85,64170,24950,257822,249674,8148
587,87,64240,21900,257976,251733,6243
588,88,64336,25550,259331,252924,6407
589,85,64365,24050,260226,254474,5752
590,81,64403,23400,259681,256183,3498
591,89,64447,21550,260072,258383,1689
592,85,64766,23600,260826,259533,1293
593,81,64979,23400,261326,260674,652
594,82,65074,21650,261781,261633,148
595,83,65204,20350,262631,262683,-52
596,82,65244,23000,263526,264283,-757
597,80,65327,25600,264722,265933,-1211
598,85,65419,26300,264631,267983,-3352
599,81,65582,25650,265831,270133,-4302
600,81,65612,23850,265697,272133,-6436
601,82,65664,22100,265822,272824,-7002
602,82,65840,25700,266331,273833,-7502
603,83,65985,21250,267176,275474,-8298
604,90,66014,25200,267676,276283,-8607
605,82,66132,25700,268381,276833,-8452
606,86,66350,25000,269326,278333,-9007
607,81,66428,20250,271031,279474,-8443
608,82,66452,23000,271122,280083,-8961
609,88,66504,25550,270397,282583,-12186
610,81,66505,22950,271381,283733,-12352
611,90,66568,28350,271722,285433,-13711
612,87,66621,25050,272031,286583,-14552
613,90,66671,26100,272726,288074,-15348
614,86,66699,26350,273647,289174,-15527
615,80,66789,17950,273481,290083,-16602
616,84,66857,23100,274381,291583,-17202
617,87,66932,21450,274131,292774,-18643
618,81,67015,26550,276222,295233,-19011
619,82,67030,24350,275497,297424,-21927
620,81,67069,22950,276381,299124,-22743
621,80,67242,22000,277597,300133,-22536
622,89,67242,21550,277526,301774,-24248
623,88,67666,23300,278647,303324,-24677
624,85,67803,25400,279431,305374,-25943
625,86,67944,24550,279831,306933,-27102
626,88,68114,24650,280797,309174,-28377
627,81,68481,22950,281226,310474,-29248
628,81,68558,22050,282822,311333,-28511
629,86,68562,24100,282831,313033,-30202
630,81,68576,19800,283331,313633,-30302
631,80,68659,21100,282926,314824,-31898
632,83,68874,23050,283922,316474,-32552
633,87,68966,25500,284331,317524,-33193
634,87,69072,24150,285026,286824,-1798
635,89,69229,26050,286026,289841,-3815
636,89,69234,27850,286031,290891,-4860
637,82,69367,22100,287547,292424,-4877
638,89,69426,26950,288672,294574,-5902
639,85,69441,24050,287281,296224,-8943
640,88,69489,25550,289597,297341,-7744
641,88,69502,22850,289681,298941,-9260
642,88,69547,26450,290822,300441,-9619
643,83,69612,21250,291422,302424,-11002
644,85,69640,22250,290697,305091,-14394
645,85,69671,20900,291526,306174,-14648
646,83,69802,22150,291797,307774,-15977
647,87,69832,26400,292526,308641,-16115
648,81,70107,18450,292847,310341,-17494
649,89,70156,29200,293681,311941,-18260
650,86,70175,23200,293997,313041,-19044
651,83,70299,25300,295372,315041,-19669
652,80,70348,22000,295797,317191,-21394
653,84,70383,19500,296397,319074,-22677
654,84,70405,22650,297576,319124,-21548
655,81,70466,22500,297781,320591,-22810
656,88,70503,21500,298781,321674,-22893
657,87,70592,26850,298881,323324,-24443
658,86,70964,24550,299726,324974,-25248
659,89,71028,25150,300331,326541,-26210
660,87,71046,23700,300997,328224,-27227
661,81,71255,22050,301572,329641,-28069
662,86,71342,25450,302276,332841,-30565
663,82,71614,17600,303381,333391,-30010
664,88,71623,27800,303872,334941,-31069
665,83,71627,20800,303426,336641,-33215
666,86,71702,25900,303597,338074,-34477
667,84,71734,21300,305247,339441,-34194
668,80,71751,23800,304647,341641,-36994
669,87,71790,21900,305847,343741,-37894
670,88,71869,23750,305631,344874,-39243
671,86,71935,25000,306726,346941,-40215
672,82,72060,23000,307281,347774,-40493
673,89,72281,25600,309576,349541,-39965
674,90,72308,22500,309626,350624,-40998
675,81,72323,22050,309031,353491,-44460
676,90,72342,24300,310347,354491,-44144
677,83,72366,23500,310822,355974,-45152
678,84,72425,22200,310626,357041,-46415
679,84,72518,21300,311081,357691,-46610
680,82,72564,22100,306191,359574,-53383
681,87,72633,20550,306486,361224,-54738
682,87,72765,23700,308391,362791,-54400
683,89,72766,25150,308396,364524,-56128
684,88,72810,21050,308341,366124,-57783
685,80,72921,21100,310390,368274,-57884
686,89,72943,22450,310591,370541,-59950
687,85,72957,24500,310286,371974,-61688
688,81,73002,25650,310246,373191,-62945
689,81,73127,21150,310896,374224,-63328
690,87,73170,23700,311996,375324,-63328
691,80,73213,22900,312990,376091,-63101
692,89,73215,24250,313486,377124,-63638
693,80,73290,22450,314036,377891,-63855
694,90,73352,26100,314141,378824,-64683
695,81,73846,21150,314736,380024,-65288
696,90,73885,23850,315640,381091,-65451
697,90,73886,22950,316946,382341,-65395
698,86,73892,21850,317041,384274,-67233
699,81,74026,23400,318041,385874,-67833
700,88,74074,25550,318096,387424,-69328
701,80,74142,24700,318290,388574,-70284
702,83,74334,22600,319340,389491,-70151
703,85,74392,22700,319291,391691,-72400
704,87,74654,24150,319941,392774,-72833
705,88,74657,28250,320391,394591,-74200
706,90,74762,22950,320941,395774,-74833
707,87,75018,21000,321091,396791,-75700
708,89,75145,18850,322641,397941,-75300
709,87,75159,23700,322286,399474,-77188
710,88,75221,26000,323941,401191,-77250
711,85,75296,23600,324446,402691,-78245
712,86,75303,25900,323896,403924,-80028
713,86,75372,22750,324890,404874,-79984
714,80,75584,26050,326046,406524,-80478
715,89,75595,26050,326440,409074,-82634
716,85,75694,20900,327091,410641,-83550
717,85,75713,26300,327536,412141,-84605
718,82,75895,23000,328641,413424,-84783
719,85,75898,19100,328536,414491,-85955
720,87,76132,26850,331336,417291,-85955
721,86,76138,20950,330890,419441,-88551
722,88,76151,23300,330891,420674,-89783
723,85,76220,20900,331091,422591,-91500
724,89,76385,20200,331646,423741,-92095
725,80,76461,20200,332241,424824,-92583
726,83,76521,22600,333541,425441,-91900
727,82,76566,19400,334236,427591,-93355
728,86,76615,22750,334246,428274,-94028
729,87,76638,23250,334591,429824,-95233
730,88,77161,24650,335246,431591,-96345
731,83,77395,23050,335341,432524,-97183
732,83,77412,23500,335746,433574,-97828
733,82,77515,25700,337441,435174,-97733
734,85,77558,20900,337641,436824,-99183
735,89,77704,26050,338241,438424,-100183
736,80,77818,22000,339341,439491,-100150
737,84,77887,22200,339186,441074,-101888
738,83,78040,23050,339736,442391,-102655
739,89,78043,21550,340091,443491,-103400
740,88,78267,21950,340336,444574,-104238
741,89,78296,28300,341336,446341,-105005
742,83,78463,26200,343390,447224,-103834
743,90,78483,27450,343841,448324,-104483
744,81,78488,22050,343290,448891,-105601
745,82,78491,20300,343646,450574,-106928
746,82,78611,18950,344841,452041,-107200
747,89,78687,24250,344696,455041,-110345
748,82,78752,21650,345846,456091,-110245
749,90,78794,28350,346690,457974,-111284
750,85,78913,24950,346841,460024,-113183
751,81,79271,19800,347240,460724,-113484
752,86,79750,25450,348291,462441,-114150
753,84,79808,22650,350341,463074,-112733
754,82,79856,22550,350136,464624,-114488
755,81,79892,24750,350140,465624,-115484
756,86,79898,29500,350096,467674,-117578
757,83,80100,23500,351140,468891,-117751
758,84,80103,25350,352041,471374,-119333
759,83,80191,26650,352436,472591,-120155
760,90,80393,26550,354291,474124,-119833
761,85,80402,20900,353746,475774,-122028
762,81,80450,24300,354536,477774,-123238
763,80,81094,23800,354991,479324,-124333
764,86,81260,23200,356886,482024,-125138
765,83,81281,23050,356891,484024,-127133
766,85,81358,21350,356746,485541,-128795
767,89,81437,26050,357246,486541,-129295
768,85,81552,24500,357886,487624,-129738
769,85,81575,23150,358191,488891,-130700
770,82,81774,20750,343330,491424,-148094
771,83,81817,21700,343778,492741,-148963
772,85,81870,22250,344178,493341,-149163
773,90,82023,24750,345428,494041,-148613
774,80,82103,25600,345528,497091,-151563
775,81,82150,18900,345828,498741,-152913
776,81,82227,24750,346828,500791,-153963
777,87,82329,24150,347830,503341,-155511
778,84,82486,24900,347878,505541,-157663
779,81,82768,19800,305685,507974,-202289
780,85,82808,25400,306136,509474,-203338
781,81,82896,22500,306339,511074,-204735
782,89,82925,23350,306836,512441,-205605
783,85,83108,22250,307539,513924,-206385
784,81,83207,19350,308039,515241,-207202
785,87,83285,26400,308585,516991,-208406
786,81,83351,20250,308539,517591,-209052
787,84,83450,24000,309391,519024,-209633
788,85,83565,21350,309739,521091,-211352
789,80,83568,22000,310889,522441,-211552
790,82,83584,23000,311486,523041,-211555
791,87,83658,24150,311285,524641,-213356
792,86,83694,26350,313841,526074,-212233
793,87,83758,23700,313885,526241,-212356
794,87,83785,25950,314186,527291,-213105
795,86,83785,24100,314239,528524,-214285
796,85,83785,19550,314339,530291,-215952
797,90,83900,22050,315236,532391,-217155
798,85,83902,23600,315441,533674,-218233
799,81,84064,22500,315941,535191,-219250
800,81,84225,18450,316689,536074,-219385
801,81,84297,16200,317189,536841,-219652
802,89,84403,25150,318085,538391,-220306
803,82,84403,26150,317741,540274,-222533
804,87,84631,23250,319291,541424,-222133
805,87,84683,23250,319289,542074,-222785
806,85,84932,24050,319839,543341,-223502
807,84,85088,23550,320285,543824,-223539
808,89,85259,23800,320889,545824,-224935
809,87,85377,22800,321991,547924,-225933
810,85,85427,22250,322689,547891,-225202
811,86,85510,28150,322939,549024,-226085
812,86,85616,25450,323235,550541,-227306
813,84,85632,24000,324039,553224,-229185
814,89,85657,25150,324439,556574,-232135
815,83,85888,21700,324991,557724,-232733
816,89,86163,26500,325491,559774,-234283
817,82,86294,19400,325885,560524,-234639
818,80,86563,19300,327136,560141,-233005
819,90,86617,27000,327485,368585,-41100
820,87,86788,23700,328186,369783,-41597
821,87,86874,22800,328989,370185,-41196
822,88,87019,22400,329639,362284,-32645
823,84,87131,21300,330689,362489,-31800
824,88,87188,28250,331139,363543,-32404
825,82,87291,30200,332189,364589,-32400
826,80,87325,22000,332189,365135,-32946
827,88,87478,22850,332791,365434,-32643
828,86,87585,21850,333385,365843,-32458
829,82,87827,23900,334385,366484,-32099
830,81,87844,25650,334689,366984,-32295
831,90,88404,25200,335185,367939,-32754
832,85,88805,25400,335939,368643,-32704
833,84,88850,20400,338891,369435,-30544
834,89,88861,26950,337039,370139,-33100
835,85,88886,24500,337285,370689,-33404
836,89,88905,22900,339939,371487,-31548
837,84,88933,22200,340041,372184,-32143
838,85,88953,24050,339385,372587,-33202
839,82,88953,25700,340539,373087,-32548
840,87,88961,21000,340541,374193,-33652
841,84,89243,23100,341286,374384,-33098
842,85,89300,26300,341641,375384,-33743
843,89,89381,24700,342685,375789,-33104
844,83,89465,23950,343589,376487,-32898
845,81,89582,22500,344086,377134,-33048
846,89,89670,30100,345341,377939,-32598
847,87,89760,24600,345935,378439,-32504
848,80,89764,25150,345139,378693,-33554
849,84,89778,24450,346435,379635,-33200
850,82,89845,22100,347341,380185,-32844
851,88,89904,26000,347985,380589,-32604
852,85,89970,27200,347989,381139,-33150
853,80,90206,22000,350089,381487,-31398
854,81,90266,22500,350739,381884,-31145
855,89,90279,26500,350086,382637,-32551
856,90,90356,26100,350835,383989,-33154
857,80,90628,20650,351239,384385,-33146
858,89,90954,22900,353736,384784,-31048
859,85,90990,24500,353291,385435,-32144
860,85,90995,21800,353135,386035,-32900
861,87,91021,24600,354889,386593,-31704
862,81,91103,25650,354936,387093,-32157
863,80,91108,22900,354989,387585,-32596
864,83,91272,26200,355685,388193,-32508
865,80,91732,24250,356941,389039,-32098
866,83,91823,20350,356685,389735,-33050
867,86,91980,23200,357441,311090,46351
868,85,92043,23600,358041,311439,46602
869,89,92160,25600,359389,313089,46300
870,88,92197,23750,359686,314990,44696
871,80,92277,24700,359889,316590,43299
872,84,92327,20400,360389,317090,43299
873,88,92561,23750,361391,318639,42752
874,86,92573,23650,361389,319390,41999
875,86,92690,23650,361885,321540,40345
876,90,92733,23400,351989,323689,28300
877,89,93336,25150,353277,324740,28537
878,85,93351,21800,352679,325340,27339
879,81,93399,25200,353180,327940,25240
880,86,93607,23200,354230,328989,25241
881,90,93655,31500,354974,330589,24385
882,89,94091,26500,355430,333840,21590
883,85,94131,24500,357077,334940,22137
884,83,94144,19000,356780,334990,21790
885,80,94222,22000,357129,336040,21089
886,86,94302,22300,358089,337140,20949
887,81,94370,23400,357679,337439,20240
888,89,94436,22450,359679,338589,21090
889,80,94454,22000,359727,339290,20437
890,82,94507,23450,360024,340839,19185
891,82,94612,24800,360739,342939,17800
892,84,94850,21300,361229,344140,17089
893,83,94885,22600,362977,345690,17287
894,84,94896,22650,362530,346939,15591
895,84,94906,22200,362829,348439,14390
896,85,95066,22700,363329,350140,13189
897,88,95328,28700,364324,352139,12185
898,86,95396,27700,365279,353890,11389
899,89,95426,25150,364989,356289,8700
900,88,95437,20150,365077,357890,7187
901,89,95699,24700,365929,359040,6889
902,83,95702,24400,366479,360689,5790
903,81,95816,19350,367839,361839,6000
904,81,95827,25200,367124,363140,3984
905,83,95866,23950,367624,364839,2785
906,82,95940,20750,369624,366440,3184
907,90,95990,25200,368539,368040,499
908,86,95992,25450,369627,370190,-563
909,82,96015,23450,369930,372490,-2560
910,89,96095,22450,370089,373539,-3450
911,82,96167,23450,371030,376140,-5110
912,85,96179,20900,371177,377589,-6412
913,80,96315,22450,371927,380040,-8113
914,87,96378,23250,372030,381090,-9060
915,87,96591,20100,372525,381439,-8914
916,81,96712,22950,375975,382489,-6514
917,82,96749,20750,376475,384540,-8065
918,89,96807,24700,376343,385839,-9496
919,88,97008,21050,379775,387240,-7465
920,80,97022,21100,379793,388739,-8946
921,84,97196,22200,385275,389839,-4564
922,90,97227,24750,382843,392589,-9746
923,80,97247,24700,384943,393639,-8696
924,85,97452,27200,386993,395189,-8196
925,89,97548,27400,392943,396740,-3797
926,80,97568,22000,393043,398340,-5297
927,87,97595,25500,395143,399840,-4697
928,86,97607,23650,395475,401339,-5864
929,83,97643,23050,393325,402540,-9215
930,84,97691,25350,394643,405989,-11346
931,88,97989,24200,396525,406989,-10464
932,88,98240,23750,398725,409089,-10364
933,90,98681,25650,400193,411540,-11347
934,80,98831,21550,401743,412739,-10996
935,88,98875,26000,404943,414340,-9397
936,83,98914,19900,404775,415889,-11114
937,81,98985,24750,407625,417740,-10115
938,85,99000,21350,408043,419240,-11197
939,90,99143,24750,408743,420089,-11346
940,90,99247,24750,409793,421590,-11797
941,87,99885,22800,413525,422839,-9314
942,80,99918,19750,415493,423590,-8097
943,84,100004,24450,414525,425090,-10565
944,83,100016,24850,420325,427090,-6765
945,85,100048,23600,420093,429140,-9047
946,89,100060,25150,420143,429690,-9547
947,89,100078,22900,420793,432290,-11497
948,87,100408,26400,421925,433989,-12064
949,90,100421,22050,424525,436190,-11665
950,89,100524,22000,425625,437190,-11565
951,80,100525,24250,427093,439689,-12596
952,87,100547,25050,428743,441340,-12597
953,85,100887,20900,430893,442490,-11597
954,88,101016,26000,434425,446089,-11664
955,85,101078,24950,434925,446739,-11814
956,84,101197,23100,436743,448889,-12146
957,87,101318,22800,439225,450490,-11265
958,89,101365,25600,439343,451939,-12596
959,81,101614,22950,442593,453039,-10446
960,80,101623,22450,441525,454189,-12664
961,81,101640,20700,443125,455339,-12214
962,89,101886,26950,445193,457940,-12747
963,85,102020,23600,448025,459039,-11014
964,88,102022,21500,448525,460189,-11664
965,81,102048,20700,448293,461790,-13497
966,85,102159,22250,449893,463789,-13896
967,81,102335,22500,453175,464389,-11214
968,88,102402,25100,451643,466539,-14896
969,89,102428,24250,452675,468589,-15914
970,82,102460,23450,456893,470139,-13246
971,86,102480,22750,455193,471390,-16197
972,80,102531,21550,457125,472940,-15815
973,85,102693,24050,459375,475040,-15665
974,82,103392,21200,460625,477689,-17064
975,86,103518,23650,461143,479290,-18147
976,89,103787,24700,466975,481290,-14315
977,89,103802,26950,465375,482890,-17515
978,87,103841,27750,469043,484490,-15447
979,80,103935,22450,469693,485539,-15846
980,82,104010,23900,469725,486689,-16964
981,85,104051,19100,471325,487189,-15864
982,82,104184,20750,472475,488889,-16414
983,83,104460,25300,474475,490139,-15664
984,88,104779,23750,476625,492189,-15564
985,82,104809,20750,477175,492839,-15664
986,85,104909,21800,479293,494290,-14997
987,87,105140,24150,480793,495340,-14547
988,81,105174,24750,482143,496390,-14247
989,87,105207,24150,481825,496940,-15115
990,82,105369,22550,483025,497940,-14915
991,84,105650,18600,482893,498490,-15597
992,90,105793,27000,484893,499990,-15097
993,80,105886,24250,486225,501089,-14864
994,90,105903,26100,487825,502189,-14364
995,90,106435,24750,488643,503290,-14647
996,90,106537,26550,491125,505340,-14215
997,85,106549,24500,492125,507990,-15865
998,87,106559,22800,494743,508689,-13946
999,90,106620,22950,497443,509889,-12446
1000,81,106686,21150,500525,510440,-9915
1001,80,106693,22450,496975,512489,-15514
1002,87,106748,23700,501025,514039,-13014
1003,89,106755,23800,501525,515940,-14415
1004,86,106940,25000,503175,517389,-14214
1005,82,107061,21200,505425,518140,-12715
1006,90,107073,25200,505643,519289,-13646
1007,82,107356,22100,511525,520439,-8914
1008,80,107381,22000,511093,521790,-10697
1009,85,107412,24050,508975,522340,-13365
1010,85,107441,22700,512093,491181,20912
1011,89,107630,26050,516643,492979,23664
1012,81,107678,24750,516275,494629,21646
1013,86,108010,26800,518193,495279,22914
1014,83,108163,26200,524143,496879,27264
1015,86,108196,24100,524725,498081,26644
1016,87,108220,25950,526093,500181,25912
1017,85,108250,24950,523725,501629,22096
1018,80,108290,20200,527775,503179,24596
1019,81,108318,22950,527793,503931,23862
1020,90,108346,25650,528275,505429,22846
1021,84,108451,21750,529393,505979,23414
1022,87,108467,23250,531075,507579,23496
1023,83,108617,23500,532043,509629,22414
1024,84,108732,25350,533525,511631,21894
1025,90,108912,23850,534625,512681,21944
1026,84,109074,19500,536425,513779,22646
1027,86,109346,25000,538575,514829,23746
1028,84,109387,16800,539093,515379,23714
1029,86,109668,19150,540275,516181,24094
1030,83,109840,23500,542475,517729,24746
1031,88,109936,26450,545025,519381,25644
1032,85,110066,19100,545493,520929,24564
1033,83,110359,23050,548593,522531,26062
1034,80,110433,22450,550943,524029,26914
1035,82,110503,25250,550975,526529,24446
1036,85,110524,21800,551475,528029,23446
1037,80,110632,22900,552125,530179,21946
1038,81,110770,19800,552793,531681,21112
1039,90,110929,22950,558075,532181,25894
1040,90,110989,25200,559675,534179,25496
1041,82,110994,21650,559943,535281,24662
1042,81,111030,23850,559725,537331,22394
1043,89,111232,23800,561375,539531,21844
1044,89,111365,23800,563075,540829,22246
1045,85,111511,20900,565693,542829,22864
1046,84,111670,23100,567975,543531,24444
1047,81,111761,22500,568475,544979,23496
1048,86,111916,23650,571193,545079,26114
1049,89,111968,23350,570775,546181,24594
1050,80,112324,22450,572425,547881,24544
1051,86,112465,20500,573975,549031,24944
1052,89,112596,23350,577643,551231,26412
1053,84,112680,26700,578143,553381,24762
1054,85,112690,22700,577625,554381,23244
1055,88,113052,24200,580925,555531,25394
1056,89,113126,26050,580443,557631,22812
1057,82,113181,18950,581475,558779,22696
1058,81,113486,25650,584025,560431,23594
1059,82,113594,24350,584525,562129,22396
1060,90,113632,23850,587493,564629,22864
1061,87,113740,25050,589225,566181,23044
1062,88,113927,19250,592043,567831,24212
1063,87,113964,19200,591975,568879,23096
1064,88,114158,18800,594125,569881,24244
1065,85,114330,24050,594725,571079,23646
1066,89,114498,25150,597543,572181,25362
1067,85,114503,24950,596775,573879,22896
1068,85,114563,24500,597593,575929,21664
1069,86,114966,23200,601843,577381,24462
1070,86,115015,26800,602225,579581,22644
1071,84,115170,20850,603825,581181,22644
1072,90,115364,26550,605593,582231,23362
1073,87,115398,26850,606725,583579,23146
1074,87,115486,22350,608593,585531,23062
1075,80,115573,22900,610293,587131,23162
1076,83,115573,23950,613743,589181,24562
1077,81,115659,22500,615343,591229,24114
1078,80,115674,23350,615393,593331,22062
1079,90,115861,22500,617125,593431,23694
1080,83,116009,20350,619293,593979,25314
1081,82,116259,21200,620993,594679,26314
1082,84,116402,24450,624293,596331,27962
1083,89,116432,23800,624475,598529,25946
1084,88,116520,26900,626443,600029,26414
1085,89,116592,22450,626425,602631,23794
1086,90,116939,25650,630175,604181,25994
1087,85,116998,27200,631725,605879,25846
1088,88,117062,25100,631343,608079,23264
1089,80,117234,22000,632325,609229,23096
1090,87,117317,21000,634525,611031,23494
1091,90,117318,25650,638793,612081,26712
1092,87,117328,28200,637743,613581,24162
1093,84,117348,21300,639293,614779,24514
1094,84,117543,24450,640943,615731,25212
1095,86,117597,22750,642193,616879,25314
1096,90,117619,25650,642325,618579,23746
1097,90,117753,24750,643793,620129,23664
1098,86,117842,22750,645025,621531,23494
1099,89,117964,25600,646625,623231,23394
1100,89,118053,23800,648143,624931,23212
1101,82,118193,23900,650193,625929,24264
1102,80,118323,22000,652375,626929,25446
1103,81,118327,25650,652743,628529,24214
1104,80,118490,19750,653993,629381,24612
1105,87,118659,23700,655543,631481,24062
1106,85,118717,19100,657525,632581,24944
1107,82,118736,22550,657593,634131,23462
1108,82,118877,21200,659143,634631,24512
1109,80,119266,20200,660143,635229,24914
1110,90,120068,27450,660775,636429,24346
1111,89,120183,24250,663293,636781,26512
1112,85,120274,24050,665025,637881,27144
1113,82,120444,26150,667025,640129,26896
1114,90,120552,22500,669825,642229,27596
1115,87,120604,21900,669793,643881,25912
1116,90,120820,22050,672425,645481,26944
1117,85,121119,26300,676443,647581,28862
1118,90,121125,28800,676825,649079,27746
1119,86,121239,22300,677593,650729,26864
1120,90,121448,28350,683825,652881,30944
1121,86,121479,25450,684875,653431,31444
1122,83,121485,24400,683325,654979,28346
1123,88,121560,23300,686325,657179,29146
1124,81,121613,23850,687993,658879,29114
1125,90,121674,22950,688043,660281,27762
1126,82,121699,20750,688575,661931,26644
1127,84,121897,19050,689575,662929,26646
1128,88,122060,21050,693293,664681,28612
1129,89,122078,22900,693793,666779,27014
1130,86,122314,23650,695025,669031,25994
1131,82,122450,21650,696675,670579,26096
1132,80,122454,22450,698393,672229,26164
1133,83,122492,17650,699675,672729,26946
1134,90,122495,23400,699643,673781,25862
1135,87,122706,25950,700825,676479,24346
1136,80,122817,24250,701743,676931,24812
1137,87,123008,24600,704125,453575,250550
1138,85,123156,23600,705925,454586,251339
1139,83,123159,23500,706693,455086,251607
1140,81,123261,23400,708725,455675,253050
1141,89,123415,24700,715425,456675,258750
1142,87,123461,23700,715893,457125,258768
1143,86,123503,26350,718175,458040,260135
1144,88,123507,21500,718675,458536,260139
1145,85,123593,21800,721975,459184,262791
1146,87,123617,24150,721593,460475,261118
1147,80,123658,21550,721543,460884,260659
1148,89,123731,26050,724243,461386,262857
1149,85,123822,20000,726125,461525,264600
1150,86,123825,19150,726075,461725,264350
1151,82,124177,23450,728793,462436,266357
1152,86,124196,23650,729293,463275,266018
1153,80,124213,25600,729375,463825,265550
1154,82,124335,19400,731075,464090,266985
1155,80,124492,21100,732093,464536,267557
1156,81,124851,22050,734325,464740,269585
1157,80,124928,21550,734693,465625,269068
1158,88,125007,28250,736825,466240,270585
1159,85,125243,24500,737975,466740,271235
1160,87,125389,25500,741225,467675,273550
1161,85,125439,21800,743075,468525,274550
1162,90,125503,26100,742643,469075,273568
1163,82,125591,19850,743643,469386,274257
1164,83,125613,19000,745043,469740,275303
1165,90,125632,24750,745325,469986,275339
1166,80,125847,23350,749693,470536,279157
1167,85,125915,20900,749525,470925,278600
1168,90,125953,25200,751343,471525,279818
1169,88,126068,25550,752893,471934,280959
1170,81,126174,19350,754093,472675,281418
1171,83,126366,21700,755275,473084,282191
1172,90,126749,26100,758375,473686,284689
1173,89,126760,25600,756293,474134,282159
1174,86,126768,23200,757893,474925,282968
1175,81,126884,22050,760725,475490,285235
1176,88,126898,26900,760693,476848,283845
1177,90,127282,22050,762625,478282,284343
1178,82,127347,19850,763125,479382,283743
1179,85,127740,24000,764493,480982,283511
1180,90,127761,20350,577936,482448,95488
1181,82,127965,22250,580140,483498,96642
1182,81,128027,19100,579836,485132,94704
1183,84,128215,21350,581140,485698,95442
1184,86,128297,22800,582586,486682,95904
1185,86,128330,21750,583990,489332,94658
1186,82,128605,23700,584990,490932,94058
1187,82,129066,18500,585990,492082,93908
1188,82,129195,19500,586536,493648,92888
1189,85,129249,21000,588040,495132,92908
1190,86,129371,23800,589736,496632,93104
1191,87,129505,25000,595436,497832,97604
1192,82,129535,19250,595490,499148,96342
1193,89,129695,22450,596740,500298,96442
1194,83,129864,17350,597736,501398,96338
1195,89,130243,21900,599640,502798,96842
1196,87,130244,20950,604586,504432,100154
1197,80,130320,18200,602336,505898,96438
1198,87,130339,26950,606540,507582,98958
1199,87,130408,21650,606136,509198,96938
1200,84,130702,15100,607736,509882,97854
1201,82,130760,21400,611386,511348,100038
1202,89,130770,18250,610240,512998,97242
1203,81,130790,20400,611790,514598,97192
1204,90,130905,19550,613490,516248,97242
1205,88,130996,20800,615736,518398,97338
1206,87,131036,18450,619086,520648,98438
1207,85,131119,22000,621786,493175,128611
1208,81,131123,17600,622490,493636,128854
1209,83,131140,21650,622786,494186,128600
1210,87,131168,19600,621990,495236,126754
1211,90,131423,23900,624540,496236,128304
1212,88,131973,19200,628686,496584,132102
1213,81,131976,21250,628740,496875,131865
1214,87,132280,20650,629890,497825,132065
1215,87,132455,17350,631586,498386,133200
1216,84,132685,20500,632586,499025,133561
1217,90,132855,23100,633540,499490,134050
1218,81,133243,21250,638690,500025,138665
1219,85,133258,24150,638736,500584,138152
1220,86,133290,20550,639190,501075,138115
1221,88,133411,22000,640240,501290,138950
1222,86,133486,20800,641536,502125,139411
1223,81,133496,18600,642090,502390,139700
1224,82,133753,18350,643236,502940,140296
1225,84,133812,24150,645786,503634,142152
1226,85,133820,19400,647386,503825,143561
1227,85,133944,18750,648790,504186,144604
1228,84,134118,19000,650490,504684,145806
1229,89,134329,22550,652190,505425,146765
1230,81,134371,18400,655040,505936,149104
1231,84,134423,20700,655036,506140,148896
1232,88,134644,24250,656236,507075,149161
1233,83,134960,17350,657890,507436,150454
1234,86,135039,23700,658890,507884,151006
1235,81,135140,16850,660890,508384,152506
1236,81,135222,17300,660936,508975,151961
1237,87,135406,20750,667936,509440,158496
1238,83,135436,17500,667940,510040,157900
1239,81,135436,17200,667986,510584,157402
1240,84,135489,21650,669136,510775,158361
1241,83,135537,21600,669490,511190,158300
1242,87,135719,18400,670740,511375,159365
1243,83,135738,20050,671486,512275,159211
1244,82,135867,18100,673590,512786,160804
1245,86,135882,20100,674736,513475,161261
1246,88,136000,22850,675740,514040,161700
1247,88,136085,20900,676886,514525,162361
1248,89,136203,21600,679186,515090,164096
1249,80,136412,24100,680490,515484,165006
1250,81,136495,20900,682240,516125,166115
1251,90,136624,23900,765675,516640,249035
1252,82,136764,20300,766843,517375,249468
1253,81,136796,23400,768875,518134,250741
1254,89,137045,20200,769543,518634,250909
1255,84,137268,20400,772925,519086,253839
1256,81,137337,24300,773093,519586,253507
1257,88,137662,24650,775493,520025,255468
1258,89,137671,26050,775625,520825,254800
1259,87,137823,21450,777275,521290,255985
1260,87,138075,22800,779525,521534,257991
1261,80,138311,22000,780725,522034,258691
1262,84,138517,26250,785143,522790,262353
1263,85,138601,20450,784475,523036,261439
1264,90,138602,23850,789443,523575,265868
1265,81,138617,20250,789625,524125,265500
1266,83,138657,24400,789543,524584,264959
1267,84,138886,25800,790775,524940,265835
1268,81,139237,22050,795443,525384,270059
1269,81,139278,25200,795475,525940,269535
1270,80,139322,18850,794975,526440,268535
1271,80,139499,22000,797043,526984,270059
1272,89,139874,26050,798693,527575,271118
1273,82,139997,19400,799893,528075,271818
1274,87,140059,21000,805725,528775,276950
1275,85,140063,24050,806093,529134,276959
1276,90,140101,24750,804525,529575,274950
1277,88,140111,22850,806593,529825,276768
1278,80,140337,19750,809025,530075,278950
1279,84,140409,22200,809443,530984,278459
1280,81,140494,22500,810143,531484,278659
1281,89,140646,26950,813225,532140,281085
1282,85,140799,21350,816075,532425,283650
1283,80,140818,19300,816125,533336,282789
1284,85,140845,23150,816093,534025,282068
1285,82,140937,23450,816693,534740,281953
1286,85,141024,29450,818775,535525,283250
1287,86,141286,22300,818893,535890,283003
1288,85,141579,20900,822275,536586,285689
1289,80,141663,22000,824043,536934,287109
1290,83,141687,24400,822775,537175,285600
1291,86,141714,24550,824543,538236,286307
1292,84,141864,26250,826643,538775,287868
1293,81,141888,22500,828325,539275,289050
1294,82,142018,24800,829443,539825,289618
1295,86,142149,26800,831475,540434,291041
1296,86,142179,19150,836043,540840,295203
1297,83,142204,24400,836525,541636,294889
1298,88,142230,23300,836593,542425,294168
1299,87,142401,22350,837625,543175,294450
1300,88,142501,23300,840243,543675,296568
1301,85,142550,25850,843143,544475,298668
1302,89,142597,24250,842593,544825,297768
1303,81,142745,23850,844625,545375,299250
1304,80,142867,23350,846875,546136,300739
1305,88,142893,27800,848993,546975,302018
1306,84,142909,25800,850025,547290,302735
1307,89,143028,22000,850843,547890,302953
1308,88,143068,23300,852593,548575,304018
1309,82,143151,25250,853693,549286,304407
1310,85,143257,25850,856993,549675,307318
1311,90,143291,24300,857225,550175,307050
1312,88,143422,20600,858325,550740,307585
1313,80,143517,22000,859075,551586,307489
1314,83,143555,22600,860343,551675,308668
1315,80,143558,23800,861875,552175,309700
1316,88,143612,23300,784040,552725,231315
1317,80,143653,21550,784540,553725,230815
1318,87,143807,23700,786140,554225,231915
1319,84,143866,21750,788536,554775,233761
1320,81,144086,27900,789990,554934,235056
1321,86,144327,21850,790640,555740,234900
1322,89,144384,24250,791140,556575,234565
1323,84,144564,24900,793790,557075,236715
1324,89,144625,21550,794186,557675,236511
1325,85,144732,23600,795240,558336,236904
1326,83,144879,21250,796340,558836,237504
1327,89,145019,19750,797086,559484,237602
1328,80,145128,22450,798140,560790,237350
1329,85,145244,21800,800740,561375,239365
1330,90,145347,23850,802786,562134,240652
1331,89,145390,26500,803986,562675,241311
1332,81,145538,20700,804490,563036,241454
1333,87,145574,21450,806690,563586,243104
1334,87,145666,22350,806836,564086,242750
1335,90,145779,22950,808036,564586,243450
1336,81,145919,21600,809690,565086,244604
1337,90,145923,27000,814640,565784,248856
1338,81,145940,27000,814986,567284,247702
1339,86,146002,22750,814486,567825,246661
1340,90,146054,23850,816390,567990,248400
1341,83,146150,22600,817636,568734,248902
1342,81,146235,21600,819186,569234,249952
1343,83,146253,25300,820340,570025,250315
1344,89,146277,28750,825136,570575,254561
1345,84,146303,23100,822586,571375,251211
1346,90,146334,28800,824640,572425,252215
1347,90,146385,20700,825740,572636,253104
1348,84,146571,20850,826790,560188,266602
1349,84,146721,19950,828686,560575,268111
1350,85,146855,24500,831936,561275,270661
1351,86,146855,25450,831436,561834,269602
1352,89,146957,25150,832836,562334,270502
1353,90,147019,27450,833487,563288,270199
1354,81,147044,23400,835091,563686,271405
1355,85,147089,24500,835591,564186,271405
1356,85,147125,25850,835687,564584,271103
1357,80,147506,20650,835936,565338,270598
1358,81,147813,19350,836937,565786,271151
1359,84,147824,23100,837791,566525,271266
1360,84,147913,24450,838041,567025,271016
1361,89,147933,26500,838591,567538,271053
1362,80,147958,22000,838487,568638,269849
1363,89,148078,24250,839087,569186,269901
1364,86,148097,25000,839637,570175,269462
1365,87,148154,20550,841189,570675,270514
1366,80,148192,18850,840841,570788,270053
1367,87,148192,20100,841337,571236,270101
1368,84,148293,23550,841586,571884,269702
1369,86,148688,25900,842789,572486,270303
1370,86,148706,25450,843641,572975,270666
1371,86,148920,22750,843837,573727,270110
1372,87,148948,23700,845391,574175,271216
1373,83,148981,25750,845386,575327,270059
1374,82,149630,24800,846891,576134,270757
1375,85,149724,20450,847089,576784,270305
1376,87,149820,23250,847041,577336,269705
1377,80,149895,20650,847739,577838,269901
1378,89,150112,22450,848239,578077,270162
1379,88,150249,24650,849237,578388,270849
1380,87,150266,25500,849691,579075,270616
1381,84,150301,23550,850191,579675,270516
1382,83,150383,20350,850191,579736,270455
1383,89,150466,25150,851189,580477,270712
1384,84,150491,19500,851341,580884,270457
1385,88,150555,22400,852041,581036,271005
1386,81,150711,23850,852786,582086,270700
1387,85,150807,20450,853286,582338,270948
1388,85,150942,22700,854089,583027,271062
1389,89,151065,25150,854486,583527,270959
1390,86,151313,25450,854986,583988,270998
1391,82,151380,22100,855486,584636,270850
1392,81,151502,25650,856586,584884,271702
1393,82,151597,21650,856541,585384,271157
1394,81,151607,26550,857041,586177,270864
1395,89,151650,24700,857736,586434,271302
1396,86,151676,28150,859391,587225,272166
1397,82,151685,23900,858637,587727,270910
1398,89,151759,22450,859637,588436,271201
1399,87,151997,24600,859891,589427,270464
1400,82,152107,19850,860341,589975,270366
1401,87,152274,24600,860636,590284,270352
1402,81,152350,19800,861636,590884,270752
1403,87,152438,24600,861591,591388,270203
1404,81,152483,18000,862191,591575,270616
1405,86,152640,23650,863341,592438,270903
1406,80,152647,22450,863191,593225,269966
1407,90,152801,22950,864237,593775,270462
1408,86,152843,25000,864639,594875,269764
1409,83,152932,21250,865139,595425,269714
1410,82,153034,24350,866789,595975,270814
1411,81,153074,20700,865886,596488,269398
1412,90,153086,28350,867586,597177,270409
1413,88,153165,27350,867289,597736,269553
1414,81,153340,22050,868337,598177,270160
1415,89,153464,27850,868887,598984,269903
1416,80,153499,20650,869041,599534,269507
1417,85,153568,26300,869487,600688,268799
1418,87,153788,22800,869987,601325,268662
1419,90,153788,20700,870136,601836,268300
1420,84,153851,24900,870786,602525,268261
1421,82,153915,20300,871089,603177,267912
1422,89,154156,22000,871841,603677,268164
1423,87,154299,23700,873836,604486,269350
1424,85,154344,26300,873437,604727,268710
1425,81,154345,22050,873889,605484,268405
1426,84,154396,20400,873791,605675,268116
1427,84,154540,23550,875537,605927,269610
1428,84,154541,19950,875291,606527,268764
1429,88,154563,26450,875441,606686,268755
1430,82,154861,19400,876491,607084,269407
1431,83,154901,23050,876491,607734,268757
1432,82,155020,18500,876687,608234,268453
1433,90,155107,24300,879237,608925,270312
1434,88,155125,24200,878187,609486,268701
1435,83,155188,26200,879337,609834,269503
1436,83,155251,23050,879539,610577,268962
1437,85,155674,26300,880091,611577,268514
1438,85,155724,24950,881486,612077,269409
1439,87,155751,22800,881239,612627,268612
1440,86,156101,22750,881986,613284,268702
1441,90,156225,27900,882737,614284,268453
1442,80,156346,21550,883191,614975,268216
1443,80,156376,26500,883691,615834,267857
1444,84,156427,23550,885939,616038,269901
1445,85,156448,21350,885986,616638,269348
1446,90,156468,26550,885737,617477,268260
1447,83,156635,21700,886439,617686,268753
1448,82,156955,25250,887039,618684,268355
1449,81,157015,23400,887686,619825,267861
1450,81,157143,22500,887937,620925,267012
1451,90,157265,24750,888437,621738,266699
1452,81,157412,22500,889736,622338,267398
1453,84,157439,24450,889789,623127,266662
1454,90,157545,22950,890191,623434,266757
1455,89,157575,24700,890637,623984,266653
1456,90,157625,22950,891439,624534,266905
1457,83,157679,24850,891886,625184,266702
1458,81,157840,21600,892887,625684,267203
1459,80,157856,24250,892936,626377,266559
1460,83,158167,23950,893436,626684,266752
1461,81,158381,22050,893986,627284,266702
1462,89,158556,25150,894536,628488,266048
1463,88,158810,25100,894937,629286,265651
1464,89,159008,28300,896037,629884,266153
1465,87,159019,21900,895691,630788,264903
1466,81,159067,24300,896537,631288,265249
1467,85,159254,23150,897086,631886,265200
1468,80,159447,20200,897989,632436,265553
1469,88,159580,27350,898736,633075,265661
1470,81,159723,22500,899491,633938,265553
1471,87,160026,20100,899886,634627,265259
1472,86,160061,24100,900287,634984,265303
1473,80,160064,20200,900691,635627,265064
1474,89,160123,22450,901291,636036,265255
1475,80,160130,22900,902537,636638,265899
1476,90,160186,25200,902889,637227,265662
1477,88,160306,23300,904691,637827,266864
1478,85,160339,26300,905486,638327,267159
1479,82,160374,21200,905536,638734,266802
1480,88,160408,26450,906036,639327,266709
1481,90,160433,21600,906887,640036,266851
1482,87,160531,23700,907136,640738,266398
1483,81,160532,22050,906741,641288,265453
1484,87,160754,24600,907241,642084,265157
1485,87,160854,22800,907589,642775,264814
1486,85,160905,22250,908041,643036,265005
1487,84,161079,19500,908637,643388,265249
1488,83,161269,25750,909137,643775,265362
1489,81,161669,21600,909489,644325,265164
1490,86,161707,22750,909637,644488,265149
1491,86,161828,24100,910536,645425,265111
1492,87,161885,22350,912441,645925,266516
1493,80,161912,18400,912841,646584,266257
1494,89,161944,23800,913336,647425,265911
1495,86,162010,25000,913341,648184,265157
1496,83,162306,21700,914089,648277,265812
1497,81,162407,19350,915541,648734,266807
1498,84,162434,21750,915486,648977,266509
1499,80,162658,22000,916489,649738,266751
1500,84,162706,22200,916287,650527,265760
1501,80,162784,22450,916841,651336,265505
1502,90,162999,28800,918191,652177,266014
1503,84,163349,22650,918887,652584,266303
1504,80,163374,20200,918689,653134,265555
1505,88,163494,25550,836940,653627,183313
1506,83,163590,22150,841090,654175,186915
1507,86,163657,26350,839836,655038,184798
1508,83,163661,24850,840836,655725,185111
1509,82,163673,20750,842686,656277,186409
1510,86,163710,23200,842340,656775,185565
1511,89,163891,24250,844040,649890,194150
1512,80,164082,23350,852040,650134,201906
1513,90,164119,22950,847836,650684,197152
1514,81,164172,26100,849390,651784,197606
1515,87,164172,27750,852036,652683,199353
1516,87,164459,25050,854740,653684,201056
1517,83,164466,22600,854486,654234,200252
1518,87,164582,21450,855686,654884,200802
1519,80,164697,24700,857840,655733,202107
1520,82,164829,25700,859390,656384,203006
1521,87,165317,25050,860490,657233,203257
1522,90,165429,22050,863786,657588,206198
1523,88,165454,27800,861690,658638,203052
1524,80,165470,24250,864190,659138,205052
1525,82,165593,21650,865836,659540,206296
1526,81,165630,22950,866986,660134,206852
1527,90,165673,23400,868190,660684,207506
1528,86,165784,23200,871686,661438,210248
1529,90,165844,25650,873036,662234,210802
1530,88,165867,26000,873086,663284,209802
1531,83,165936,21250,873586,663790,209796
1532,80,166203,25150,875990,664638,211352
1533,89,166233,23800,876736,665188,211548
1534,86,166350,25450,879290,665484,213806
1535,90,166415,26100,882336,666884,215452
1536,80,166469,25600,882040,667484,214556
1537,80,166700,23350,884190,667590,216600
1538,89,166774,22450,885290,667934,217356
1539,81,166827,21150,887136,668138,218998
1540,86,166842,23650,887390,668683,218707
1541,89,167022,23350,891836,668834,223002
1542,82,167094,19400,889686,669584,220102
1543,90,167101,22950,892336,670283,222053
1544,85,167202,20900,893986,670388,223598
1545,83,167399,23950,894586,670890,223696
1546,88,167461,24200,896190,671188,225002
1547,80,167598,21550,898536,671033,227503
1548,86,167664,23200,898790,671684,227106
1549,87,167867,27300,901590,672288,229302
1550,84,167915,19950,901736,672834,228902
1551,84,168081,22200,904890,673434,231456
1552,85,168118,23150,904886,673934,230952
1553,89,168330,22000,907690,674190,233500
1554,86,168336,24100,908086,674690,233396
1555,87,168855,25050,910786,675690,235096
1556,80,168916,22450,911836,676288,235548
1557,83,169025,20350,912640,676433,236207
1558,81,169050,18450,913140,676934,236206
1559,81,169234,25200,915440,677484,237956
1560,84,169272,22650,919143,678534,240609
1561,88,169314,21500,919186,679034,240152
1562,82,169370,23000,919341,679584,239757
1563,85,169464,23150,919686,680283,239403
1564,90,169481,27000,920643,681134,239509
1565,81,169552,25650,920489,681388,239101
1566,83,169585,24400,921041,681888,239153
1567,85,169757,24950,923636,682684,240952
1568,90,169766,23850,924487,682940,241547
1569,80,169828,19300,924089,683488,240601
1570,80,169854,22000,923541,684038,239503
1571,87,169865,24150,924589,684490,240099
1572,82,170141,21650,925089,684883,240206
1573,83,170214,21700,926139,685540,240599
1574,83,170299,24850,926737,686040,240697
1575,80,170347,21550,926741,686334,240407
1576,86,170391,21850,926693,686933,239760
1577,89,170843,23800,927741,687934,239807
1578,81,170955,21150,927839,688533,239306
1579,84,170955,25800,928539,689033,239506
1580,82,171084,16250,928941,688688,240253
1581,82,171228,18500,929387,689434,239953
1582,87,171328,23250,930536,689934,240602
1583,90,171380,22050,930893,690833,240060
1584,80,171609,21550,931691,691090,240601
1585,90,171626,25650,932393,691538,240855
1586,89,171826,27850,933587,692088,241499
1587,80,171874,23350,933593,692834,240759
1588,88,171954,20150,935187,693340,241847
1589,84,171985,24900,935189,693934,241255
1590,87,172010,22800,934986,694384,240602
1591,81,172129,24750,937439,695384,242055
1592,83,172132,23950,935893,695484,240409
1593,85,172179,24500,936641,695884,240757
1594,80,172197,20200,937191,696290,240901
1595,87,172204,25050,937939,697134,240805
1596,84,172218,22200,938391,697840,240551
1597,83,172317,25750,938387,698584,239803
1598,87,172485,24150,940041,699284,240757
1599,84,172516,22200,940043,699890,240153
1600,87,172559,24150,940189,700433,239756
1601,87,172757,21000,940887,700990,239897
1602,81,172965,22050,941636,701384,240252
1603,88,173014,22400,942186,701733,240453
1604,84,173175,23100,942437,702138,240299
1605,81,173225,20700,942987,702534,240453
1606,81,173324,19350,943537,702984,240553
1607,88,173532,22850,945287,703638,241649
1608,90,173556,27900,945386,704534,240852
1609,81,173573,27000,945143,705084,240059
1610,81,173870,21150,920836,705383,215453
1611,88,173939,21050,922186,705490,216696
1612,81,173940,22050,922540,706433,216107
1613,84,174134,24000,924190,707040,217150
1614,84,174328,28050,927036,708040,218996
1615,80,174387,23350,927536,708538,218998
1616,88,174503,25550,930836,709640,221196
1617,80,174519,20650,929990,710088,219902
1618,81,174562,23850,930640,710534,220106
1619,83,174688,24400,932240,711533,220707
1620,86,174867,20950,934990,711840,223150
1621,84,174964,22650,935336,712238,223098
1622,88,175108,20150,937086,712633,224453
1623,84,175345,22200,938636,713283,225353
1624,85,175587,24950,940790,713990,226800
1625,81,175643,19800,941840,714734,227106
1626,88,175703,23750,942340,714988,227352
1627,88,175965,28700,943840,715988,227852
1628,83,176053,19900,944736,716538,228198
1629,83,176423,22150,946193,717538,228655
1630,85,176496,21350,946543,717784,228759
1631,81,176652,22950,946837,718184,228653
1632,83,176879,25300,947293,719184,228109
1633,90,176925,24750,947839,719338,228501
1634,82,177140,23000,948487,720184,228303
1635,80,177211,22450,948987,720588,228399
1636,83,177371,28000,949589,721138,228451
1637,89,177515,24700,950543,721883,228660
1638,85,177612,20450,950536,722484,228052
1639,80,177876,22900,951043,722984,228059
1640,89,178162,24700,952086,723284,228802
1641,87,178271,25500,952737,724240,228497
1642,84,178400,22650,953337,724934,228403
1643,84,178487,22650,953243,725434,227809
1644,81,178603,23850,953743,726290,227453
1645,80,178650,23800,953839,726434,227405
1646,81,178737,21150,953486,726790,226696
1647,84,178741,22200,953740,727184,226556
1648,86,178765,25000,954440,727790,226650
1649,87,178825,26400,958190,728483,229707
1650,89,178858,23800,958186,729033,229153
1651,82,178873,26150,956836,729734,227102
1652,82,178886,22100,958686,730583,228103
1653,89,179047,21550,960286,731133,229153
1654,89,179182,22450,964986,730934,234052
1655,81,179245,22950,966536,731588,234948
1656,89,179277,19300,965040,732040,233000
1657,80,179310,22000,966640,733090,233550
1658,84,179364,24450,967036,733734,233302
1659,90,179403,27450,706028,734140,-28112
1660,89,179407,22900,706081,734584,-28503
1661,81,179409,19350,705972,734790,-28818
1662,89,179534,27850,707022,735538,-28516
1663,90,179582,27900,707628,735933,-28305
1664,84,179710,25800,711272,736433,-25161
1665,88,179721,26000,711497,737234,-25737
1666,85,179723,22700,711681,737784,-26103
1667,89,179730,26500,709672,738490,-28818
1668,89,179775,22900,712628,739033,-26405
1669,88,179801,26900,710997,739583,-28586
1670,85,179844,24050,713433,740534,-27101
1671,80,179878,20650,713281,741183,-27902
1672,81,179974,22500,713872,741683,-27811
1673,80,179978,18850,716497,741840,-25343
1674,81,180022,24300,714872,742588,-27716
1675,88,180022,24650,716172,743084,-26912
1676,83,180039,20350,716131,743283,-27152
1677,87,180041,27300,716631,743940,-27309
1678,85,180267,24500,717131,744584,-27453
1679,87,180396,23700,718583,744933,-26350
1680,88,180428,27350,719047,745583,-26536
1681,85,180432,27650,719083,746190,-27107
1682,87,180616,24150,720678,746688,-26010
1683,88,180628,26450,720431,746534,-26103
1684,86,180686,25450,720972,747288,-26316
1685,87,180880,22350,721472,747938,-26466
1686,81,181039,25200,722278,748433,-26155
1687,85,181103,23150,723231,749034,-25803
1688,80,181147,19750,723883,749188,-25305
1689,90,181241,25650,724231,749683,-25452
1690,83,181254,19000,724078,750183,-26105
1691,81,181360,19800,725083,750688,-25605
1692,86,181829,25000,725381,751634,-26253
1693,82,181956,22100,725778,752190,-26412
1694,85,182254,25400,726733,753133,-26400
1695,88,182326,24200,726378,753684,-27306
1696,83,182340,23500,727378,754234,-26856
1697,82,182343,22100,728572,754390,-25818
1698,89,182349,21550,728631,754838,-26207
1699,83,182548,26200,730172,755390,-25218
1700,83,182559,22150,730181,756283,-26102
1701,89,182574,26050,730028,756434,-26406
1702,80,182812,18850,731078,756783,-25705
1703,88,182819,25550,731781,720236,11545
1704,88,183022,29600,732178,721524,10654
1705,86,183116,26350,732397,722436,9961
1706,80,183116,23350,734478,722774,11704
1707,89,183125,23800,733472,723974,9498
1708,89,183134,26950,733928,726074,7854
1709,90,183147,23400,734481,727624,6857
1710,81,183244,23400,734972,728224,6748
1711,89,183389,25600,736722,730224,6498
1712,82,183424,23900,736081,732186,3895
1713,83,183433,26200,736728,734186,2542
1714,83,183739,19450,737222,735624,1598
1715,84,183802,27150,739281,737386,1895
1716,88,183896,23750,738322,738824,-502
1717,82,183897,23900,739297,739924,-627
1718,83,184050,23050,740281,741624,-1343
1719,89,184051,25150,740672,744286,-3614
1720,82,184082,24350,741222,745786,-4564
1721,88,184195,26450,742128,747124,-4996
1722,86,184246,26800,742881,749724,-6843
1723,82,184584,26600,743397,751136,-7739
1724,87,184767,23250,743783,751786,-8003
1725,80,184883,22000,745328,753486,-8158
1726,87,184918,23700,745422,754136,-8714
1727,89,184927,24700,745631,756186,-10555
1728,89,184959,24250,745733,757224,-11491
1729,85,185228,25850,747778,758924,-11146
1730,88,185267,20600,748478,761136,-12658
1731,87,185292,25050,747728,762736,-15008
1732,80,185324,24700,748222,763624,-15402
1733,89,185352,24700,748881,764774,-15893
1734,82,185560,21200,749431,765586,-16155
1735,86,185702,23200,749983,767624,-17641
1736,80,185749,20650,752728,769674,-16946
1737,80,185757,23800,752833,771274,-18441
1738,81,185804,23850,753047,773736,-20689
1739,81,185804,24750,753081,775336,-22255
1740,84,185984,20400,754731,776274,-21543
1741,85,185993,23150,754983,777324,-22341
1742,85,186047,22700,754697,779024,-24327
1743,84,186139,24000,755428,780874,-25446
1744,84,186203,21300,756478,781974,-25496
1745,85,186216,24950,756872,797531,-40659
1746,81,186303,23400,757922,797631,-39709
1747,81,186319,23400,758331,799231,-40900
1748,80,186432,19750,758947,799431,-40484
1749,88,186523,24200,759172,800531,-41359
1750,89,186752,26050,760128,803082,-42954
1751,88,186806,25550,760631,803732,-43101
1752,90,186882,24750,760628,805332,-44704
1753,90,187097,24750,762081,806932,-44851
1754,80,187171,19300,762178,807982,-45804
1755,83,187183,19900,762631,809181,-46550
1756,84,187280,22650,764122,809932,-45810
1757,85,187307,26300,763731,812082,-48351
1758,89,187379,22900,764228,812682,-48454
1759,88,187566,20150,764772,813882,-49110
1760,80,187839,24700,765372,814931,-49559
1761,85,187956,22700,765947,816182,-50235
1762,81,187978,24300,767047,817332,-50285
1763,82,188044,21650,766833,819132,-52299
1764,84,188142,24000,767178,820481,-53303
1765,84,188250,21300,767647,821632,-53985
1766,86,188501,25900,768181,823682,-55501
1767,83,188724,23500,769647,824831,-55184
1768,87,188788,24600,770222,825882,-55660
1769,83,188840,21700,770778,826582,-55804
1770,87,188896,26850,771733,827632,-55899
1771,80,188962,23350,771778,829282,-57504
1772,81,189073,22050,772328,831031,-58703
1773,80,189161,22000,773147,832532,-59385
1774,84,189190,26250,774431,833881,-59450
1775,86,189200,23200,774378,836081,-61703
1776,80,189294,21100,774928,837231,-62303
1777,86,189475,25900,778431,838732,-60301
1778,87,189477,26400,778478,840331,-61853
1779,90,189525,24750,776678,841932,-65254
1780,83,189549,18100,777122,842581,-65459
1781,89,189565,25600,779033,844731,-65698
1782,88,189569,25550,779197,845231,-66034
1783,85,189650,23150,779222,846381,-67159
1784,90,189889,21600,781178,847631,-66453
1785,84,189894,27150,781222,848831,-67609
1786,86,190010,26350,781681,849932,-68251
1787,89,190170,26050,782272,851981,-69709
1788,89,190464,22450,782872,853232,-70360
1789,87,190782,28200,784047,854832,-70785
1790,82,190835,20300,783872,856382,-72510
1791,85,190891,23600,784522,857982,-73460
1792,82,191054,22550,785733,858982,-73249
1793,82,191140,22100,785522,860482,-74960
1794,90,191399,27900,785978,863032,-77054
1795,87,191430,24150,786522,864131,-77609
1796,88,191510,21950,788228,865232,-77004
1797,88,191519,26000,787522,867982,-80460
1798,80,191566,20650,788033,869731,-81698
1799,85,191620,21350,788631,870632,-82001
1800,80,191731,25600,789583,871731,-82148
1801,90,191862,31500,790831,873332,-82501
1802,85,191864,24050,790772,874532,-83760
1803,89,191966,22450,792028,876231,-84203
1804,86,191966,21850,792097,878832,-86735
1805,80,192162,22000,792431,879931,-87500
1806,80,192252,22900,792983,882131,-89148
1807,86,192313,26800,793431,883281,-89850
1808,90,192370,26100,794431,885332,-90901
1809,87,192370,25050,795178,886731,-91553
1810,83,192501,25750,796228,888931,-92703
1811,88,192509,26000,796131,890932,-94801
1812,84,192544,26700,796447,891781,-95334
1813,81,192644,23400,797072,893232,-96160
1814,80,193092,17500,797833,894081,-96248
1815,82,193206,25250,798481,895631,-97150
1816,90,193352,25650,798933,896632,-97699
1817,88,193506,23750,799322,897632,-98310
1818,80,193697,19750,800747,899081,-98334
1819,80,193717,18850,800922,899332,-98410
1820,86,193880,25000,801881,900731,-98850
1821,90,193897,25650,802178,901932,-99754
1822,90,194028,25200,803522,904431,-100909
1823,89,194107,24250,803481,905481,-102000
1824,80,194275,24250,803997,908531,-104534
1825,83,194310,26200,804481,910531,-106050
1826,81,194332,22050,804622,911932,-107310
1827,87,194641,23250,805622,913331,-107709
1828,82,194723,22100,805481,914582,-109101
1829,90,194825,24300,806178,916132,-109954
1830,84,195043,21300,807581,917282,-109701
1831,84,195054,22200,807033,918332,-111299
1832,83,195103,23050,807681,920082,-112401
1833,83,195172,23050,808672,921281,-112609
1834,84,195264,22200,809728,922832,-113104
1835,86,195302,29050,809683,924332,-114649
1836,88,195439,23750,811978,925681,-113703
1837,85,195475,24500,812431,927182,-114751
1838,90,195504,24300,812383,928732,-116349
1839,87,195646,25500,813328,929731,-116403
1840,90,195720,22050,813031,930531,-117500
1841,85,195802,18650,814181,931632,-117451
1842,89,195817,21100,814197,933231,-119034
1843,80,195870,21550,814528,934681,-120153
1844,87,195996,25050,815831,935681,-119850
1845,85,196021,25400,816331,938182,-121851
1846,80,196049,22000,816833,938732,-121899
1847,86,196124,22750,816831,940282,-123451
1848,80,196187,20650,817778,942631,-124853
1849,80,196266,21550,817483,945232,-127749
1850,87,196270,22350,817278,946282,-129004
1851,83,196315,24400,819283,948432,-129149
1852,82,196368,27050,819333,950981,-131648
1853,81,196388,20700,819372,952081,-132709
1854,83,196466,20800,819833,953482,-133649
1855,86,196656,23200,820597,954132,-133535
1856,85,196727,21350,821597,955231,-133634
1857,85,196862,20900,822331,956182,-133851
1858,86,196892,25450,823178,957031,-133853
1859,82,197154,19850,825628,958432,-132804
1860,90,197156,24300,826083,959781,-133698
1861,88,197156,26000,826128,962132,-136004
1862,90,197182,22500,826422,962681,-136259
1863,81,197331,21150,826733,964732,-137999
1864,85,197332,22250,827081,966982,-139901
1865,90,197473,22500,828522,968781,-140259
1866,89,197518,23800,827397,969532,-142135
1867,84,197523,21300,829197,971331,-142134
1868,84,197548,20850,829672,972381,-142709
1869,84,197599,21300,829022,974032,-145010
1870,87,197602,23700,830831,975632,-144801
1871,83,197663,24850,830528,977531,-147003
1872,82,197668,18950,830872,978781,-147909
1873,90,197767,26100,831028,980881,-149853
1874,89,197963,25600,831547,982631,-151084
1875,83,198077,23050,832472,984681,-152209
1876,83,198180,23050,834747,986281,-151534
1877,85,198204,21350,834883,987931,-153048
1878,81,198222,25650,834928,989131,-154203
1879,86,198242,20050,834431,991032,-156601
1880,88,198510,22400,837522,992682,-155160
1881,81,198546,23850,837547,994832,-157285
1882,86,198581,27700,837483,995882,-158399
1883,87,198770,23700,838381,996881,-158500
1884,86,198893,23650,839572,998531,-158959
1885,90,198943,27000,839583,999682,-160099
1886,88,199323,18800,840578,992774,-152196
1887,88,199355,23300,841131,994436,-153305
1888,80,199453,23800,840697,995586,-154889
1889,86,199532,25900,841631,997424,-155793
1890,88,199750,26000,842781,998886,-156105
1891,81,199781,20700,842433,999686,-157253
1892,89,200010,22450,843497,999824,-156327
1893,80,200484,20200,844431,825042,19389
1894,90,200515,22050,844472,825478,18994
1895,83,200917,23050,846197,827142,19055
1896,90,200970,22050,845181,828378,16803
1897,84,200981,24450,845883,829378,16505
1898,83,201015,22150,845931,830678,15253
1899,83,201197,21700,846697,832042,14655
1900,87,201413,24600,847022,832828,14194
1901,80,201555,19750,847483,834978,12505
1902,81,201749,22050,848747,836728,12019
1903,80,201801,18850,848722,838792,9930
1904,85,201913,19100,850178,840978,9200
1905,87,201990,26850,850728,842492,8236
1906,82,202062,21650,851031,843992,7039
1907,81,202210,21150,851597,845528,6069
1908,82,202334,22100,852147,846128,6019
1909,90,202353,23400,852578,848278,4300
1910,80,202539,23350,853747,850328,3419
1911,86,202603,20500,853483,851442,2041
1912,83,203039,22150,854328,853428,900
1913,88,203172,24650,854828,854978,-150
1914,82,203366,21200,855822,857128,-1306
1915,87,203536,23250,856778,859392,-2614
1916,90,203632,25200,858531,862042,-3511
1917,89,203699,24250,857197,863642,-6445
1918,87,203714,23250,858578,865028,-6450
1919,83,203727,23050,858797,867128,-8331
1920,84,203834,23550,859081,868442,-9361
1921,86,203949,22750,861081,869928,-8847
1922,87,203992,21900,860683,871978,-11295
1923,80,204015,22000,861022,873578,-12556
1924,90,204154,26100,862883,875692,-12809
1925,81,204245,22950,862831,877792,-14961
1926,87,204293,26850,864247,879778,-15531
1927,86,204330,23200,864381,881428,-17047
1928,83,204451,22600,865772,882592,-16820
1929,83,204488,19900,865728,884528,-18800
1930,83,204732,21250,867533,885592,-18059
1931,86,204758,27700,867872,888278,-20406
1932,89,204793,27400,867481,889378,-21897
1933,90,205023,23400,868233,889792,-21559
1934,88,205079,23300,869128,890392,-21264
1935,85,205144,25400,869297,892178,-22881
1936,80,205258,21100,870022,892942,-22920
1937,81,205268,23400,870522,894492,-23970
1938,84,205429,22650,871678,896092,-24414
1939,84,205471,21750,871747,898742,-26995
1940,85,205670,24050,872822,900328,-27506
1941,87,205700,22800,873928,901628,-27700
1942,86,205795,19600,873533,902442,-28909
1943,81,205898,21600,875031,903642,-28611
1944,83,205906,20800,874978,904942,-29964
1945,87,206123,24150,875683,905942,-30259
1946,90,206172,22500,876578,907192,-30614
1947,85,206323,22700,877683,908728,-31045
1948,87,206407,25500,877678,911292,-33614
1949,87,206435,23700,878828,911842,-33014
1950,81,206517,24300,879328,913078,-33750
1951,83,206578,24850,879997,915042,-35045
1952,86,206633,20950,879783,915892,-36109
1953,86,206678,21400,880597,916942,-36345
1954,86,206695,24550,881281,918278,-36997
1955,90,206885,23850,883622,918742,-35120
1956,89,206901,18850,882622,919928,-37306
1957,83,206957,26650,883678,921078,-37400
1958,84,207218,20850,884122,922278,-38156
1959,85,207243,20900,884478,923578,-39100
1960,90,207775,23400,884978,926192,-41214
1961,88,207920,26000,885622,927378,-41756
1962,83,208099,20800,886172,928492,-42320
1963,88,208495,23300,887147,930528,-43381
1964,86,208740,24550,889633,932678,-43045
1965,85,208791,20900,890181,933392,-43211
1966,85,208834,28100,889822,935928,-46106
1967,88,208859,26000,890628,937642,-47014
1968,86,208979,23650,891422,938728,-47306
1969,89,209003,22450,891978,940778,-48800
1970,89,209099,26050,892022,941942,-49920
1971,82,209218,25700,892881,943542,-50661
1972,85,209233,29000,859589,945528,-85939
1973,89,209290,22900,859635,946628,-86993
1974,86,209475,22300,859940,947042,-87102
1975,89,209477,25600,861540,949142,-87602
1976,84,209517,22650,861439,950178,-88739
1977,90,209614,19800,861884,950492,-88608
1978,81,209827,21150,862835,952142,-89307
1979,87,209880,27750,863340,953578,-90238
1980,90,210234,26550,864035,955242,-91207
1981,86,210408,27700,864946,956742,-91796
1982,80,210432,22450,864934,957678,-92744
1983,88,210626,22850,865496,959278,-93782
1984,89,210729,23350,866684,960242,-93558
1985,89,210820,26050,867685,962128,-94443
1986,88,210843,23750,867590,962392,-94802
1987,80,210938,23350,868039,963492,-95453
1988,90,211162,24750,868396,964592,-96196
1989,87,211251,27750,869290,966092,-96802
1990,87,211517,24150,870735,967628,-96893
1991,87,211568,21900,870890,969778,-98888
1992,87,211601,22350,870689,971528,-100839
1993,87,211710,24600,871785,972628,-100843
1994,90,211724,27450,872784,974728,-101944
1995,85,211823,23600,873196,976342,-103146
1996,83,211911,19900,873389,976942,-103553
1997,88,211913,19700,876294,978028,-101734
1998,81,211938,22050,875987,980078,-104091
1999,87,211948,20100,875539,981228,-105689
2000,80,211964,23350,876994,983328,-106334
2001,83,211965,25750,875184,985428,-110244
2002,84,212011,22650,877037,987492,-110455
2003,85,212062,27650,877044,988778,-111734
2004,83,212295,24400,878144,990278,-112134
2005,87,212476,20550,879994,991392,-111398
2006,88,212546,23750,881237,992542,-111305
2007,85,212574,24050,884444,994228,-109784
2008,90,212657,24750,884387,995828,-111441
2009,90,212796,26550,888744,998692,-109948
2010,82,212819,18950,888794,999878,-111084
2011,86,212868,23200,888987,999978,-110991
2012,83,212996,22600,889587,860290,29297
2013,86,213169,25450,890694,860840,29854
2014,89,213370,22000,891744,861138,30606
2015,81,213371,17550,892587,861635,30952
2016,90,213393,26100,895194,862290,32904
2017,82,213496,20300,896387,862738,33649
2018,89,213802,25150,898437,862835,35602
2019,89,213952,23800,898694,863088,35606
2020,88,213956,22850,900787,863835,36952
2021,80,214069,19750,904087,864190,39897
2022,81,214124,19800,904094,864435,39659
2023,88,214472,22400,905637,864690,40947
2024,85,214619,23600,908237,865190,43047
2025,84,214698,22650,911044,865690,45354
2026,82,214721,20750,912637,866340,46297
2027,82,214722,20300,913137,866835,46302
2028,87,214815,23250,912594,867390,45204
2029,86,215161,20950,914644,867535,47109
2030,81,215169,23850,915337,868438,46899
2031,90,215179,23400,918094,869088,49006
2032,90,215217,22050,918594,869588,49006
2033,80,215480,20650,920144,870035,50109
2034,84,215612,24000,922294,870738,51556
2035,89,215840,21550,925487,871238,54249
2036,86,215850,25000,924987,871738,53249
2037,81,216016,21150,926587,872435,54152
2038,88,216227,25550,930937,873338,57599
2039,84,216248,26250,930494,873485,57009
2040,90,216296,22950,930444,874035,56409
2041,90,216635,25650,931094,874238,56856
2042,84,216763,24900,933244,874085,59159
2043,86,216900,24100,938494,874735,63759
2044,86,216901,23200,936737,875285,61452
2045,84,216985,26250,940044,876240,63804
2046,83,217065,22150,941094,876285,64809
2047,82,217095,17150,940887,877290,63597
2048,82,217245,21650,945587,877885,67702
2049,87,217282,22350,945994,878385,67609
2050,85,217283,24050,945687,878985,66702
2051,82,217492,22550,946237,879788,66449
2052,89,217684,23800,948787,880288,68499
2053,82,217742,20750,948244,880788,67456
2054,83,217847,23950,949937,881488,68449
2055,80,218098,22450,951487,881785,69702
2056,90,218281,22500,953144,882488,70656
2057,89,218385,25600,954244,882835,71409
2058,90,218404,24750,954887,883588,71299
2059,86,218420,23650,912884,884335,28549
2060,85,218437,24050,912889,885140,27749
2061,87,218471,25050,912990,885688,27302
2062,80,218573,22900,913639,886238,27401
2063,88,218932,25100,914239,886738,27501
2064,86,219192,24100,915289,887485,27804
2065,85,219753,26750,915584,888338,27246
2066,90,220057,23850,912940,888888,24052
2067,87,220149,18300,913291,889540,23751
2068,85,220165,21350,913990,890040,23950
2069,81,220176,24750,914293,890285,24008
2070,84,220335,22650,915290,890788,24502
2071,81,220372,22050,915548,891385,24163
2072,81,220498,22500,915843,892385,23458
2073,84,220516,24900,917441,893040,24401
2074,84,220567,22650,916648,893540,23108
2075,81,220600,24300,917148,893985,23163
2076,89,220618,20650,918393,894485,23908
2077,86,220672,24550,918198,895135,23063
2078,84,220693,21750,918943,895685,23258
2079,85,220760,21800,920848,896088,24760
2080,82,220828,26600,920890,896835,24055
2081,84,220828,24000,920138,897138,23000
2082,90,220856,23400,921041,898090,22951
2083,81,221045,24300,922288,898288,24000
2084,85,221046,24500,922898,898935,23963
2085,86,221160,25000,923898,899635,24263
2086,88,221432,26900,925090,900085,25005
2087,83,221470,19000,925038,900438,24600
2088,86,221507,25450,926841,900940,25901
2089,90,221564,25200,927388,901588,25800
2090,90,221594,26550,928388,902038,26350
2091,84,221626,26700,928093,902538,25555
2092,80,221668,23350,928698,903088,25610
2093,82,221698,22100,928890,903288,25602
2094,82,221987,24800,930143,904138,26005
2095,82,222012,19850,930141,904438,25703
2096,81,222159,24750,930498,904638,25860
2097,81,222204,26550,931143,905738,25405
2098,86,222237,22750,931691,906238,25453
2099,83,222533,23050,932190,906635,25555
2100,87,222676,25950,932943,907635,25308
2101,83,222767,22600,934190,908635,25555
2102,80,222773,19750,933891,909190,24701
2103,90,222787,22950,934043,910135,23908
2104,89,222992,25600,935248,910840,24408
2105,81,223062,22050,935240,911788,23452
2106,90,223126,22500,935988,912188,23800
2107,81,223192,20250,936291,912788,23503
2108,80,223619,23800,937243,913385,23858
2109,88,223685,24200,937538,914388,23150
2110,84,223768,19500,937840,915088,22752
2111,87,223922,24600,938390,916035,22355
2112,88,223951,23750,938890,916390,22500
2113,90,224338,26550,939890,917135,22755
2114,84,224498,25350,941643,917888,23755
2115,87,224533,24150,941490,918185,23305
2116,84,224644,20850,941898,918685,23213
2117,87,224766,21900,942743,919235,23508
2118,86,224880,22300,943090,919738,23352
2119,87,224886,25950,943448,919788,23660
2120,86,224964,20500,944088,920238,23850
2121,82,225064,29300,945443,920535,24908
2122,80,225111,19300,946443,920938,25505
2123,80,225170,23800,946141,921635,24506
2124,83,225296,23050,947741,922438,25303
2125,80,225318,22450,947943,922885,25058
2126,82,225395,21650,948291,923290,25001
2127,88,225492,21950,949143,923735,25408
2128,86,225536,22300,949748,924285,25463
2129,90,225708,24750,950440,924788,25652
2130,83,225844,24400,950743,925435,25308
2131,87,225959,24150,950940,925985,24955
2132,87,225976,21450,951341,926385,24956
2133,83,225979,19450,951588,926688,24900
2134,80,226187,24250,952088,927688,24400
2135,82,226322,22550,952993,928185,24808
2136,85,226526,24500,954838,928435,26403
2137,83,226557,22600,954491,928935,25556
2138,85,226579,23600,955338,929535,25803
2139,86,227288,27250,955991,930790,25201
2140,84,227413,22650,957141,931288,25853
2141,82,227443,20300,957641,931788,25853
2142,90,227483,28350,958191,932685,25506
2143,80,227570,23350,958238,933140,25098
2144,89,227661,24250,959338,933438,25900
2145,89,227745,24700,958990,933785,25205
2146,80,228399,22000,960643,934088,26555
2147,88,228425,21950,960748,934335,26413
2148,88,228488,19700,961241,934690,26551
2149,89,228550,21550,961291,935138,26153
2150,84,228566,23550,961640,935238,26402
2151,81,228922,18900,961988,935738,26250
2152,80,228940,20650,962393,936185,26208
2153,86,229194,23650,962941,936638,26303
2154,87,229498,25500,964238,936735,27503
2155,86,229499,25000,963998,937385,26613
2156,81,229662,21600,965243,937885,27358
2157,88,229663,23300,965540,938788,26752
2158,90,229665,24300,965598,938985,26613
2159,82,229792,27500,966293,939985,26308
2160,86,229999,24550,967841,940588,27253
2161,84,230030,24900,967793,940985,26808
2162,90,230152,29700,968698,941535,27163
2163,90,230392,26100,969391,941885,27506
2164,90,230634,21600,969543,942538,27005
2165,86,230706,25450,970288,942940,27348
2166,81,230864,22500,970740,943588,27152
2167,80,230872,19750,971043,943885,27158
2168,80,231008,21100,971938,944040,27898
2169,85,231053,24050,972490,944588,27902
2170,81,231117,22050,972893,944935,27958
2171,85,231175,22250,973140,945885,27255
2172,85,231362,20450,974098,946238,27860
2173,88,231380,25100,974940,946385,28555
2174,86,231472,24550,975238,947288,27950
2175,83,231502,27100,976238,947738,28500
2176,82,231775,22550,976788,948288,28500
2177,81,231844,25200,977093,948940,28153
2178,89,232066,27850,977593,949435,28158
2179,81,232226,21150,978388,949788,28600
2180,86,232249,22300,978143,950490,27653
2181,85,232405,24500,979490,951135,28355
2182,90,232660,20700,980498,951538,28960
2183,84,232729,19050,980988,952088,28900
2184,85,232851,25850,981548,953040,28508
2185,84,233005,26250,982488,953385,29103
2186,81,233130,20250,984698,953788,30910
2187,82,233174,22550,984943,954338,30605
2188,86,233219,20050,984640,955138,29502
2189,80,233341,22000,985698,955338,30360
2190,89,233601,26500,987288,956240,31048
2191,80,233699,22000,987243,956888,30355
2192,81,233806,22050,987788,957238,30550
2193,89,233923,24700,989340,957438,31902
2194,90,233934,26100,989388,958090,31298
2195,87,233992,24150,989938,958585,31353
2196,81,234085,18900,990438,959490,30948
2197,83,234141,18550,990341,960040,30301
2198,88,234389,24200,992090,960735,31355
2199,84,234438,24900,992788,961640,31148
2200,87,234474,19650,991991,961388,30603
2201,84,234516,22200,992741,961938,30803
2202,81,234572,21600,993338,962138,31200
2203,84,234740,22650,994398,962538,31860
2204,86,234767,22750,994388,963038,31350
2205,86,234913,23200,994593,963390,31203
2206,84,234948,21300,995193,963885,31308
2207,86,235186,27700,995793,964738,31055
2208,83,235217,21700,996293,964985,31308
2209,82,235547,21200,996640,965785,30855
2210,83,235639,23050,997293,966335,30958
2211,81,235714,18000,999143,966490,32653
2212,84,235717,19500,998641,966990,31651
2213,90,235751,27900,999141,967635,31506
2214,86,235784,19600,999988,968135,31853
2215,86,235871,22250,999793,968738,31055
2216,87,235955,20000,999740,969185,30555
2217,86,235968,23200,999993,969838,30155
2218,85,236069,21850,987929,970388,17541
2219,82,236127,18000,988032,970735,17297
2220,83,236255,17100,988479,971590,16889
2221,87,236273,21050,988979,972535,16444
2222,84,236402,22250,989480,973140,16340
2223,80,236534,18500,990229,973640,16589
2224,87,236622,26450,990632,974885,15747
2225,88,236795,22900,991132,975338,15794
2226,81,237050,19000,992130,975985,16145
2227,90,237169,23850,992829,976535,16294
2228,85,237354,20400,992832,976988,15844
2229,87,237532,19550,993928,977535,16393
2230,83,237607,19850,995179,978585,16594
2231,84,237663,20950,995478,979138,16340
2232,84,237749,21250,996729,979538,17191
2233,82,237770,20300,996280,979785,16495
2234,80,237801,15600,997429,980385,17044
2235,81,237874,21600,997182,981585,15597
2236,81,238099,17150,998280,982135,16145
2237,80,238120,17500,998780,982640,16140
2238,83,238122,21150,998828,982988,15840
2239,87,238289,23050,999779,983985,15794
2240,88,238299,15400,999679,984790,14889
2241,80,238316,16600,999982,985585,14397
2242,87,238784,16600,858026,986038,-128012
2243,88,238942,17550,860039,986838,-126799
2244,85,238959,18600,859330,987388,-128058
2245,80,238987,17800,860126,988040,-127914
2246,82,239115,15200,860683,988388,-127705
2247,85,239132,20900,861726,989285,-127559
2248,90,239139,20850,861733,990038,-128305
2249,82,239313,14350,862276,990588,-128312
2250,81,239364,17750,863139,991238,-128099
2251,90,239397,21950,863480,991740,-128260
2252,83,239553,11650,864030,992240,-128210
2253,87,239631,20100,865226,993085,-127859
2254,89,239655,17550,865726,993840,-128114
2255,83,239677,18500,865589,994785,-129196
2256,87,239756,18350,866876,995490,-128614
2257,89,239758,14800,867030,996385,-129355
2258,86,239814,14900,866826,996488,-129662
2259,81,239814,15500,867289,997190,-129901
2260,86,239919,17050,869289,997690,-128401
2261,81,239939,20800,869330,998188,-128858
2262,80,239993,13550,869733,998688,-128955
2263,89,240044,19150,870826,999685,-128859
2264,80,240129,15600,870839,999940,-129101
2265,82,240138,15400,870429,999990,-129561
2266,89,240292,18850,872339,938337,-65998
2267,82,240381,17450,872426,938637,-66211
2268,88,240612,18750,873033,939237,-66204
2269,89,240835,22950,873533,939837,-66304
2270,87,241060,21000,876126,940337,-64211
2271,86,241085,20500,875583,941639,-66056
2272,85,241125,16700,876280,942139,-65859
2273,85,241205,19450,877789,942934,-65145
2274,82,241205,18150,877733,943139,-65406
2275,87,241294,20100,878330,943687,-65357
2276,83,241386,16550,878289,944137,-65848
2277,81,241392,12300,878429,944634,-66205
2278,86,241492,17850,879830,944895,-65065
2279,89,241559,18150,879626,945637,-66011
2280,80,241599,14700,880633,945945,-65312
2281,85,241704,19250,881380,946445,-65065
2282,85,241932,19100,881880,947187,-65307
2283,89,242050,18800,882483,947837,-65354
2284,80,242293,17550,882983,948484,-65501
2285,83,242402,14750,884876,949145,-64269
2286,89,242454,17750,885430,949737,-64307
2287,83,242516,18000,885583,950337,-64754
2288,81,242660,19600,886026,951134,-65108
2289,83,242716,15900,886526,951637,-65111
2290,85,242850,19450,886783,952137,-65354
2291,84,242999,21300,888829,952537,-63708
2292,80,243017,22850,887833,953187,-65354
2293,88,243083,22300,888539,953795,-65256
2294,81,243091,14750,888730,954334,-65604
2295,84,243185,20550,889930,954995,-65065
2296,89,243592,18950,890530,955939,-65409
2297,85,243699,18100,891029,956639,-65610
2298,85,243883,19000,892080,957034,-64954
2299,80,243977,23300,892126,957987,-65861
2300,80,244126,18950,892626,958584,-65958
2301,88,244164,20500,895880,959084,-63204
2302,83,244169,19800,895976,959445,-63469
2303,81,244181,22500,894389,960439,-66050
2304,88,244197,21400,894976,961084,-66108
2305,85,244200,19400,895829,961637,-65808
2306,84,244350,21300,896929,962634,-65705
2307,80,244357,20350,897430,963195,-65765
2308,83,244440,21800,897930,963587,-65657
2309,85,244508,18350,897826,964087,-66261
2310,88,244594,23000,899579,964834,-65255
2311,80,244619,18950,899180,964889,-65709
2312,89,244676,17950,899680,965537,-65857
2313,85,245000,21200,899983,965939,-65956
2314,89,245010,22200,901339,966939,-65600
2315,88,245105,19850,901533,967087,-65554
2316,88,245376,21400,903930,968039,-64109
2317,87,245385,25100,902226,968695,-66469
2318,83,245398,17550,904039,969539,-65500
2319,88,245440,22850,904179,970437,-66258
2320,87,245462,19450,904183,970937,-66754
2321,83,246208,17500,904983,971234,-66251
2322,85,246299,20700,906526,971689,-65163
2323,88,246315,20050,906733,972037,-65304
2324,85,246321,20150,906029,973284,-67255
2325,80,246414,17750,906639,973937,-67298
2326,81,246778,22850,907333,974489,-67156
2327,81,247009,20400,907639,975087,-67448
2328,80,247344,22300,908930,976039,-67109
2329,83,247461,19200,909430,976539,-67109
2330,80,247547,22400,910289,976945,-66656
2331,80,247640,17800,910179,977587,-67408
2332,82,247683,23100,912639,978495,-65856
2333,81,247724,21050,913130,979434,-66304
2334,83,247725,16550,912876,979787,-66911
2335,84,247879,18250,913883,979945,-66062
2336,89,248019,22650,914280,980445,-66165
2337,89,248158,23150,915126,981189,-66063
2338,80,248186,16400,915380,981689,-66309
2339,85,248604,19400,915829,982439,-66610
2340,87,248857,20750,916133,982587,-66454
2341,87,249039,21100,918026,983437,-65411
2342,83,249044,17650,917739,983595,-65856
2343,82,249075,20850,918239,984337,-66098
2344,83,249194,17550,919383,984587,-65204
2345,86,249208,22250,919380,985084,-65704
2346,90,249294,19750,919930,985584,-65654
2347,87,249321,20550,920429,986134,-65705
2348,90,249519,22150,921033,986889,-65856
2349,89,249698,20500,921426,986945,-65519
2350,87,249726,24100,921739,987884,-66145
2351,82,249836,19550,923876,988484,-64608
2352,87,249859,21900,924330,988645,-64315
2353,89,249892,19300,924476,989087,-64611
2354,84,249903,20850,923830,989537,-65707
2355,80,250007,19200,925139,989945,-64806
2356,81,250157,17400,926829,990687,-63858
2357,80,250209,19450,926976,991234,-64258
2358,84,250334,20400,927479,991689,-64210
2359,88,250458,26700,928529,992237,-63708
2360,83,251282,22050,928883,992834,-63951
2361,83,251545,21750,929226,993595,-64369
2362,86,251681,17750,931229,994289,-63060
2363,88,251740,22850,932526,994887,-62361
2364,85,251740,21450,932089,995684,-63595
2365,84,251785,21900,931730,995937,-64207
2366,84,251835,18700,932733,996245,-63512
2367,83,251919,20850,933139,996884,-63745
2368,87,251983,21150,933833,997637,-63804
2369,89,252103,21500,934480,998245,-63765
2370,87,252140,19600,935076,998634,-63558
2371,84,252170,16150,935383,999089,-63706
2372,84,252286,20900,935879,999837,-63958
2373,80,252390,17650,936280,999895,-63615
2374,81,252635,19250,936780,999837,-63057
2375,87,252965,19200,937583,965929,-28346
2376,86,253209,19800,937926,966568,-28642
2377,90,253309,19850,938876,967172,-28296
2378,80,253331,21700,939980,967375,-27395
2379,80,253385,19350,939539,967925,-28386
2380,89,253402,20350,939589,968322,-28733
2381,88,253424,21600,940629,968868,-28239
2382,81,253521,18950,940639,969472,-28833
2383,88,254079,21850,941576,969868,-28292
2384,82,254205,17950,942133,970368,-28235
2385,80,254215,21100,942380,970679,-28299
2386,87,254339,17800,942779,971222,-28443
2387,85,254424,25250,943279,971679,-28400
2388,89,254627,23000,944383,972172,-27789
2389,80,254716,18800,945483,972718,-27235
2390,90,254793,21100,945526,973229,-27703
2391,85,254921,19950,946439,973572,-27133
2392,88,254958,21150,947080,973875,-26795
2393,86,254975,23650,947580,974518,-26938
2394,85,255135,22650,948589,975018,-26429
2395,80,255183,21950,948379,975479,-27100
2396,84,255243,19900,949730,976472,-26742
2397,83,255306,18400,950129,977168,-27039
2398,81,255511,16500,951476,977472,-25996
2399,85,255582,23100,951489,978225,-26736
2400,90,255605,23400,951729,978922,-27193
2401,90,255901,23850,952139,979622,-27483
2402,83,255909,23050,953280,980275,-26995
2403,86,255940,25450,953789,980918,-27129
2404,81,255966,20700,953626,981375,-27749
2405,80,256284,22450,954429,981872,-27443
2406,82,256354,22550,954889,982525,-27636
2407,81,256582,20250,956039,982972,-26933
2408,89,256635,25600,955939,983775,-27836
2409,90,256655,24300,956480,985022,-28542
2410,90,256682,26100,957139,985768,-28629
2411,89,256899,24250,958833,986572,-27739
2412,83,256997,27550,958680,987072,-28392
2413,83,257019,22150,960189,987818,-27629
2414,82,257023,24350,960676,988472,-27796
2415,90,257023,24300,960533,989222,-28689
2416,80,257134,22000,961533,989472,-27939
2417,88,257174,19700,962289,990029,-27740
2418,84,257256,23100,962329,990725,-28396
2419,86,257331,20050,962829,991325,-28496
2420,87,257489,25050,964333,991879,-27546
2421,80,257527,23800,964326,992118,-27792
2422,84,257800,20850,964880,993025,-28145
2423,80,257904,22450,965639,993229,-27590
2424,85,257937,21800,965526,993772,-28246
2425,87,257941,26850,966789,994072,-27283
2426,86,258027,25000,966983,994279,-27296
2427,82,258180,21200,969588,994872,-25284
2428,87,258211,22800,970992,995472,-24480
2429,90,258244,25200,973092,996422,-23330
2430,90,258283,23400,971238,996479,-25241
2431,86,258338,22300,972788,996922,-24134
2432,89,258462,25150,974742,997922,-23180
2433,86,258568,26800,976038,998668,-22630
2434,88,258605,23750,982138,998822,-16684
2435,83,258608,23500,979442,999275,-19833
2436,90,258619,24750,982638,999925,-17287
2437,88,258704,24650,982142,999922,-17780
2438,85,258780,22700,983242,849990,133252
2439,89,258876,26050,987238,851842,135396
2440,82,258929,21650,988042,853092,134950
2441,80,259002,21550,991038,854592,136446
2442,88,259049,23750,992088,856742,135346
2443,87,259131,22350,992092,857942,134150
2444,88,259332,24200,993692,859690,134002
2445,83,259346,21700,998742,860190,138552
2446,80,259371,21100,998588,861240,137348
2447,84,259438,27150,999088,863442,135646
2448,87,259722,24050,999842,864940,134902
2449,88,259939,20900,977676,866590,111086
2450,82,260086,20200,979079,867840,111239
2451,87,260132,21450,978483,869440,109043
2452,88,260158,21100,979579,870942,108637
2453,80,260183,20600,979130,872940,106190
2454,88,260241,20600,979339,874490,104849
2455,82,260430,19400,979989,875540,104449
2456,87,260537,20700,980329,877092,103237
2457,81,260583,18050,981180,878192,102988
2458,81,260607,21350,981479,880290,101189
2459,88,260683,19450,981979,881790,100189
2460,87,260873,20300,983529,882592,100937
2461,84,260923,19400,983389,884192,99197
2462,89,261345,21050,984130,886392,97738
2463,81,261363,17000,984829,886940,97889
2464,86,261611,25550,985533,889642,95891
2465,88,261939,21500,986329,891090,95239
2466,85,262010,20350,986539,891690,94849
2467,80,262113,18650,986830,892790,94040
2468,84,262122,19800,987933,893292,94641
2469,83,262145,17850,988039,894742,93297
2470,89,262237,21450,988933,896690,92243
2471,86,262472,19000,989639,898492,91147
2472,83,262576,17050,990289,899542,90747
2473,81,262729,21250,990579,900692,89887
2474,81,263050,19050,991833,902390,89443
2475,89,263086,22000,992333,904392,87941
2476,83,263108,18100,992276,905942,86334
2477,81,263237,19250,992826,906390,86436
2478,81,263404,19850,994876,908392,86484
2479,80,263428,19350,995330,909990,85340
2480,86,263480,19950,994729,911642,83087
2481,84,263495,20500,995483,912240,83243
2482,80,263599,23000,995930,912742,83188
2483,81,263675,17650,996289,913890,82399
2484,80,263932,17800,997039,915592,81447
2485,83,264005,21650,997530,917142,80388
2486,87,264184,20300,999226,920240,78986
2487,82,264242,17250,999033,920840,78193
2488,82,264243,18750,999579,922642,76937
2489,88,264455,21250,999876,923442,76434
2490,87,264539,14300,999939,924092,75847
2491,80,264557,17900,932684,926392,6292
2492,89,264599,16300,933142,928542,4600
2493,83,264747,19700,933696,930390,3306
2494,84,264822,18100,934839,933442,1397
2495,88,264909,17850,935534,934442,1092
2496,89,265005,19300,936389,935542,847
2497,88,265041,16600,936435,938092,-1657
2498,87,265299,15250,937535,939242,-1707
2499,82,265386,16950,937446,940640,-3194
2500,83,265440,16550,938634,942042,-3408
2501,82,265505,15850,938684,943242,-4558
2502,89,265582,16500,939696,944890,-5194
2503,86,265677,19050,940685,945242,-4557
2504,87,265739,19100,940739,948190,-7451
2505,85,265909,17750,941946,949290,-7344
2506,89,266002,16150,941842,950192,-8350
2507,80,266494,17900,942642,952140,-9498
2508,86,266573,19550,943596,953240,-9644
2509,90,266666,15900,943534,954840,-11306
2510,80,266666,15850,944034,955142,-11108
2511,87,266729,16250,944242,956540,-12298
2512,86,267038,16200,944534,957540,-13006
2513,83,267481,17600,946585,958842,-12257
2514,84,267564,16750,948339,960590,-12251
2515,84,267567,17450,947996,962142,-14146
2516,86,267599,19950,948735,963440,-14705
2517,84,267629,22250,948085,965942,-17857
2518,83,267681,17650,949735,967042,-17307
2519,86,267699,18950,949192,967942,-18750
2520,83,267768,14100,949884,969042,-19158
2521,82,267800,17700,950384,970092,-19708
2522,84,268149,15750,950792,971490,-20698
2523,82,268320,15650,951385,973342,-21957
2524,83,268468,17200,953235,974540,-21305
2525,81,268490,16850,953689,975190,-21501
2526,86,268493,18700,952542,976492,-23950
2527,88,268510,20800,953734,978492,-24758
2528,85,268547,20000,953592,980042,-26450
2529,86,268921,17250,953785,981940,-28155
2530,81,269035,20600,954642,984440,-29798
2531,88,269103,24050,955285,986392,-31107
2532,87,269308,19800,956389,988042,-31653
2533,88,269406,22750,956834,989242,-32408
2534,81,269426,22050,958834,990842,-32008
2535,81,269480,19850,958442,992390,-33948
2536,81,269506,21500,958984,993390,-34406
2537,82,269593,18150,960439,995440,-35001
2538,85,269608,21200,960939,997292,-36353
2539,89,269638,19750,961135,998490,-37355
2540,80,269671,19700,961284,999942,-38658
2541,87,269881,25550,961992,999790,-37798
2542,89,270288,20450,962784,872936,89848
2543,86,270510,21300,963334,873936,89398
2544,85,270632,21750,964092,874544,89548
2545,82,270996,18250,964739,874986,89753
2546,84,271119,22700,965239,875837,89402
2547,84,271201,19050,966096,876786,89310
2548,88,271221,23650,966684,877487,89197
2549,82,271309,15250,968984,877987,90997
2550,88,271328,21100,969692,878836,90856
2551,86,271369,23300,968434,879336,89098
2552,90,271405,20900,969696,880094,89602
2553,81,271542,20250,969984,880982,89002
2554,89,271629,22250,970792,881637,89155
2555,85,271744,18550,971392,881982,89410
2556,88,271841,17700,973542,882486,91056
2557,84,271906,21400,972784,883437,89347
2558,85,271921,19000,973546,884082,89464
2559,85,272153,19300,974042,884987,89055
2560,88,272206,22750,974385,885587,88798
2561,84,272345,17800,974885,885782,89103
2562,82,272462,18150,976589,885936,90653
2563,80,272476,18350,976785,886087,90698
2564,87,272513,22750,977239,886486,90753
2565,80,272533,21000,977385,887086,90299
2566,82,272561,20750,977496,887586,89910
2567,83,272563,20300,977142,887944,89198
2568,81,272661,15250,978239,888637,89602
2569,85,272827,18650,978884,889182,89702
2570,83,272913,20800,979192,889887,89305
2571,87,272939,21050,979685,890336,89349
2572,84,273046,19750,980196,890836,89360
2573,87,273116,22800,980639,891637,89002
2574,80,273286,19200,981235,891836,89399
2575,89,273339,22750,981542,892586,88956
2576,80,273448,16700,981985,893086,88899
2577,86,273681,21700,982634,893444,89190
2578,90,273781,26100,984185,893936,90249
2579,81,273793,15550,983784,894536,89248
2580,85,273856,20100,984685,895494,89191
2581,84,273965,21250,985296,896044,89252
2582,80,273968,23750,986284,896532,89752
2583,90,274019,23900,986192,897186,89006
2584,88,274024,17750,986835,898036,88799
2585,87,274307,20000,987935,898636,89299
2586,80,274337,20050,988442,899144,89298
2587,81,274375,20200,989284,899737,89547
2588,89,274473,22550,988935,900386,88549
2589,87,274656,21550,990484,900986,89498
2590,88,274740,24700,990096,901886,88210
2591,83,274762,19350,991096,902636,88460
2592,87,274974,20450,991835,902844,88991
2593,85,275109,20150,992892,903632,89260
2594,88,275193,20600,993035,904232,88803
2595,80,275277,19300,993392,904544,88848
2596,84,275982,20500,993635,904986,88649
2597,90,276106,20850,994392,905237,89155
2598,83,276106,22600,995135,906144,88991
2599,89,276264,16500,995635,906686,88949
2600,86,276490,23750,996142,907032,89110
2601,90,276505,22900,996384,907437,88947
2602,86,276594,22700,996685,907744,88941
2603,88,276693,24650,997139,908244,88895
2604,83,276777,21550,997842,908744,89098
2605,87,276900,21150,998392,909586,88806
2606,85,277245,19500,998934,909894,89040
2607,81,277297,17850,999289,910236,89053
2608,83,277419,17300,999992,910736,89256
2609,82,277448,21500,999989,911437,88552
2610,90,277595,17100,861589,912087,-50498
2611,87,277828,18600,862739,912486,-49747
2612,86,277838,18100,863186,912786,-49600
2613,82,277957,16800,864186,913486,-49300
2614,82,278040,16400,863983,913994,-50011
2615,85,278127,17050,865447,914994,-49547
2616,83,278130,16050,865236,915537,-50301
2617,82,278365,17000,865990,916037,-50047
2618,83,278624,15300,867097,916632,-49535
2619,88,278700,16100,866883,917386,-50503
2620,86,278716,17400,867590,918144,-50554
2621,88,279025,16500,916137,918782,-2645
2622,80,279032,15050,915743,919186,-3443
2623,86,279228,18150,918193,919986,-1793
2624,85,279250,20550,918237,920686,-2449
2625,86,279465,24950,920293,921344,-1051
2626,83,279643,20750,922443,921786,657
2627,80,279683,21650,921687,922186,-499
2628,80,279724,21200,924787,922532,2255
2629,86,279747,16400,925293,922987,2306
2630,86,279749,19500,924737,923544,1193
2631,88,279889,21350,928643,924386,4257
2632,83,279901,19600,928537,924886,3651
2633,88,279999,22350,930587,925737,4850
2634,88,279999,17300,932187,926094,6093
2635,83,280113,19500,939137,926887,12250
2636,89,280129,22850,935693,927532,8161
2637,87,280137,18750,940043,928086,11957
2638,89,280191,24550,938943,928782,10161
2639,88,280338,25900,943337,929844,13493
2640,84,280375,15250,943343,930432,12911
2641,82,280481,19850,945787,930586,15201
2642,84,280540,19800,945993,931186,14807
2643,89,280601,24350,947937,931886,16051
2644,84,280610,16700,951787,932582,19205
2645,81,280629,18800,949893,933087,16806
2646,83,280657,20400,951943,933582,18361
2647,80,280764,15500,952787,933786,19001
2648,87,280851,20350,957537,934444,23093
2649,83,280894,20400,959087,934836,24251
2650,86,280900,16200,959093,935287,23806
2651,84,280948,21850,960643,936186,24457
2652,85,280955,21100,958993,936786,22207
2653,80,281014,17550,960287,936837,23450
2654,88,281122,17800,961037,937336,23701
2655,87,281159,16100,962287,937836,24451
2656,87,281308,20600,963043,938386,24657
2657,80,281378,16650,966237,938936,27301
2658,87,281447,20450,966537,939637,26900
2659,82,281503,20250,966993,939936,27057
2660,86,281848,22850,971437,940237,31200
2661,87,281897,18800,969793,941194,28599
2662,89,281937,24250,971487,941837,29650
2663,87,282134,18650,972987,942244,30743
2664,88,282239,21050,976443,942744,33699
2665,89,282299,23150,976493,943336,33157
2666,83,282324,20100,978643,943932,34711
2667,82,282408,20450,979837,944637,35200
2668,88,282440,22600,979843,944986,34857
2669,82,282924,21250,981337,945886,35451
2670,87,283510,17950,982937,946186,36751
2671,86,283633,21650,984637,947482,37155
2672,81,283773,19500,985943,948044,37899
2673,81,283786,21750,988943,949087,39856
2674,84,283808,21600,988443,949886,38557
2675,85,283903,23350,991993,950486,41507
2676,80,284571,21250,995643,951287,44356
2677,86,284619,21850,995237,952586,42651
2678,90,285092,21750,997337,953382,43955
2679,86,285099,20000,999437,954236,45201
2680,80,285475,19500,999893,954794,45099
2681,90,285497,14000,999637,955432,44205
2682,81,285681,19850,944641,956336,-11695
2683,88,285738,16100,944994,956836,-11842
2684,87,285931,19100,948691,957582,-8891
2685,87,285964,14400,950994,958132,-7138
2686,84,285975,18500,951191,959132,-7941
2687,84,286058,17650,951891,959287,-7396
2688,88,286115,17050,954141,959936,-5795
2689,89,286202,19800,955144,960682,-5538
2690,80,286285,18350,955641,961182,-5541
2691,88,286439,19450,956691,962287,-5596
2692,80,286740,17600,958844,962636,-3792
2693,81,287110,12800,960544,963537,-2993
2694,81,287353,20100,961594,964037,-2443
2695,84,287465,17450,966894,964282,2612
2696,86,287465,13050,964591,964737,-146
2697,80,287508,13250,966791,965787,1004
2698,83,287527,18550,966394,966386,8
2699,82,287692,16950,968441,967037,1404
2700,85,287870,19900,970141,967394,2747
2701,82,288037,14700,971644,967882,3762
2702,85,288507,15500,975141,968536,6605
2703,84,288587,18150,974994,969444,5550
2704,81,288611,15200,975691,969687,6004
2705,80,288765,16800,976144,970444,5700
2706,81,288946,20300,977941,971036,6905
2707,80,289064,18450,978941,971387,7554
2708,86,289099,20650,980091,972880,7211
2709,84,289190,16650,983344,973680,9664
2710,86,289196,20500,983341,975230,8111
2711,81,289348,15750,986994,977590,9404
2712,86,289398,21650,986991,979830,7161
2713,84,289474,17700,988044,980930,7114
2714,88,289665,15450,989094,982530,6564
2715,80,290045,18250,994444,984540,9904
2716,83,290074,18750,994491,987090,7401
2717,84,290128,20750,994944,988690,6254
2718,85,290142,17400,994441,989430,5011
2719,85,290479,15950,996094,990090,6004
2720,90,290482,18650,997644,991840,5804
2721,81,290655,15350,999341,992880,6461
2722,86,290786,13150,999841,994490,5351
2723,90,290851,17200,925389,995590,-70201
2724,87,291550,14650,926136,996640,-70504
2725,81,291658,10750,926897,997890,-70993
2726,87,291669,14000,927033,998330,-71297
2727,83,291858,16900,928189,999980,-71791
2728,80,291909,12500,928047,983986,-55939
2729,85,291925,14600,928683,984194,-55511
2730,86,292070,13250,929247,984736,-55489
2731,89,292105,13450,929747,985587,-55840
2732,82,292208,16150,930347,986386,-56039
2733,80,292283,15100,931039,986687,-55648
2734,84,292290,16450,932189,987386,-55197
2735,88,292330,17250,932547,988186,-55639
2736,90,292432,12750,933889,988736,-54847
2737,85,292531,12400,934483,988987,-54504
2738,82,292580,14550,934790,989432,-54642
2739,85,292633,12550,935989,990087,-54098
2740,83,292645,18200,935947,990736,-54789
2741,88,292750,16050,936489,990986,-54497
2742,83,293099,15550,937489,990737,-53248
2743,85,293407,17150,938040,992237,-54197
2744,84,293547,17700,939286,992894,-53608
2745,84,293566,12700,939533,993232,-53699
2746,87,293668,13700,941089,993636,-52547
2747,84,293691,15100,941183,994187,-53004
2748,85,293712,12350,940886,994686,-53800
2749,89,293908,14850,941683,995282,-53599
2750,87,294177,15500,942183,995544,-53361
2751,80,294311,11350,943647,995936,-52289
2752,84,294344,13950,943839,996487,-52648
2753,89,294384,19800,944090,996982,-52892
2754,89,294699,16550,944647,997244,-52597
2755,85,294736,14200,946286,997982,-51696
2756,80,294756,12750,945736,998844,-53108
2757,85,294770,14700,946483,999444,-52961
2758,86,294877,15550,947290,999786,-52496
2759,80,295001,15300,948033,999682,-51649
2760,85,295131,15800,950040,812129,137911
2761,83,295148,18350,950633,812734,137899
2762,88,295190,16550,950739,813225,137514
2763,81,295239,14100,950997,813775,137222
2764,82,295581,12400,951240,814275,136965
2765,83,295710,15000,953036,814638,138398
2766,85,295776,12400,954039,815034,139005
2767,86,295799,14650,953433,815375,138058
2768,84,295843,13300,954040,815684,138356
2769,85,296464,14250,955189,815975,139214
2770,80,296496,10950,955186,816475,138711
2771,84,296617,13050,955689,817184,138505
2772,86,296815,17000,957383,817788,139595
2773,85,296872,11700,957436,818288,139148
2774,86,296905,12100,957533,818529,139004
2775,83,296978,12050,958940,818788,140152
2776,81,297064,16350,958889,819029,139860
2777,82,297302,13550,959440,819784,139656
2778,90,297315,13400,960097,820386,139711
2779,86,297505,15250,960797,820986,139811
2780,81,297760,13250,961383,821392,139991
2781,82,297980,19950,962186,822275,139911
2782,86,298210,18000,963197,823375,139822
2783,81,298304,14500,963186,823825,139361
2784,83,298313,20350,963797,824692,139105
2785,84,298514,17750,964336,825034,139302
2786,81,298613,13250,964783,825375,139408
2787,90,298624,19900,965289,825725,139564
2788,87,298643,20100,966339,826425,139914
2789,90,298995,19400,968586,826975,141611
2790,87,299012,16100,968671,827484,141187
2791,80,299024,15850,968840,828025,140815
2792,83,299040,17050,969295,828192,141103
2793,81,299185,17450,970895,828388,142507
2794,89,299343,14850,971921,828938,142983
2795,80,299408,16050,973571,829634,143937
2796,89,299569,20050,974721,830342,144379
2797,84,299700,19700,976245,830842,145403
2798,84,299815,17150,976795,831086,145709
2799,88,300211,21500,978995,831942,147053
2800,82,300234,15850,980921,832586,148335
2801,88,300321,21700,981095,834042,147053
2802,80,300653,15450,984121,834425,149696
2803,83,300677,19700,984395,834786,149609
2804,81,300947,14750,985871,834984,150887
2805,86,301111,17750,991595,835336,156259
2806,80,301130,17500,990295,835825,154470
2807,83,301171,14000,992121,836584,155537
2808,89,301400,20700,992645,837134,155511
2809,84,301812,17200,996245,837842,158403
2810,80,301880,16600,997971,838529,159442
2811,86,301945,15950,998521,839234,159287
2812,85,302067,13850,999521,840075,159446
2813,89,302234,14300,999945,840434,159511
2814,85,302281,15150,982139,841186,140953
2815,85,302335,14700,982547,841779,140768
2816,89,302601,12550,985189,842336,142853
2817,82,302632,15900,983290,843125,140165
2818,82,302634,14750,984797,843886,140911
2819,85,302693,18250,984836,844675,140161
2820,85,302918,11750,985386,845225,140161
2821,80,303068,13200,986239,845936,140303
2822,82,303085,13400,986739,846284,140455
2823,89,303272,14800,987239,847179,140060
2824,85,303466,14850,988090,847788,140302
2825,85,303680,17050,989547,848375,141172
2826,88,303761,15800,990690,849086,141604
2827,83,303798,16150,990089,849879,140210
2828,80,303798,8500,990589,850136,140453
2829,86,303902,19900,992886,850488,142398
2830,88,304001,14000,992897,850736,142161
2831,82,304239,14250,994840,850988,143852
2832,81,304307,15750,994947,851479,143468
2833,88,304485,17200,997033,851975,145058
2834,90,304559,14350,997047,852579,144468
2835,82,304570,14150,996839,853025,143814
2836,86,304730,12700,997533,853584,143949
2837,80,304807,16650,998186,854279,143907
2838,88,304988,16450,998533,854525,144008
2839,81,305235,14350,999247,855025,144222
2840,88,305284,16800,999090,855736,143354
2841,85,305309,16600,999733,856125,143608
2842,83,305438,12350,999939,856429,143510
2843,86,305461,16450,999847,856788,143059
2844,89,305486,10850,999989,857184,142805
4633,82,495244,14800,975441,858125,117316
4634,81,495376,12450,976540,859086,117454
4634,81,495376,9650,976940,859629,117311
4634,81,495376,13600,977190,860129,117061
4634,81,495376,14550,977889,860825,117064
4634,81,495376,10450,978389,861229,117160
4634,81,495376,11550,978939,861884,117055
4634,81,495376,12850,979537,862625,116912
4634,81,495376,11350,980340,862929,117411
4635,84,495618,9300,980541,863579,116962
4635,84,495618,13500,981539,864325,117214
4635,84,495618,11500,982090,865325,116765
4635,84,495618,10650,983390,866386,117004
4635,84,495618,11900,983841,867188,116653
4635,84,495618,10000,983689,868288,115401
4635,84,495618,13650,984341,868975,115366
4635,84,495618,11400,986740,869636,117104
4635,84,495618,12400,987287,869929,117358
4635,84,495618,12850,987340,870638,116702
4636,89,495656,9050,987039,871134,115905
4636,89,495656,8600,987539,871736,115803
4636,89,495656,11250,988041,872688,115353
4636,89,495656,14900,988740,873229,115511
4636,89,495656,16050,989387,874134,115253
4636,89,495656,9350,989641,874379,115262
4636,89,495656,16250,990641,875138,115503
4636,89,495656,12700,992490,875529,116961
4636,89,495656,11600,991687,876284,115403
4636,89,495656,14350,992687,877179,115508
4637,84,495739,15000,994041,877836,116205
4637,84,495739,11750,994389,878386,116003
4637,84,495739,15500,995140,878834,116306
4637,84,495739,8550,995591,879229,116362
4637,84,495739,8450,996240,879684,116556
4637,84,495739,11700,996840,880288,116552
4637,84,495739,17250,997639,880686,116953
4637,84,495739,12600,997990,880975,117015
4637,84,495739,10100,998239,881736,116503
4637,84,495739,12300,999041,882229,116812
4637,84,495739,14600,999440,882938,116502
4637,84,495739,8900,999939,883675,116264
4637,84,495739,12200,999990,884329,115661
4637,84,495739,8150,861969,885275,-23306
4637,84,495739,8600,859319,886184,-26865
4636,89,495656,9750,862230,887088,-24858
4636,89,495656,9800,862569,887875,-25306
4637,84,495739,9650,865419,888375,-22956
4638,88,495901,10550,865430,888829,-23399
4638,88,495901,9100,866719,889525,-22806
4638,88,495901,11500,868269,890384,-22115
4638,88,495901,11400,873130,891279,-18149
4638,88,495901,11900,871080,891829,-20749
4638,88,495901,11100,872719,892538,-19819
4638,88,495901,11650,874919,893138,-18219
4638,88,495901,13300,875880,893784,-17904
4638,88,495901,10800,876880,894638,-17758
4638,88,495901,8600,879580,894979,-15399
4638,88,495901,12200,879719,895188,-15469
4639,81,495913,10000,881269,896075,-14806
4639,81,495913,13400,882330,896625,-14295
4639,81,495913,10800,885080,897125,-12045
4639,81,495913,14550,884669,897679,-13010
4639,81,495913,13900,886230,898279,-12049
4639,81,495913,13150,888369,898825,-10456
4639,81,495913,12950,889980,899138,-9158
4639,81,495913,8550,893381,899925,-6544
4639,81,495913,12500,893233,900929,-7696
4639,81,495913,11850,893881,901225,-7344
4639,81,495913,12150,894983,901629,-6646
4638,88,495901,14450,894981,902486,-7505
4638,88,495901,9100,897380,902884,-5504
4638,88,495901,12250,896533,903438,-6905
4640,80,496070,11900,897230,904038,-6808
4640,80,496070,12400,903430,904586,-1156
4640,80,496070,14100,899730,905629,-5899
4640,80,496070,12600,905030,906586,-1556
4640,80,496070,11950,905530,907236,-1706
4640,80,496070,12200,906180,907534,-1354
4640,80,496070,10450,905830,908234,-2404
4640,80,496070,10250,907180,908734,-1554
4640,80,496070,13750,909680,909525,155
4640,80,496070,11850,909430,909979,-549
4640,80,496070,13100,910980,910384,596
4641,80,496503,17450,915680,910738,4942
4641,80,496503,15050,915630,911136,4494
4641,80,496503,15600,918780,911484,7296
4641,80,496503,14350,922530,911838,10692
4641,80,496503,11300,922330,912388,9942
4641,80,496503,9600,926230,913136,13094
4641,80,496503,11850,926180,913829,12351
4641,80,496503,10900,928930,914379,14551
4641,80,496503,12650,927830,915034,12796
4641,80,496503,11250,929030,915529,13501
4641,80,496503,10250,931080,916286,14794
4641,80,496503,8550,931180,916684,14496
4641,80,496503,16800,936780,917629,19151
4641,80,496503,13200,936880,918175,18705
4642,80,496676,7550,935230,918779,16451
4642,80,496676,11500,938130,919429,18701
4642,80,496676,13050,938630,919834,18796
4642,80,496676,13450,940180,920334,19846
4642,80,496676,11500,941330,920884,20446
4642,80,496676,10500,943680,921338,22342
4642,80,496676,14050,944880,921934,22946
4642,80,496676,12650,944930,922179,22751
4642,80,496676,11300,946130,922436,23694
4642,80,496676,14000,950980,923379,27601
4642,80,496676,11100,948330,924029,24301
4642,80,496676,10950,951480,924529,26951
4642,80,496676,9750,949780,925284,24496
4642,80,496676,8150,950480,925879,24601
4642,80,496676,8050,951630,926184,25446
4642,80,496676,13800,952630,926825,25805
4643,84,496848,8400,953230,927234,25996
4643,84,496848,14800,954337,927875,26462
4643,84,496848,9000,954839,928584,26255
4643,84,496848,9600,956343,929236,27107
4643,84,496848,11550,956486,929786,26700
4643,84,496848,13150,956943,930279,26664
4643,84,496848,8450,956889,931538,25351
4644,87,496887,11850,958045,932434,25611
4644,87,496887,15600,958539,932879,25660
4644,87,496887,13300,958387,933436,24951
4644,87,496887,13300,958937,933879,25058
4644,87,496887,10200,959595,934536,25059
4644,87,496887,10350,959937,935586,24351
4644,87,496887,12050,960589,936234,24355
4644,87,496887,10200,961637,936734,24903
4644,87,496887,10500,961886,937479,24407
4645,86,496896,12100,963493,938236,25257
4645,86,496896,11300,963986,938736,25250
4645,86,496896,9300,964043,939634,24409
4645,86,496896,11700,965643,940179,25464
4645,86,496896,12950,966137,940679,25458
4645,86,496896,9300,965636,941438,24198
4645,86,496896,12050,966195,942284,23911
4645,86,496896,11450,967389,943125,24264
4645,86,496896,8950,967845,943979,23866
4645,86,496896,16700,968845,945086,23759
4645,86,496896,15900,971287,945979,25308
4645,86,496896,13600,971336,946838,24498
4646,90,496941,12750,971593,947284,24309
4646,90,496941,10700,971189,947775,23414
4646,90,496941,17050,972095,948236,23859
4646,90,496941,8450,972645,948488,24157
4646,90,496941,12650,975087,948988,26099
4646,90,496941,11150,973795,950236,23559
4646,90,496941,13700,975095,950786,24309
4646,90,496941,11850,974989,951229,23760
4646,90,496941,11600,975636,951538,24098
4646,90,496941,14300,976236,951925,24311
4646,90,496941,13000,977245,952638,24607
4646,90,496941,9800,977493,954084,23409
4646,90,496941,11500,978043,954479,23564
4646,90,496941,13200,978837,954238,24599
4646,90,496941,10800,979387,954838,24549
4643,84,496848,10250,980243,955284,24959
4644,87,496887,11800,980436,955529,24907
4647,88,497001,11750,980039,956025,24014
4647,88,497001,10100,982587,956388,26199
4647,88,497001,10200,982593,957034,25559
4647,88,497001,8200,982636,957534,25102
4647,88,497001,15050,982739,957829,24910
4647,88,497001,9200,983286,958329,24957
4647,88,497001,15050,983843,958936,24907
4647,88,497001,15300,984295,959734,24561
4647,88,497001,9550,984737,960438,24299
4647,88,497001,10500,985436,961234,24202
4647,88,497001,14400,987495,961784,25711
4647,88,497001,11600,986543,962425,24118
4647,88,497001,17400,987437,963136,24301
4646,90,496941,16450,987643,963784,23859
4646,90,496941,14700,988193,964686,23507
4648,89,497079,13450,988536,965236,23300
4648,89,497079,15150,989036,965384,23652
4648,89,497079,12400,989145,965884,23261
4648,89,497079,15500,990893,966384,24509
4648,89,497079,16200,990687,967179,23508
4647,88,497001,13800,991145,967888,23257
4649,90,497119,13850,991736,967984,23752
4649,90,497119,17750,992239,968988,23251
4649,90,497119,12050,992836,969475,23361
4649,90,497119,13450,993436,969879,23557
4649,90,497119,14400,994637,970188,24449
4649,90,497119,13350,994686,970836,23850
4649,90,497119,11750,995186,971486,23700
4649,90,497119,16600,995145,972479,22666
4650,82,497139,17100,998443,972686,25757
4650,82,497139,16950,998539,973475,25064
4650,82,497139,12250,998295,974134,24161
4650,82,497139,15200,998387,974775,23612
4650,82,497139,14000,999043,975825,23218
4650,82,497139,12650,999389,976286,23103
4650,82,497139,16050,999487,976875,22612
4650,82,497139,14400,999989,977286,22703
4650,82,497139,14550,999743,977988,21755
4650,82,497139,13450,969347,978525,-9178
4650,82,497139,10850,969030,979025,-9995
4651,85,497139,11300,970972,979538,-8566
4651,85,497139,12200,970397,979836,-9439
4651,85,497139,11900,971180,980588,-9408
4651,85,497139,13600,971780,981375,-9595
4651,85,497139,9000,972097,981738,-9641
4651,85,497139,13350,972622,981975,-9353
4651,85,497139,13100,973122,982679,-9557
4652,90,497142,12950,974380,982884,-8504
4652,90,497142,8250,974333,983636,-9303
4652,90,497142,10000,975597,984329,-8732
4652,90,497142,12350,975772,985034,-9262
4652,90,497142,10000,976197,985688,-9491
4652,90,497142,9250,976697,986325,-9628
4652,90,497142,13400,976881,986479,-9598
4652,90,497142,8700,977083,987238,-10155
4648,89,497079,12650,978133,987738,-9605
4649,90,497119,10150,978431,987536,-9105
4650,82,497139,13650,980530,988288,-7758
4650,82,497139,9500,980122,989175,-9053
4651,85,497139,13650,980581,989729,-9148
4652,90,497142,8050,980333,990436,-10103
4653,88,497242,11700,980347,990875,-10528
4653,88,497242,11500,981422,991388,-9966
4653,88,497242,10100,981681,991875,-10194
4653,88,497242,14850,983083,992179,-9096
4653,88,497242,11000,983331,992584,-9253
4653,88,497242,10900,983881,993075,-9194
4653,88,497242,12900,983931,993488,-9557
4653,88,497242,12200,984480,993929,-9449
4653,88,497242,10400,984633,994686,-10053
4653,88,497242,11900,985183,995425,-10242
4653,88,497242,9550,987281,995736,-8455
4653,88,497242,11200,987831,996125,-8294
4654,82,497458,12700,987147,997125,-9978
4654,82,497458,13300,988883,997836,-8953
4654,82,497458,11450,989072,998884,-9812
4654,82,497458,10000,988830,999386,-10556
4654,82,497458,13050,989330,999988,-10658
4654,82,497458,11550,990131,999925,-9794
4654,82,497458,8650,990697,988986,1711
4654,82,497458,12900,992483,989292,3191
4655,81,497530,16600,992480,989825,2655
4655,81,497530,8300,992983,990884,2099
4655,81,497530,10700,993547,991384,2163
4655,81,497530,10900,994081,991775,2306
4655,81,497530,12050,994683,992442,2241
4655,81,497530,12550,995681,992775,2906
4656,85,497547,13900,996447,993825,2622
4656,85,497547,12150,998447,995075,3372
4656,85,497547,10350,997872,995886,1986
4656,85,497547,12000,998580,996192,2388
4656,85,497547,14800,999581,996775,2806
4656,85,497547,12800,999922,997834,2088
4654,82,497458,10000,842330,998442,-156112
4654,82,497458,8350,840230,999025,-158795
4654,82,497458,7600,841830,999992,-158162
4655,81,497530,10350,843930,999925,-155995
4656,85,497547,8300,846680,918848,-72168
4656,85,497547,8050,847180,920998,-73818
4656,85,497547,9650,846180,922548,-76368
4657,84,497674,9750,848680,923785,-75105
4657,84,497674,4400,849280,926948,-77668
4657,84,497674,10450,851530,927998,-76468
4657,84,497674,6450,855430,930098,-74668
4657,84,497674,10100,854380,931298,-76918
4657,84,497674,6950,854930,933548,-78618
4657,84,497674,8000,860430,934185,-73755
4657,84,497674,6950,860780,935235,-74455
4657,84,497674,9150,860480,936435,-75955
4657,84,497674,9950,860980,937535,-76555
4657,84,497674,7600,863830,938598,-74768
4657,84,497674,8750,865480,940335,-74855
4658,80,497690,12900,865630,941835,-76205
4658,80,497690,7600,867880,943048,-75168
4658,80,497690,6650,870130,945135,-75005
4658,80,497690,7300,867880,947285,-79405
4658,80,497690,9450,869980,949598,-79618
4658,80,497690,5650,872430,951098,-78668
4658,80,497690,8400,872880,952535,-79655
4659,80,497747,10750,876530,953448,-76918
4659,80,497747,8850,876930,954685,-77755
4659,80,497747,9250,878130,956335,-78205
4659,80,497747,6800,879230,957935,-78705
4659,80,497747,8500,883780,960448,-76668
4659,80,497747,8000,884280,962598,-78318
4657,84,497674,8450,884180,963235,-79055
4657,84,497674,7200,885380,965098,-79718
4658,80,497690,10700,884130,965598,-81468
4658,80,497690,9700,885880,966535,-80655
4658,80,497690,9850,886980,968448,-81468
4660,85,497906,5350,888530,969385,-80855
4660,85,497906,6850,890130,971935,-81805
4660,85,497906,7450,891880,973198,-81318
4660,85,497906,7250,892930,974848,-81918
4660,85,497906,8400,894580,976835,-82255
4660,85,497906,4900,895530,977998,-82468
4660,85,497906,8800,895680,979535,-83855
4660,85,497906,6600,897230,980585,-83355
4660,85,497906,8550,896830,982698,-85868
4660,85,497906,9050,897930,984198,-86268
4661,89,497915,6150,899280,986085,-86805
4661,89,497915,7150,899530,987398,-87868
4661,89,497915,10300,903930,988085,-84155
4661,89,497915,6350,905430,989648,-84218
4661,89,497915,10500,905180,991398,-86218
4661,89,497915,9150,903430,992885,-89455
4661,89,497915,7850,905680,994048,-88368
4660,85,497906,10250,907230,995398,-88168
4661,89,497915,10650,908880,998485,-89605
4661,89,497915,10700,910580,999248,-88668
4661,89,497915,10700,911630,999798,-88168
4661,89,497915,8100,912980,828883,84097
4662,80,498066,7050,914180,828936,85244
4662,80,498066,9200,919280,829538,89742
4662,80,498066,9800,917980,829986,87994
4662,80,498066,6650,919230,830690,88540
4662,80,498066,9700,920280,831233,89047
4662,80,498066,8750,921830,831586,90244
4662,80,498066,9400,923830,832038,91792
4662,80,498066,10200,924430,832934,91496
4662,80,498066,12750,929430,833434,95996
4663,84,498185,11850,929630,834240,95390
4663,84,498185,8400,931580,835286,96294
4663,84,498185,13300,931830,835886,95944
4663,84,498185,14100,936330,836486,99844
4663,84,498185,8200,936830,837184,99646
4663,84,498185,11050,936030,837990,98040
4663,84,498185,8850,938330,838334,99996
4663,84,498185,8550,941030,838888,102142
4663,84,498185,6650,940980,839540,101440
4664,83,498371,12300,942730,839886,102844
4664,83,498371,9350,944330,840190,104140
4664,83,498371,6600,945830,840683,105147
4664,83,498371,8450,948080,841284,106796
4664,83,498371,6100,947880,841733,106147
4664,83,498371,7900,949080,842038,107042
4664,83,498371,9650,951280,842390,108890
4664,83,498371,7600,951730,842940,108790
4664,83,498371,7950,952930,843134,109796
4664,83,498371,9850,954430,843784,110646
4665,89,498412,8900,956230,844784,111446
4665,89,498412,6000,957430,845033,112397
4665,89,498412,11000,963180,845238,117942
4665,89,498412,8150,963730,845786,117944
4665,89,498412,8650,964280,846233,118047
4665,89,498412,9650,964030,846940,117090
4665,89,498412,6150,964530,847184,117346
4665,89,498412,12000,965380,847734,117646
4664,83,498371,10150,966730,848436,118294
4665,89,498412,9050,970380,848986,121394
4665,89,498412,9350,970480,849784,120696
4665,89,498412,7750,971580,850238,121342
4666,87,498610,11200,974630,850384,124246
4666,87,498610,10150,977230,851033,126197
4666,87,498610,7600,978630,851533,127097
4666,87,498610,6950,980030,851986,128044
4666,87,498610,8000,979930,852240,127690
4666,87,498610,8900,981680,853036,128644
4666,87,498610,8950,982880,853938,128942
4666,87,498610,9500,984480,854433,130047
4666,87,498610,13100,989380,855040,134340
4666,87,498610,8700,989730,855238,134492
4666,87,498610,9150,991480,855738,135742
4667,82,498660,4900,991980,856090,135890
4667,82,498660,7000,996530,856238,140292
4667,82,498660,5500,996680,857083,139597
4667,82,498660,10550,996880,857584,139296
4667,82,498660,11550,999980,857938,142042
4667,82,498660,8750,999630,858488,141142
4667,82,498660,7000,834380,859490,-25110
4667,82,498660,6750,834430,860436,-26006
4667,82,498660,6650,834880,860884,-26004
4666,87,498610,6100,839330,861884,-22554
4666,87,498610,6000,837880,862934,-25054
4666,87,498610,6050,841630,863288,-21658
4667,82,498660,4850,841480,863934,-22454
4667,82,498660,5000,843780,864288,-20508
4668,80,498923,3800,844130,864486,-20356
4668,80,498923,7250,847730,865086,-17356
4668,80,498923,6250,848230,865434,-17204
4668,80,498923,5350,847930,865640,-17710
4668,80,498923,6150,850980,866636,-15656
4668,80,498923,4650,850480,867083,-16603
4668,80,498923,4200,852230,867786,-15556
4668,80,498923,7250,853430,868584,-15154
4668,80,498923,3450,854030,868733,-14703
4668,80,498923,6650,855580,869140,-13560
4668,80,498923,6950,858280,869783,-11503
4668,80,498923,6100,857780,870588,-12808
4668,80,498923,6350,859380,870936,-11556
4668,80,498923,6550,861480,871890,-10410
4669,82,499056,5050,862480,872383,-9903
4669,82,499056,5750,864830,872486,-7656
4669,82,499056,3950,865180,873036,-7856
4669,82,499056,4250,864930,873334,-8404
4669,82,499056,7350,866480,874036,-7556
4669,82,499056,6100,869980,874340,-4360
4669,82,499056,6500,871680,875083,-3403
4669,82,499056,7100,871730,875536,-3806
4669,82,499056,6550,871180,876086,-4906
4669,82,499056,6600,873830,876888,-3058
4669,82,499056,6050,874930,877490,-2560
4669,82,499056,3050,875230,877934,-2704
4670,90,499204,8550,879680,878733,947
4670,90,499204,3900,878480,879086,-606
4670,90,499204,5100,879730,879434,296
4670,90,499204,4950,881680,880088,1592
4670,90,499204,5300,883680,880636,3044
4670,90,499204,5300,885630,881186,4444
4670,90,499204,4850,885980,881433,4547
4671,90,499255,7550,888980,882088,6892
4671,90,499255,5700,889130,882588,6542
4671,90,499255,7100,891730,883034,8696
4671,90,499255,7350,891080,883688,7392
4670,90,499204,4150,892680,884433,8247
4672,89,499336,7550,894430,885183,9247
4672,89,499336,4000,894980,885636,9344
4672,89,499336,6000,896680,885438,11242
4672,89,499336,3800,897980,886438,11542
4672,89,499336,9050,902180,886836,15344
4672,89,499336,6400,902180,887734,14446
4672,89,499336,6550,903830,888090,15740
4672,89,499336,8150,907930,889036,18894
4672,89,499336,7400,907330,889638,17692
4671,90,499255,7350,909780,890036,19744
4671,90,499255,4300,909130,890334,18796
4672,89,499336,1950,909680,890536,19144
4672,89,499336,5900,912380,891033,21347
4673,90,499474,7500,912530,891384,21146
4673,90,499474,5500,914480,891736,22744
4673,90,499474,4600,917430,892640,24790
4673,90,499474,7250,919680,893236,26444
4673,90,499474,7050,919580,893733,25847
4673,90,499474,4600,920230,893936,26294
4673,90,499474,6450,925130,894538,30592
4673,90,499474,6600,925180,894984,30196
4673,90,499474,7650,927980,895736,32244
4673,90,499474,5350,926980,895888,31092
4673,90,499474,6050,928080,896736,31344
4674,90,499534,6450,930830,897383,33447
4674,90,499534,5400,930680,897836,32844
4674,90,499534,7650,933480,898434,35046
4674,90,499534,5150,935030,899083,35947
4674,90,499534,7650,937730,899583,38147
4674,90,499534,5450,938430,900484,37946
4674,90,499534,4700,939280,901240,38040
4675,87,499630,7200,941330,901833,39497
4675,87,499630,8400,943430,902383,41047
4675,87,499630,9450,946480,902638,43842
4675,87,499630,7650,948080,903486,44594
4675,87,499630,6700,949230,903633,45597
4675,87,499630,6050,951930,904133,47797
4675,87,499630,5550,952280,904636,47644
4675,87,499630,4600,952430,905236,47194
4675,87,499630,6600,954480,905683,48797
4675,87,499630,4950,958280,905984,52296
4675,87,499630,5200,957780,906936,50844
4675,87,499630,7300,960330,907983,52347
4675,87,499630,4850,960230,908586,51644
4676,88,499893,6100,962730,909534,53196
4676,88,499893,5050,963080,910033,53047
4676,88,499893,7650,965730,910188,55542
4676,88,499893,3600,964680,911183,53497
4676,88,499893,5050,966880,911840,55040
4676,88,499893,7000,968930,912684,56246
4676,88,499893,4400,970480,913184,57296
4676,88,499893,5950,971580,913886,57694
4677,86,499926,5350,973830,914436,59394
4677,86,499926,5600,974130,914933,59197
4677,86,499926,3800,975280,915486,59794
4677,86,499926,9100,976980,916036,60944
4677,86,499926,4950,980730,916683,64047
4677,86,499926,6050,983280,917036,66244
4678,83,500005,9050,985630,917290,68340
4678,83,500005,4500,981280,918084,63196
4678,83,500005,8050,982780,918840,63940
4678,83,500005,7300,984380,919186,65194
4678,83,500005,4150,986080,919684,66396
4678,83,500005,7850,992480,920490,71990
4678,83,500005,9350,992930,920884,72046
4678,83,500005,8600,993430,921738,71692
4678,83,500005,5250,994530,922140,72390
4678,83,500005,2150,994630,922640,71990
4678,83,500005,7000,994580,923383,71197
4678,83,500005,6750,998980,924338,74642
4678,83,500005,6850,998480,925186,73294
4677,86,499926,5300,999980,925988,73992
4678,83,500005,3250,854569,926336,-71767
4679,86,500121,4450,856769,926533,-69764
4679,86,500121,1750,857366,926838,-69472
4679,86,500121,4650,861116,927940,-66824
4679,86,500121,5350,865416,928440,-63024
4679,86,500121,3850,865966,929038,-63072
4679,86,500121,3600,864619,930088,-65469
4679,86,500121,1700,866219,930586,-64367
4679,86,500121,4350,868369,931440,-63071
4679,86,500121,4800,873166,931838,-58672
4679,86,500121,3250,873669,932540,-58871
4679,86,500121,3450,875916,933134,-57218
4680,87,500171,4850,875869,933336,-57467
4680,87,500171,2800,877466,933888,-56422
4680,87,500171,2750,878619,934740,-56121
4680,87,500171,1450,881019,935184,-54165
4680,87,500171,1900,881519,936088,-54569
4680,87,500171,2650,881116,936638,-55522
4680,87,500171,5750,884266,937186,-52920
4681,84,500209,1150,884719,937490,-52771
4681,84,500209,3150,885866,938034,-52168
4681,84,500209,3550,887569,938438,-50869
4681,84,500209,2900,889719,938836,-49117
4681,84,500209,2700,895066,939333,-44267
4679,86,500121,2350,895319,939988,-44669
4679,86,500121,4300,895819,940833,-45014
4680,87,500171,3250,896066,941290,-45224
4681,84,500209,4000,896566,941638,-45072
4682,81,500587,1950,897569,942086,-44517
4682,81,500587,2850,899869,942738,-42869
4682,81,500587,2250,899566,943034,-43468
4682,81,500587,2350,902866,943736,-40870
4682,81,500587,4650,903019,944286,-41267
4682,81,500587,2200,904716,945133,-40417
4682,81,500587,3350,905219,945538,-40319
4682,81,500587,3150,906769,945833,-39064
4683,82,500682,2150,907819,946588,-38769
4683,82,500682,2300,908919,947040,-38121
4683,82,500682,4150,910566,947183,-36617
4683,82,500682,4400,912719,946838,-34119
4683,82,500682,3200,914219,947636,-33417
4683,82,500682,4800,916419,947783,-31364
4683,82,500682,3950,918866,948438,-29572
4683,82,500682,2200,918719,948790,-30071
4683,82,500682,2950,921616,949440,-27824
4684,85,500690,4600,922469,950038,-27569
4684,85,500690,4150,924119,950733,-26614
4684,85,500690,2800,927066,951040,-23974
4684,85,500690,3500,926919,951688,-24769
4684,85,500690,1800,928019,952040,-24021
4684,85,500690,3300,929269,952690,-23421
4684,85,500690,1150,929819,953240,-23421
4685,87,500696,2300,931019,953884,-22865
4685,87,500696,2500,932216,954436,-22220
4685,87,500696,5300,936416,954988,-18572
4685,87,500696,2300,935719,955586,-19867
4685,87,500696,1450,936369,956083,-19714
4685,87,500696,2250,937566,956188,-18622
4685,87,500696,4800,940719,957590,-16871
4685,87,500696,2650,941166,958233,-17067
4686,83,500731,2350,942216,958590,-16374
4686,83,500731,3700,944069,958834,-14765
4686,83,500731,2950,948116,959586,-11470
4686,83,500731,4250,946916,960233,-13317
4686,83,500731,1400,947719,960783,-13064
4686,83,500731,3350,949366,961584,-12218
4684,85,500690,2250,950519,961883,-11364
4684,85,500690,1850,952716,962336,-9620
4684,85,500690,3350,952919,962883,-9964
4684,85,500690,1600,953266,963188,-9922
4684,85,500690,2650,954266,964036,-9770
4685,87,500696,4450,956566,964538,-7972
4685,87,500696,2300,958366,965136,-6770
4686,83,500731,2700,958819,965684,-6865
4686,83,500731,3250,960016,966286,-6270
4687,87,500941,2650,961516,966936,-5420
4687,87,500941,3350,964766,967583,-2817
4687,87,500941,5200,965266,968188,-2922
4687,87,500941,3300,967019,968683,-1664
4687,87,500941,1800,967166,969240,-2074
4687,87,500941,4300,969219,969738,-519
4687,87,500941,1900,970266,970390,-124
4687,87,500941,4700,972266,970884,1382
4687,87,500941,2700,973466,971490,1976
4687,87,500941,2950,974819,972040,2779
4688,88,500997,2400,975969,973040,2929
4688,88,500997,3250,977566,973884,3682
4688,88,500997,2050,978169,974386,3783
4688,88,500997,3750,979766,974886,4880
4688,88,500997,3750,982419,975333,7086
4688,88,500997,3500,982969,975838,7131
4688,88,500997,6200,986069,976383,9686
4688,88,500997,3000,989969,976690,13279
4688,88,500997,4200,989369,977383,11986
4688,88,500997,2400,991319,977988,13331
4688,88,500997,3050,994866,978340,16526
4688,88,500997,2750,992469,978840,13629
4687,87,500941,4250,994366,979638,14728
4689,90,501242,3200,998219,980283,17936
4689,90,501242,4000,997866,980783,17083
4689,90,501242,4200,999916,981783,18133
4689,90,501242,500,802030,982336,-180306
4689,90,501242,50,801880,982833,-180953
4689,90,501242,500,802380,983240,-180860
4689,90,501242,50,802080,983388,-181308
4689,90,501242,50,802130,984483,-182353
4689,90,501242,50,802180,984986,-182806
4689,90,501242,50,802230,985840,-183610
4689,90,501242,50,802280,985986,-183706
4689,90,501242,500,802780,986434,-183654
4689,90,501242,50,802430,987084,-184654
4689,90,501242,50,802480,987683,-185203
4690,88,501435,500,802980,987886,-184906
4690,88,501435,50,802830,988334,-185504
4690,88,501435,500,803330,988884,-185554
4690,88,501435,50,803030,989140,-186110
4690,88,501435,50,803080,989934,-186854
4690,88,501435,500,803580,990586,-187006
4690,88,501435,50,803380,991090,-187710
4691,85,501604,500,803880,992136,-188256
4691,85,501604,500,804080,992686,-188606
4691,85,501604,50,803930,993684,-189754
4691,85,501604,50,803980,994240,-190260
4691,85,501604,500,804480,994740,-190260
4691,85,501604,500,804580,995734,-191154
4691,85,501604,50,804530,995988,-191458
4691,85,501604,50,804580,996940,-192360
4691,85,501604,500,805080,997536,-192456
4691,85,501604,500,805080,998086,-193006
4691,85,501604,50,805130,998538,-193408
4691,85,501604,500,805580,999340,-193760
4691,85,501604,50,805180,999933,-194753
4691,85,501604,500,805680,999986,-194306
4692,88,501725,500,806080,926994,-120914
4692,88,501725,500,806180,928974,-122794
4692,88,501725,500,806580,930694,-124114
4692,88,501725,50,806230,931294,-125064
4692,88,501725,50,806280,932444,-126164
4692,88,501725,500,806780,933224,-126444
4692,88,501725,500,807080,935324,-128244
4692,88,501725,500,807280,936494,-129214
4692,88,501725,500,807580,937644,-130064
4692,88,501725,500,807780,939194,-131414
4692,88,501725,500,808080,940374,-132294
4692,88,501725,50,807830,942374,-134544
4692,88,501725,50,807880,943424,-135544
4693,82,501877,50,807930,944574,-136644
4693,82,501877,500,808430,946594,-138164
4693,82,501877,500,808580,947174,-138594
4693,82,501877,50,808480,949874,-141394
4693,82,501877,50,808530,950474,-141944
4693,82,501877,50,808580,952724,-144144
4693,82,501877,50,808630,954324,-145694
4693,82,501877,500,809080,956424,-147344
4693,82,501877,500,809130,957524,-148394
4694,86,501942,50,809130,959344,-150214
4694,86,501942,50,809180,960824,-151644
4694,86,501942,50,809180,962644,-153464
4694,86,501942,500,809680,963844,-154164
4694,86,501942,50,809230,965344,-156114
4694,86,501942,50,809280,966324,-157044
4694,86,501942,500,809780,967444,-157664
4694,86,501942,50,809730,968044,-158314
4694,86,501942,500,810230,970124,-159894
4694,86,501942,500,810280,970694,-160414
4694,86,501942,500,810730,971024,-160294
4694,86,501942,50,810330,971624,-161294
4693,82,501877,50,810380,973274,-162894
4695,81,502131,500,810880,975544,-164664
4695,81,502131,500,811230,976474,-165244
4695,81,502131,50,810930,977974,-167044
4695,81,502131,500,811430,979794,-168364
4695,81,502131,50,811280,981344,-170064
4695,81,502131,500,811780,983524,-171744
4695,81,502131,50,811480,984694,-173214
4695,81,502131,500,811980,985774,-173794
4695,81,502131,50,811830,986874,-175044
4695,81,502131,500,812330,988524,-176194
4695,81,502131,500,812480,990074,-177594
4696,87,502141,50,812380,990674,-178294
4696,87,502141,500,812880,992224,-179344
4696,87,502141,50,812530,993274,-180744
4696,87,502141,50,812580,993894,-181314
4696,87,502141,500,813080,995494,-182414
4696,87,502141,50,812930,996494,-183564
4696,87,502141,500,813430,998144,-184714
4696,87,502141,50,813130,999244,-186114
4696,87,502141,50,813180,999844,-186664
4696,87,502141,500,813680,925781,-112101
4696,87,502141,50,813480,927832,-114352
4696,87,502141,50,813530,928682,-115152
4696,87,502141,500,814030,930431,-116401
4697,81,502190,50,813730,931732,-118002
4697,81,502190,50,813780,933282,-119502
4697,81,502190,500,814280,934382,-120102
4697,81,502190,500,814530,935932,-121402
4697,81,502190,500,814780,937031,-122251
4697,81,502190,50,814580,937682,-123102
4697,81,502190,500,815080,939581,-124501
4697,81,502190,500,815280,941082,-125802
4697,81,502190,50,815130,941281,-126151
4695,81,502131,50,815180,942681,-127501
4695,81,502131,500,815680,944082,-128402
4696,87,502141,500,815780,944782,-129002
4696,87,502141,50,815730,945531,-129801
4697,81,502190,500,816230,946982,-130752
4698,80,502455,500,816280,947731,-131451
4698,80,502455,50,816280,948481,-132201
4698,80,502455,50,816330,949732,-133402
4698,80,502455,500,816780,951081,-134301
4698,80,502455,50,816380,953731,-137351
4698,80,502455,500,816880,954432,-137552
4698,80,502455,50,816830,956632,-139802
4698,80,502455,500,817330,958332,-141002
4698,80,502455,50,816930,959382,-142452
4698,80,502455,500,817430,960582,-143152
4698,80,502455,500,817830,961732,-143902
4698,80,502455,50,817480,963732,-146252
4698,80,502455,500,817980,965181,-147201
4698,80,502455,50,817880,966331,-148451
4699,89,502525,500,818380,968131,-149751
4699,89,502525,50,818030,969131,-151101
4699,89,502525,500,818530,970332,-151802
4699,89,502525,50,818430,972882,-154452
4699,89,502525,500,818930,973131,-154201
4699,89,502525,50,818580,975231,-156651
4699,89,502525,500,819080,976731,-157651
4699,89,502525,50,818980,978632,-159652
4698,80,502455,500,819480,979632,-160152
4699,89,502525,50,819130,980832,-161702
4700,83,502710,500,819630,982982,-163352
4700,83,502710,500,819980,984631,-164651
4700,83,502710,50,819680,985231,-165551
4700,83,502710,500,820180,986781,-166601
4700,83,502710,50,820030,987832,-167802
4700,83,502710,500,820530,989031,-168501
4700,83,502710,500,820680,989681,-169001
4700,83,502710,50,820580,990931,-170351
4700,83,502710,500,821080,991982,-170902
4701,85,502837,50,820730,993331,-172601
4701,85,502837,50,820780,994882,-174102
4701,85,502837,500,821280,996031,-174751
4701,85,502837,500,821580,998581,-177001
4701,85,502837,50,821330,999681,-178351
4701,85,502837,500,821830,999781,-177951
4701,85,502837,500,822080,938130,-116050
4701,85,502837,500,822330,940630,-118300
4701,85,502837,500,822580,941980,-119400
4701,85,502837,50,822380,943830,-121450
4702,80,503002,50,822430,944830,-122400
4702,80,503002,50,822480,946180,-123700
4702,80,503002,50,822530,947030,-124500
4702,80,503002,500,823030,947830,-124800
4702,80,503002,500,823080,949380,-126300
4702,80,503002,50,823080,950430,-127350
4702,80,503002,500,823580,952330,-128750
4702,80,503002,500,823580,953780,-130200
4702,80,503002,50,823630,955380,-131750
4703,86,503013,500,824080,956980,-132900
4703,86,503013,500,824130,958130,-134000
4703,86,503013,500,824580,959880,-135300
4703,86,503013,500,824630,960530,-135900
4703,86,503013,500,825080,962230,-137150
4703,86,503013,500,825130,963480,-138350
4703,86,503013,500,825580,964380,-138800
4704,89,503093,500,825630,967330,-141700
4704,89,503093,50,825630,969530,-143900
4704,89,503093,50,825680,971180,-145500
4704,89,503093,500,826130,972080,-145950
4704,89,503093,3150,825730,973730,-148000
4704,89,503093,800,826230,975830,-149600
4704,89,503093,1950,826180,976930,-150750
4704,89,503093,2200,826680,977680,-151000
4704,89,503093,2800,826730,980480,-153750
4704,89,503093,4300,826730,982080,-155350
4704,89,503093,1900,826780,983130,-156350
4704,89,503093,2050,827230,984680,-157450
4704,89,503093,1850,827280,985830,-158550
4705,80,503098,2200,827280,987230,-159950
4705,80,503098,4300,827330,988930,-161600
4705,80,503098,2150,827780,989930,-162150
4705,80,503098,4300,827830,991530,-163700
4705,80,503098,2750,827830,993280,-165450
4705,80,503098,1850,827880,994680,-166800
4703,86,503013,1600,828330,997630,-169300
4703,86,503013,3200,828380,999280,-170900
4706,81,503133,2450,828380,999930,-171550
4706,81,503133,4150,828880,627130,201750
4706,81,503133,2650,828880,629380,199500
4706,81,503133,3700,829380,630930,198450
4706,81,503133,2950,828930,632580,196350
4706,81,503133,3350,828980,633180,195800
4706,81,503133,3300,829030,634580,194450
4706,81,503133,3400,829080,636030,193050
4706,81,503133,3300,829130,637130,192000
4707,86,503156,2900,829630,638730,190900
4707,86,503156,4700,829880,640430,189450
4707,86,503156,3850,830130,642130,188000
4707,86,503156,1800,830380,643680,186700
4707,86,503156,4300,830630,645330,185300
4707,86,503156,4250,830430,647180,183250
4707,86,503156,6300,830930,648730,182200
4707,86,503156,3050,830680,650130,180550
4707,86,503156,4800,830730,650980,179750
4707,86,503156,2750,830780,652830,177950
4707,86,503156,6450,831280,653880,177400
4707,86,503156,3600,831430,655430,176000
4704,89,503093,1750,831780,657130,174650
4704,89,503093,4700,831930,659130,172800
4708,85,503203,3200,832280,660230,172050
4708,85,503203,2350,831980,660430,171550
4708,85,503203,4450,832030,662930,169100
4708,85,503203,3750,832530,663830,168700
4708,85,503203,2850,832780,665580,167200
4708,85,503203,2900,832580,667130,165450
4708,85,503203,3600,833080,668730,164350
4706,81,503133,1350,833280,669280,164000
4706,81,503133,4300,833130,670280,162850
4709,82,503243,6250,833180,671080,162100
4709,82,503243,1850,833230,673130,160100
4709,82,503243,4350,833280,674130,159150
4709,82,503243,3400,833780,675330,158450
4709,82,503243,2350,833330,676630,156700
4709,82,503243,4150,833830,678030,155800
4709,82,503243,5450,834280,680380,153900
4709,82,503243,2350,833880,681930,151950
4709,82,503243,3850,833930,682430,151500
4709,82,503243,3800,834430,683580,150850
4709,82,503243,3800,834330,684780,149550
4707,86,503156,2250,834380,686030,148350
4707,86,503156,2150,834430,687180,147250
4710,80,503336,750,834480,688180,146300
4710,80,503336,3450,834480,689430,145050
4710,80,503336,3400,834980,690530,144450
4710,80,503336,5650,834980,691580,143400
4710,80,503336,4300,835480,692130,143350
4710,80,503336,2800,835480,694080,141400
4710,80,503336,3350,835980,695280,140700
4710,80,503336,1700,835980,696080,139900
4710,80,503336,1950,836480,697680,138800
4710,80,503336,4250,836480,698880,137600
4710,80,503336,1850,836530,699930,136600
4709,82,503243,3900,836530,701030,135500
4709,82,503243,2950,837030,702480,134550
4710,80,503336,2250,836580,702680,133900
4711,83,503560,3700,836630,704280,132350
4711,83,503560,4050,836680,705780,130900
4711,83,503560,4200,837180,707530,129650
4711,83,503560,3850,837080,709080,128000
4711,83,503560,2450,837130,709380,127750
4711,83,503560,1250,837180,710330,126850
4711,83,503560,2750,837230,711980,125250
4711,83,503560,3350,837230,713380,123850
4711,83,503560,3700,837280,714930,122350
4711,83,503560,3200,837280,716480,120800
4711,83,503560,1800,837330,718080,119250
4712,84,503566,4900,837330,719430,117900
4712,84,503566,4400,837380,720380,117000
4712,84,503566,2200,837830,722630,115200
4712,84,503566,4300,837880,724430,113450
4712,84,503566,3350,838330,726030,112300
4712,84,503566,1750,837930,726880,111050
4712,84,503566,5050,838430,728630,109800
4712,84,503566,4900,838830,730430,108400
4712,84,503566,3800,838480,731980,106500
4712,84,503566,3150,838530,734080,104450
4712,84,503566,1300,838580,736080,102500
4712,84,503566,2350,839080,737030,102050
4712,84,503566,3900,839330,738830,100500
4712,84,503566,2800,839580,740280,99300
4713,82,503576,4250,839830,744180,95650
4713,82,503576,2300,839630,745230,94400
4713,82,503576,2650,839680,745580,94100
4713,82,503576,3800,840180,747080,93100
4713,82,503576,4350,840330,748180,92150
4712,84,503566,1850,840230,749780,90450
4712,84,503566,4350,840730,750930,89800
4712,84,503566,5300,840380,753080,87300
4713,82,503576,4700,840430,755580,84850
4714,80,503866,2300,840480,758630,81850
4714,80,503866,4050,840980,759680,81300
4714,80,503866,2850,840780,760930,79850
4714,80,503866,800,840830,763030,77800
4714,80,503866,1650,841330,765180,76150
4714,80,503866,2250,841030,766630,74400
4714,80,503866,4300,841530,767730,73800
4714,80,503866,1850,841830,769230,72600
4714,80,503866,1750,841580,770030,71550
4714,80,503866,2200,842080,771930,70150
4714,80,503866,2550,841880,773580,68300
4715,88,503868,4350,841930,775130,66800
4715,88,503868,2800,842430,777830,64600
4715,88,503868,1600,842130,779480,62650
4715,88,503868,3100,842630,780680,61950
4715,88,503868,2350,842480,783380,59100
4715,88,503868,3450,842980,785430,57550
4715,88,503868,3350,842680,786580,56100
4715,88,503868,2250,843180,787130,56050
4715,88,503868,4000,843030,788530,54500
4715,88,503868,2150,843080,788830,54250
4715,88,503868,2700,843580,789880,53700
4715,88,503868,3850,843680,790880,52800
4715,88,503868,2200,844080,793030,51050
4716,89,503878,2850,843730,794180,49550
4716,89,503878,2800,844230,795830,48400
4716,89,503878,1700,844130,797930,46200
4716,89,503878,1750,844630,799530,45100
4716,89,503878,3350,844730,800530,44200
4716,89,503878,5200,845130,802530,42600
4716,89,503878,3900,845230,803530,41700
4716,89,503878,3350,845180,804630,40550
4716,89,503878,3200,845680,806680,39000
4716,89,503878,2650,845730,808830,36900
4716,89,503878,4700,846180,810080,36100
4716,89,503878,2800,845780,811180,34600
4716,89,503878,1900,845830,811380,34450
4716,89,503878,2300,845880,813030,32850
4714,80,503866,2800,845930,814780,31150
4715,88,503868,3900,845980,816330,29650
4717,89,504031,3850,846030,817880,28150
4717,89,504031,3300,846530,819780,26750
4717,89,504031,3400,846230,820280,25950
4717,89,504031,1800,846280,822680,23600
4717,89,504031,1200,846330,823780,22550
4717,89,504031,1800,846830,825430,21400
4717,89,504031,3750,846580,826930,19650
4717,89,504031,2650,846630,828980,17650
4717,89,504031,2050,846680,829830,16850
4717,89,504031,4100,847180,831730,15450
4718,85,504318,2900,847330,833130,14200
4718,85,504318,1900,847230,834830,12400
4718,85,504318,5400,847280,836230,11050
4718,85,504318,3000,847780,838330,9450
4718,85,504318,4150,847380,840030,7350
4719,88,504346,3250,847880,841930,5950
4719,88,504346,3750,848280,843930,4350
4719,88,504346,2900,848380,845230,3150
4719,88,504346,4350,848780,846680,2100
4719,88,504346,4750,848430,848730,-300
4719,88,504346,1950,848480,850530,-2050
4719,88,504346,2750,848980,852480,-3500
4719,88,504346,750,848830,854430,-5600
4720,83,504410,3150,848880,856180,-7300
4720,83,504410,3950,848930,857230,-8300
4720,83,504410,850,848980,857930,-8950
4720,83,504410,3950,849030,860080,-11050
4720,83,504410,2750,849480,861180,-11700
4720,83,504410,1650,849530,861730,-12200
4720,83,504410,3750,849980,863430,-13450
4720,83,504410,2700,850030,864530,-14500
4720,83,504410,1700,850480,866180,-15700
4720,83,504410,1650,850530,867280,-16750
4720,83,504410,1650,850980,868280,-17300
4720,83,504410,3350,851030,870330,-19300
4720,83,504410,1650,851030,870980,-19950
4718,85,504318,1950,851080,872030,-20950
4718,85,504318,3900,851080,873030,-21950
4719,88,504346,6900,851130,874280,-23150
4719,88,504346,3450,851130,875880,-24750
4721,88,504517,2650,851630,876838,-25208
4721,88,504517,2400,852891,877392,-24501
4721,88,504517,2800,852176,877942,-25766
4721,88,504517,2250,853226,878636,-25410
4721,88,504517,1800,857141,879185,-22044
4722,86,504769,3250,857176,879888,-22712
4722,86,504769,5750,858176,880688,-22512
4722,86,504769,3900,859876,881386,-21510
4722,86,504769,4450,862126,881988,-19862
4722,86,504769,2800,863226,882892,-19666
4722,86,504769,3650,864791,883942,-19151
4722,86,504769,2450,867226,884238,-17012
4722,86,504769,3900,867691,884588,-16897
4722,86,504769,3650,870241,885142,-14901
4722,86,504769,3200,870526,885738,-15212
4723,83,504857,3300,872076,886238,-14162
4723,83,504857,4300,874041,887035,-12994
4723,83,504857,3700,876576,887442,-10866
4723,83,504857,2800,876741,888185,-11444
4723,83,504857,4800,878891,888488,-9597
4723,83,504857,6800,881976,889038,-7062
4723,83,504857,2800,883576,889538,-5962
4723,83,504857,1600,887341,890138,-2797
4723,83,504857,5700,887841,890638,-2797
4724,85,504865,2300,887776,890835,-3059
4724,85,504865,3400,889526,891738,-2212
4724,85,504865,2200,890241,892288,-2047
4724,85,504865,2450,891341,892586,-1245
4724,85,504865,3200,892941,893438,-497
4724,85,504865,1700,895241,893988,1253
4724,85,504865,3250,894976,894492,484
4724,85,504865,1400,897226,894992,2234
4724,85,504865,3500,897726,895492,2234
4724,85,504865,4750,899841,896436,3405
4725,90,504868,4750,902026,897435,4591
4725,90,504868,3900,905576,897586,7990
4725,90,504868,450,903876,898138,5738
4725,90,504868,3800,905941,899186,6755
4725,90,504868,3550,908591,899786,8805
4725,90,504868,1700,910191,900286,9905
4725,90,504868,1700,908776,900786,7990
4722,86,504769,5150,912791,901042,11749
4722,86,504769,4150,913776,901588,12188
4722,86,504769,2400,914276,901786,12490
4726,82,504891,3400,915926,902638,13288
4726,82,504891,3650,917541,903138,14403
4726,82,504891,1250,918076,903688,14388
4726,82,504891,2350,920826,904335,16491
4726,82,504891,3800,920991,905186,15805
4726,82,504891,2150,921991,905388,16603
4726,82,504891,3300,924241,906235,18006
4726,82,504891,2000,923976,906836,17140
4727,81,504937,3300,925526,907285,18241
4727,81,504937,4750,935491,907738,27753
4727,81,504937,2200,928576,908238,20338
4727,81,504937,3300,936091,908738,27353
4727,81,504937,4700,931941,908942,22999
4727,81,504937,3000,936591,909438,27153
4727,81,504937,4700,935326,909542,25784
4727,81,504937,3650,938376,910142,28234
4727,81,504937,3400,940741,910742,29999
4723,83,504857,2100,940726,911686,29040
4725,90,504868,4650,942826,911892,30934
4728,82,504972,3300,944441,912188,32253
4728,82,504972,3300,951426,912736,38690
4728,82,504972,3600,952391,913688,38703
4728,82,504972,5900,949691,914285,35406
4728,82,504972,2150,951976,914788,37188
4728,82,504972,1750,952476,914886,37590
4728,82,504972,1700,955491,915838,39653
4728,82,504972,5350,958791,916235,42556
4728,82,504972,2350,956526,916386,40140
4728,82,504972,4650,958526,916588,41938
4726,82,504891,2700,960126,917638,42488
4729,84,505002,4500,962191,918036,44155
4729,84,505002,4000,963941,918536,45405
4729,84,505002,2900,965226,919036,46190
4729,84,505002,1700,965791,919536,46255
4729,84,505002,4950,968041,920142,47899
4729,84,505002,2400,969176,920642,48534
4729,84,505002,2300,970291,921585,48706
4729,84,505002,4950,972441,922085,50356
4729,84,505002,3500,973926,922635,51291
4729,84,505002,3250,975341,923036,52305
4729,84,505002,4800,977676,923536,54140
4730,89,505119,3150,979176,923888,55288
4730,89,505119,1300,979876,924438,55438
4730,89,505119,4200,981691,925035,56656
4730,89,505119,3450,985541,925686,59855
4730,89,505119,1750,984241,926035,58206
4730,89,505119,3950,986691,926438,60253
4730,89,505119,1350,986226,927442,58784
4730,89,505119,2200,987376,928336,59040
4730,89,505119,2950,990141,928538,61603
4730,89,505119,2750,989726,929038,60688
4731,86,505151,2850,991526,929635,61891
4731,86,505151,4200,995276,930738,64538
4731,86,505151,4450,995491,931288,64203
4731,86,505151,2700,996826,931886,64940
4731,86,505151,3350,998391,932386,66005
4731,86,505151,2950,999976,932685,67291
4731,86,505151,500,865280,933538,-68258
4731,86,505151,500,865530,934185,-68655
4730,89,505119,50,865330,934986,-69656
4732,80,505488,500,865830,935638,-69808
4732,80,505488,50,865580,936036,-70456
4732,80,505488,50,865630,936536,-70906
4732,80,505488,50,865680,937535,-71855
4732,80,505488,50,865730,938085,-72355
4732,80,505488,50,865780,939238,-73458
4732,80,505488,500,866280,940288,-74008
4732,80,505488,50,865880,940738,-74858
4732,80,505488,50,865930,941285,-75355
4732,80,505488,500,866430,941835,-75405
4732,80,505488,50,866330,942292,-75962
4733,90,505548,500,866830,942886,-76056
4733,90,505548,500,866930,943442,-76512
4733,90,505548,500,867330,943942,-76612
4733,90,505548,500,867430,944688,-77258
4733,90,505548,50,867380,945138,-77758
4733,90,505548,500,867880,945492,-77612
4733,90,505548,500,867930,945886,-77956
4733,90,505548,500,868380,946388,-78008
4733,90,505548,500,868430,946988,-78558
4733,90,505548,50,868430,947538,-79108
4732,80,505488,500,868930,948392,-79462
4734,88,505606,500,868930,948686,-79756
4734,88,505606,50,868980,948938,-79958
4734,88,505606,50,868980,949438,-80458
4734,88,505606,500,869480,949336,-79856
4734,88,505606,500,869480,950386,-80906
4734,88,505606,50,869530,950988,-81458
4734,88,505606,500,869980,951942,-81962
4734,88,505606,50,869580,952638,-83058
4734,88,505606,500,870080,953235,-83155
4733,90,505548,50,870030,953835,-83805
4733,90,505548,500,870530,954335,-83805
4733,90,505548,50,870130,954888,-84758
4733,90,505548,500,870630,955538,-84908
4735,85,505785,500,871030,956236,-85206
4735,85,505785,50,870680,956585,-85905
4735,85,505785,500,871180,956988,-85808
4735,85,505785,50,871080,957288,-86208
4735,85,505785,500,871580,957838,-86258
4735,85,505785,500,871680,958836,-87156
4735,85,505785,50,871630,959488,-87858
4735,85,505785,50,871680,960038,-88358
4735,85,505785,500,872180,960436,-88256
4735,85,505785,50,871730,960538,-88808
4735,85,505785,500,872230,961085,-88855
4735,85,505785,50,872230,961688,-89458
4735,85,505785,500,872730,962185,-89455
4736,84,505824,500,872730,962942,-90212
4736,84,505824,50,872780,963542,-90762
4736,84,505824,500,873230,963838,-90608
4736,84,505824,500,873280,964338,-91058
4736,84,505824,50,873280,964538,-91258
4736,84,505824,500,873780,964692,-90912
4736,84,505824,500,873780,965438,-91658
4736,84,505824,50,873830,965588,-91758
4736,84,505824,500,874280,966088,-91808
4737,82,505912,500,874330,966442,-92112
4737,82,505912,500,874780,967442,-92662
4737,82,505912,50,874380,967986,-93606
4737,82,505912,500,874880,968188,-93308
4737,82,505912,50,874830,968788,-93958
4737,82,505912,500,875330,969636,-94306
4737,82,505912,50,874930,970136,-95206
4737,82,505912,500,875430,970738,-95308
4737,82,505912,50,875380,971186,-95806
4737,82,505912,50,875430,971786,-96356
4737,82,505912,50,875480,971992,-96512
4737,82,505912,50,875480,972542,-97062
4737,82,505912,50,875530,973588,-98058
4737,82,505912,50,875530,974138,-98608
4737,82,505912,50,875580,974886,-99306
4736,84,505824,50,875580,975338,-99758
4736,84,505824,500,876080,975738,-99658
4738,90,505980,500,876080,976238,-100158
4738,90,505980,500,876580,977135,-100555
4738,90,505980,500,876580,977686,-101106
4738,90,505980,500,877080,978492,-101412
4738,90,505980,500,877080,979042,-101962
4738,90,505980,500,877580,979542,-101962
4738,90,505980,500,877580,980092,-102512
4738,90,505980,500,878080,980642,-102562
4739,90,505991,500,878080,980988,-102908
4739,90,505991,50,878130,981835,-103705
4739,90,505991,50,878130,982388,-104258
4739,90,505991,50,878180,983335,-105155
4739,90,505991,50,878180,983835,-105655
4737,82,505912,50,878230,984338,-106108
4740,89,506047,500,878680,984588,-105908
4740,89,506047,50,878280,984985,-106705
4740,89,506047,50,878330,985888,-107558
4740,89,506047,50,878380,986492,-108112
4740,89,506047,500,878880,987038,-108158
4740,89,506047,500,879180,987288,-108108
4740,89,506047,50,878930,987786,-108856
4740,89,506047,500,879430,988692,-109262
4740,89,506047,500,879680,989242,-109562
4738,90,505980,50,879480,989888,-110408
4739,90,505991,500,879980,990885,-110905
4739,90,505991,50,879730,991136,-111406
4740,89,506047,500,880230,991938,-111708
4741,81,506342,50,880030,992588,-112558
4741,81,506342,500,880530,992938,-112408
4741,81,506342,500,880730,993236,-112506
4741,81,506342,50,880580,994535,-113955
4741,81,506342,50,880630,995035,-114405
4741,81,506342,500,881130,995886,-114756
4741,81,506342,500,881230,996488,-115258
4741,81,506342,500,881630,996988,-115358
4741,81,506342,500,881730,997442,-115712
4741,81,506342,50,881680,997688,-116008
4741,81,506342,50,881730,998636,-116906
4741,81,506342,50,881780,999442,-117662
4741,81,506342,500,882230,999992,-117762
4741,81,506342,50,881830,999886,-118056
4742,89,506566,500,882330,762619,119711
4742,89,506566,500,882730,764269,118461
4742,89,506566,50,882380,765019,117361
4742,89,506566,500,882880,766280,116600
4742,89,506566,500,883230,767930,115300
4742,89,506566,500,883380,769569,113811
4742,89,506566,50,883280,771630,111650
4742,89,506566,500,883780,773880,109900
4742,89,506566,50,883430,776119,107311
4742,89,506566,50,883480,777619,105861
4742,89,506566,50,883530,779619,103911
4742,89,506566,500,884030,781169,102861
4743,80,506677,50,883830,782480,101350
4743,80,506677,500,884330,783919,100411
4743,80,506677,500,884530,785419,99111
4743,80,506677,50,884380,786430,97950
4743,80,506677,500,884880,786930,97950
4743,80,506677,50,884580,788030,96550
4743,80,506677,50,884630,789569,95061
4743,80,506677,50,884680,790780,93900
4743,80,506677,500,885180,791880,93300
4743,80,506677,50,884930,794880,90050
4743,80,506677,500,885430,797069,88361
4743,80,506677,50,885230,798080,87150
4744,87,506963,50,885280,799230,86050
4744,87,506963,500,885780,801030,84750
4744,87,506963,50,885480,802530,82950
4744,87,506963,50,885530,804080,81450
4744,87,506963,500,886030,805669,80361
4744,87,506963,50,885830,806680,79150
4744,87,506963,50,885880,807469,78411
4745,86,507188,500,886380,809830,76550
4745,86,507188,50,886080,811980,74100
4745,86,507188,50,886130,813569,72561
4745,86,507188,500,886630,814580,72050
4745,86,507188,50,886430,816319,70111
4745,86,507188,50,886480,817469,69011
4745,86,507188,50,886530,818580,67950
4745,86,507188,500,887030,820630,66400
4745,86,507188,500,887130,821330,65800
4745,86,507188,50,887080,822869,64211
4745,86,507188,50,887130,825069,62061
4746,84,507191,50,887180,827080,60100
4746,84,507191,50,887180,827630,59550
4746,84,507191,50,887230,828919,58311
4746,84,507191,500,887680,830469,57211
4746,84,507191,50,887280,833069,54211
4746,84,507191,50,887330,834669,52661
4746,84,507191,50,887380,835269,52111
4746,84,507191,500,887880,836730,51150
4746,84,507191,500,888180,837980,50200
4746,84,507191,50,887930,840030,47900
4746,84,507191,50,887980,841169,46811
4746,84,507191,50,888030,843269,44761
4745,86,507188,50,888080,843969,44111
4747,88,507368,50,888130,845230,42900
4747,88,507368,500,888630,846630,42000
4747,88,507368,500,888680,847219,41461
4747,88,507368,500,889130,848769,40361
4747,88,507368,50,888730,849880,38850
4747,88,507368,50,888780,851219,37561
4747,88,507368,50,888830,852419,36411
4747,88,507368,500,889330,853969,35361
4747,88,507368,500,889630,855019,34611
4747,88,507368,50,889380,857169,32211
4747,88,507368,50,889430,858930,30500
4747,88,507368,500,889930,860769,29161
4748,80,507539,50,889680,861919,27761
4748,80,507539,500,890180,864430,25750
4748,80,507539,500,890430,866069,24361
4748,80,507539,500,890680,866730,23950
4748,80,507539,50,890480,868480,22000
4748,80,507539,500,890980,869630,21350
4748,80,507539,50,890730,869969,20761
4748,80,507539,500,891230,871569,19661
4748,80,507539,50,891030,873230,17800
4748,80,507539,500,891530,873880,17650
4748,80,507539,50,891280,874269,17011
4748,80,507539,50,891330,874769,16561
4748,80,507539,500,891830,876819,15011
4748,80,507539,500,892030,879419,12611
4748,80,507539,500,892330,881930,10400
4748,80,507539,500,892530,882219,10311
4748,80,507539,500,892830,882769,10061
4749,84,507765,50,892580,884880,7700
4749,84,507765,500,893080,886169,6911
4749,84,507765,50,892880,887480,5400
4749,84,507765,500,893380,889080,4300
4749,84,507765,50,893130,892069,1061
4749,84,507765,50,893180,893069,111
4749,84,507765,500,893680,894230,-550
4749,84,507765,500,893880,896230,-2350
4749,84,507765,500,894180,897469,-3289
4749,84,507765,50,893930,898930,-5000
4749,84,507765,500,894430,902269,-7839
4749,84,507765,500,894680,904919,-10239
4749,84,507765,50,894480,905880,-11400
4749,84,507765,50,894530,907669,-13139
4750,81,507904,500,895030,909580,-14550
4750,81,507904,50,894730,910130,-15400
4750,81,507904,500,895230,911419,-16189
4750,81,507904,500,895530,913469,-17939
4750,81,507904,50,895280,914669,-19389
4750,81,507904,50,895330,916719,-21389
4750,81,507904,50,895380,918580,-23200
4750,81,507904,500,895880,920569,-24689
4750,81,507904,500,896030,921769,-25739
4750,81,507904,500,896380,922969,-26589
4750,81,507904,50,896080,924130,-28050
4751,83,508129,50,896130,925469,-29339
4751,83,508129,500,896630,926780,-30150
4751,83,508129,50,896430,928330,-31900
4751,83,508129,50,896480,929569,-33089
4751,83,508129,50,896530,930619,-34089
4751,83,508129,50,896580,933119,-36539
4751,83,508129,500,897080,935219,-38139
4751,83,508129,500,897130,936769,-39639
4751,83,508129,50,897130,937830,-40700
4751,83,508129,500,897630,940069,-42439
4752,83,508261,50,897180,941430,-44250
4752,83,508261,500,897680,942869,-45189
4752,83,508261,50,897680,943519,-45839
4752,83,508261,500,898180,944180,-46000
4752,83,508261,500,898180,945219,-47039
4753,81,508352,500,898680,946480,-47800
4753,81,508352,50,898230,947569,-49339
4753,81,508352,50,898280,949869,-51589
4753,81,508352,50,898330,951730,-53400
4753,81,508352,50,898380,952730,-54350
4753,81,508352,500,898880,954269,-55389
4753,81,508352,500,899180,955580,-56400
4753,81,508352,500,899380,957180,-57800
4753,81,508352,50,899230,958619,-59389
4753,81,508352,500,899730,960630,-60900
4753,81,508352,50,899430,961869,-62439
4753,81,508352,500,899930,962869,-62939
4753,81,508352,50,899780,963369,-63589
4753,81,508352,50,899830,964419,-64589
4753,81,508352,500,900330,965530,-65200
4754,81,508543,50,899980,966769,-66789
4754,81,508543,500,900480,968280,-67800
4754,81,508543,500,900830,968669,-67839
4754,81,508543,50,900530,970230,-69700
4754,81,508543,50,900580,972380,-71800
4754,81,508543,50,900630,973969,-73339
4754,81,508543,50,900680,976469,-75789
4754,81,508543,50,900730,978630,-77900
4754,81,508543,50,900780,980069,-79289
4755,86,508548,500,901280,981719,-80439
4755,86,508548,50,900880,982480,-81600
4755,86,508548,50,900930,983130,-82200
4755,86,508548,50,900980,984769,-83789
4755,86,508548,50,901030,985930,-84900
4755,86,508548,50,901080,986719,-85639
4756,80,508561,50,901130,987269,-86139
4756,80,508561,500,901630,987969,-86339
4756,80,508561,500,901780,989930,-88150
4756,80,508561,50,901680,990369,-88689
4756,80,508561,500,902180,992469,-90289
4756,80,508561,500,902280,994169,-91889
4756,80,508561,50,902230,995280,-93050
4756,80,508561,500,902730,996069,-93339
4757,89,508597,500,902780,997619,-94839
4757,89,508597,50,902780,998769,-95989
4757,89,508597,500,903280,999930,-96650
4757,89,508597,500,903280,999930,-96650
4757,89,508597,50,903330,876430,26900
4757,89,508597,500,903780,876930,26850
4757,89,508597,500,903830,876980,26850
4757,89,508597,50,903830,877430,26400
4757,89,508597,500,904330,877480,26850
4757,89,508597,50,903880,877930,25950
4757,89,508597,500,904380,877530,26850
4757,89,508597,500,904830,877980,26850
4757,89,508597,50,904430,878480,25950
4754,81,508543,50,904480,878530,25950
4754,81,508543,500,904980,878980,26000
4755,86,508548,50,904880,879030,25850
4755,86,508548,500,905380,879030,26350
4756,80,508561,50,905030,879080,25950
4756,80,508561,500,905530,879080,26450
4756,80,508561,500,905880,879580,26300
4758,83,508696,500,906030,879130,26900
4758,83,508696,50,905930,879180,26750
4758,83,508696,500,906430,879230,27200
4758,83,508696,50,906080,879280,26800
4758,83,508696,50,906130,879780,26350
4758,83,508696,50,906180,880280,25900
4758,83,508696,500,906680,880130,26550
4758,83,508696,50,906480,880630,25850
4758,83,508696,50,906530,880330,26200
4758,83,508696,500,907030,880830,26200
4758,83,508696,500,907180,881130,26050
4757,89,508597,50,907080,880880,26200
4759,87,508922,50,907130,881180,25950
4759,87,508922,50,907180,881230,25950
4759,87,508922,500,907680,881280,26400
4759,87,508922,500,907680,881780,25900
4759,87,508922,500,908180,881880,26300
4759,87,508922,500,908180,881830,26350
4759,87,508922,500,908680,878030,30650
4759,87,508922,50,908230,880080,28150
4759,87,508922,500,908730,881380,27350
4759,87,508922,500,909180,881880,27300
4759,87,508922,50,908780,882380,26400
4759,87,508922,50,908830,882380,26450
4760,88,508943,50,908880,882880,26000
4760,88,508943,500,909380,882880,26500
4760,88,508943,500,909680,882930,26750
4760,88,508943,50,909430,883930,25500
4760,88,508943,50,909480,883930,25550
4760,88,508943,500,909980,884430,25550
4760,88,508943,50,909730,883980,25750
4760,88,508943,50,909780,884480,25300
4760,88,508943,50,909830,884480,25350
4760,88,508943,500,910330,884530,25800
4760,88,508943,500,910480,884980,25500
4761,85,508956,500,910830,884580,26250
4761,85,508956,500,910980,885080,25900
4761,85,508956,500,911330,885030,26300
4761,85,508956,500,911480,885080,26400
4761,85,508956,500,911830,885130,26700
4761,85,508956,50,911530,885130,26400
4762,88,508961,500,912030,885630,26400
4762,88,508961,500,912330,885180,27150
4762,88,508961,500,912530,885230,27300
4762,88,508961,500,912830,885730,27100
4762,88,508961,500,913030,885680,27350
4762,88,508961,50,912880,886180,26700
4762,88,508961,500,913380,886230,27150
4762,88,508961,50,913080,886680,26400
4762,88,508961,500,913580,886280,27300
4762,88,508961,50,913430,886330,27100
4762,88,508961,500,913930,886830,27100
4762,88,508961,500,914080,887180,26900
4762,88,508961,50,913980,886880,27100
4760,88,508943,50,914030,882930,31100
4761,85,508956,500,914530,883430,31100
4763,85,509139,50,914130,883430,30700
4763,85,509139,50,914180,886930,27250
4763,85,509139,500,914680,886980,27700
4763,85,509139,50,914580,887030,27550
4763,85,509139,500,915080,887530,27550
4763,85,509139,500,915180,887680,27500
4763,85,509139,50,915130,887580,27550
4763,85,509139,50,915180,887630,27550
4763,85,509139,500,915680,887680,28000
4763,85,509139,500,915680,888180,27500
4763,85,509139,50,915730,887730,28000
4764,89,509173,500,916180,887780,28400
4764,89,509173,50,915780,887830,27950
4764,89,509173,50,915830,888330,27500
4764,89,509173,500,916330,888680,27650
4764,89,509173,500,916680,888830,27850
4764,89,509173,50,916380,888730,27650
4763,85,509139,50,916430,889230,27200
4763,85,509139,500,916930,888880,28050
4764,89,509173,500,917180,889380,27800
4765,80,509401,50,916980,889730,27250
4765,80,509401,500,917480,889880,27600
4765,80,509401,500,917680,890230,27450
4765,80,509401,50,917530,889930,27600
4765,80,509401,500,918030,889980,28050
4765,80,509401,50,917730,890030,27700
4765,80,509401,50,917780,890530,27250
4765,80,509401,50,917830,890280,27550
4765,80,509401,500,918330,890780,27550
4765,80,509401,50,918080,890580,27500
4765,80,509401,50,918130,891080,27050
4765,80,509401,500,918630,890830,27800
4765,80,509401,50,918380,890880,27500
4766,85,509407,50,918430,891380,27050
4766,85,509407,500,918930,891580,27350
4766,85,509407,500,919130,891430,27700
4766,85,509407,500,919430,891480,27950
4766,85,509407,500,919630,891530,28100
4766,85,509407,50,919480,891580,27900
4766,85,509407,50,919530,892080,27450
4766,85,509407,500,920030,891630,28400
4766,85,509407,50,919680,891680,28000
4766,85,509407,500,920180,891730,28450
4766,85,509407,500,920530,891780,28750
4766,85,509407,50,920230,891830,28400
4767,80,509505,50,920280,892330,27950
4767,80,509505,50,920330,892580,27750
4767,80,509505,50,920380,892380,28000
4767,80,509505,500,920880,892430,28450
4767,80,509505,500,921030,892480,28550
4767,80,509505,50,920930,892530,28400
4767,80,509505,500,921430,893030,28400
4767,80,509505,50,921080,892630,28450
4767,80,509505,500,921580,893130,28450
4766,85,509407,500,921930,893080,28850
4766,85,509407,500,922080,893580,28500
4767,80,509505,500,922430,893630,28800
4767,80,509505,50,922130,893630,28500
4767,80,509505,50,922180,894130,28050
4768,83,509610,50,922230,894130,28100
4768,83,509610,50,922280,894180,28100
4768,83,509610,50,922330,894180,28150
4768,83,509610,50,922380,894680,27700
4768,83,509610,50,922430,894230,28200
4768,83,509610,50,922480,894280,28200
4768,83,509610,500,922930,894780,28150
4768,83,509610,500,922980,894730,28250
4769,86,509773,50,922980,895230,27750
4769,86,509773,50,923030,894830,28200
4769,86,509773,500,923480,895330,28150
4769,86,509773,500,923530,895280,28250
4769,86,509773,500,923980,895430,28550
4769,86,509773,50,923580,895480,28100
4769,86,509773,500,924080,895980,28100
4769,86,509773,50,924030,896280,27750
4769,86,509773,50,924080,896030,28050
4769,86,509773,50,924130,896080,28050
4770,88,509919,50,924130,895780,28350
4770,88,509919,50,924180,895380,28800
4770,88,509919,500,924630,896130,28500
4770,88,509919,50,924230,896180,28050
4770,88,509919,500,924730,896230,28500
4770,88,509919,500,925130,896730,28400
4770,88,509919,50,924780,896780,28000
4771,90,509990,500,925280,897230,28050
4771,90,509990,50,925180,897280,27900
4771,90,509990,50,925230,897730,27500
4771,90,509990,50,925280,897330,27950
4771,90,509990,50,925330,897380,27950
4771,90,509990,500,925780,897880,27900
4771,90,509990,50,925380,897780,27600
4771,90,509990,500,925880,898280,27600
4771,90,509990,500,926280,898380,27900
4770,88,509919,50,925930,898780,27150
4772,88,510078,50,925980,898430,27550
4772,88,510078,500,926480,898480,28000
4772,88,510078,500,926780,898530,28250
4772,88,510078,50,926530,898580,27950
4772,88,510078,500,927030,898630,28400
4772,88,510078,50,926830,899130,27700
4772,88,510078,50,926880,898830,28050
4772,88,510078,50,926930,898880,28050
4772,88,510078,50,926980,899380,27600
4772,88,510078,50,927030,899630,27400
4772,88,510078,50,927080,899430,27650
4772,88,510078,500,927530,899930,27600
4771,90,509990,500,927580,900130,27450
4772,88,510078,50,927580,899980,27600
4773,80,510195,500,928080,900030,28050
4773,80,510195,500,928080,900130,27950
4773,80,510195,500,928580,900180,28400
4773,80,510195,500,928580,900180,28400
4773,80,510195,50,928630,900680,27950
4773,80,510195,500,929080,900230,28850
4773,80,510195,50,928680,900280,28400
4773,80,510195,50,928730,900330,28400
4773,80,510195,500,929230,900380,28850
4773,80,510195,500,929580,900880,28700
4774,87,510282,50,929280,900080,29200
4774,87,510282,50,929330,900730,28600
4774,87,510282,500,929830,900780,29050
4774,87,510282,500,930080,900830,29250
4774,87,510282,50,929880,901330,28550
4773,80,510195,500,930380,900930,29450
4775,87,510573,50,930130,900980,29150
4775,87,510573,50,930180,901030,29150
4775,87,510573,500,930680,901080,29600
4775,87,510573,500,930880,901130,29750
4775,87,510573,50,930730,901180,29550
4775,87,510573,500,931230,901680,29550
4775,87,510573,500,931380,901380,30000
4775,87,510573,500,931730,901430,30300
4775,87,510573,500,931880,902180,29700
4775,87,510573,500,932230,902430,29800
4775,87,510573,50,931930,902230,29700
4776,87,510602,500,932430,902730,29700
4776,87,510602,50,932280,902930,29350
4776,87,510602,50,932330,903230,29100
4776,87,510602,500,932830,903430,29400
4776,87,510602,500,932930,903280,29650
4776,87,510602,50,932880,903330,29550
4776,87,510602,50,932930,903830,29100
4776,87,510602,50,932980,903930,29050
4775,87,510573,500,933430,903880,29550
4775,87,510573,500,933480,904380,29100
4776,87,510602,50,933480,904430,29050
4777,89,510759,500,933980,904430,29550
4777,89,510759,500,933980,904480,29500
4777,89,510759,500,934480,904480,30000
4777,89,510759,50,934030,904530,29500
4777,89,510759,500,934530,904530,30000
4777,89,510759,500,934980,904580,30400
4777,89,510759,500,935030,905030,30000
4777,89,510759,50,935030,905080,29950
4777,89,510759,500,935530,905530,30000
4777,89,510759,50,935080,905580,29500
4778,87,511091,500,935580,905580,30000
4778,87,511091,50,935580,905630,29950
4778,87,511091,50,935630,905630,30000
4778,87,511091,50,935630,905680,29950
4778,87,511091,500,936130,905680,30450
4778,87,511091,500,936130,906180,29950
4778,87,511091,500,936630,901930,34700
4778,87,511091,50,936180,906230,29950
4778,87,511091,50,936230,906230,30000
4779,89,511103,500,936730,906280,30450
4779,89,511103,50,936680,906730,29950
4779,89,511103,50,936730,906780,29950
4779,89,511103,500,937230,906780,30450
4779,89,511103,50,936780,906830,29950
4779,89,511103,50,936830,906830,30000
4779,89,511103,500,937330,906880,30450
4779,89,511103,500,937730,906880,30850
4779,89,511103,50,937380,907380,30000
4779,89,511103,50,937430,907380,30050
4780,84,511113,50,937480,905730,31750
4780,84,511113,500,937980,907430,30550
4780,84,511113,500,938230,907930,30300
4780,84,511113,500,938480,907930,30550
4780,84,511113,50,938280,908430,29850
4780,84,511113,50,938330,907980,30350
4780,84,511113,50,938380,908030,30350
4780,84,511113,500,938880,908530,30350
4781,81,511139,50,938530,908480,30050
4781,81,511139,50,938580,907430,31150
4781,81,511139,50,938630,908980,29650
4780,84,511113,50,938680,909030,29650
4780,84,511113,500,939180,909480,29700
4780,84,511113,50,938930,909080,29850
4782,87,511228,500,939430,909130,30300
4782,87,511228,50,939230,909630,29600
4782,87,511228,50,939280,909980,29300
4782,87,511228,500,939780,910130,29650
4782,87,511228,50,939480,910480,29000
4782,87,511228,50,939530,910180,29350
4782,87,511228,500,940030,910230,29800
4782,87,511228,50,939830,910280,29550
4782,87,511228,500,940330,910330,30000
4782,87,511228,50,940080,910830,29250
4781,81,511139,50,940130,910980,29150
4782,87,511228,500,940630,911330,29300
4783,84,511425,500,940830,911030,29800
4783,84,511425,50,940680,911080,29600
4783,84,511425,500,941180,911580,29600
4783,84,511425,50,940880,911380,29500
4783,84,511425,500,941380,911430,29950
4783,84,511425,50,941230,911930,29300
4783,84,511425,50,941280,912080,29200
4784,87,511454,500,941780,911980,29800
4784,87,511454,500,941880,912480,29400
4784,87,511454,500,942280,912580,29700
4784,87,511454,50,941930,912530,29400
4784,87,511454,500,942430,913030,29400
4784,87,511454,500,942780,912680,30100
4784,87,511454,500,942930,912730,30200
4784,87,511454,500,943280,912630,30650
4784,87,511454,500,943430,913230,30200
4784,87,511454,50,943330,913080,30250
4784,87,511454,50,943380,913580,29800
4784,87,511454,50,943430,913730,29700
4784,87,511454,500,943930,913630,30300
4784,87,511454,50,943480,913680,29800
4784,87,511454,50,943530,914180,29350
4784,87,511454,50,943580,914230,29350
4784,87,511454,500,944080,914680,29400
4784,87,511454,500,944430,914730,29700
4785,83,511518,500,944580,915180,29400
4785,83,511518,500,944930,915230,29700
4785,83,511518,50,944630,915230,29400
4785,83,511518,50,944680,915730,28950
4785,83,511518,500,945180,915730,29450
4785,83,511518,50,944980,915780,29200
4785,83,511518,500,945480,915780,29700
4783,84,511425,50,945230,916280,28950
4786,88,511532,500,945730,916280,29450
4786,88,511532,50,945530,916780,28750
4786,88,511532,500,946030,916330,29700
4786,88,511532,500,946230,916830,29400
4786,88,511532,500,946530,917280,29250
4786,88,511532,50,946280,916880,29400
4786,88,511532,50,946330,916930,29400
4786,88,511532,50,946380,916980,29400
4786,88,511532,50,946430,917030,29400
4786,88,511532,50,946480,917080,29400
4786,88,511532,500,946980,917580,29400
4786,88,511532,50,946580,917330,29250
4786,88,511532,500,947080,917380,29700
4786,88,511532,50,947030,917430,29600
4787,86,511576,500,947530,917930,29600
4787,86,511576,50,947130,918080,29050
4787,86,511576,500,947630,917980,29650
4787,86,511576,500,948030,918480,29550
4787,86,511576,500,948130,919030,29100
4785,83,511518,500,948530,920580,27950
4785,83,511518,50,948180,922080,26100
4785,83,511518,500,948680,923080,25600
4786,88,511532,500,949030,924130,24900
4787,86,511576,500,949180,924830,24350
4787,86,511576,50,949080,925830,23250
4788,86,511691,50,949130,927216,21914
4788,86,511691,500,949630,928366,21264
4788,86,511691,50,949230,929380,19850
4788,86,511691,500,949730,930516,19214
4788,86,511691,500,950130,931330,18800
4788,86,511691,50,949780,933030,16750
4788,86,511691,500,950280,934566,15714
4788,86,511691,500,950630,935280,15350
4788,86,511691,50,950330,936316,14014
4788,86,511691,50,950380,938016,12364
4788,86,511691,50,950430,939230,11200
4788,86,511691,50,950480,940666,9814
4788,86,511691,500,950980,942880,8100
4788,86,511691,500,951130,944580,6550
4789,84,511764,50,951030,946316,4714
4789,84,511764,50,951080,948416,2664
4789,84,511764,50,951130,950330,800
4789,84,511764,500,951630,953630,-2000
4789,84,511764,50,951180,955166,-3986
4789,84,511764,500,951680,956530,-4850
4789,84,511764,50,951680,958180,-6500
4788,86,511691,500,952180,960330,-8150
4788,86,511691,50,951730,961330,-9600
4790,84,511970,50,951780,962880,-11100
4790,84,511970,500,952280,964016,-11736
4790,84,511970,500,952680,965630,-12950
4790,84,511970,50,952330,967230,-14900
4790,84,511970,500,952830,968916,-16086
4790,84,511970,50,952730,970130,-17400
4790,84,511970,50,952780,971316,-18536
4790,84,511970,500,953280,973330,-20050
4790,84,511970,500,953330,974980,-21650
4791,88,512091,500,953780,977230,-23450
4791,88,512091,50,953380,979830,-26450
4791,88,512091,500,953880,980980,-27100
4791,88,512091,50,953830,981780,-27950
4791,88,512091,50,953880,983616,-29736
4791,88,512091,500,954380,985180,-30800
4791,88,512091,500,954380,986716,-32336
4791,88,512091,50,954430,988330,-33900
4792,89,512215,550,954430,989830,-35400
4792,89,512215,3250,954930,990616,-35686
4792,89,512215,4750,954930,992180,-37250
4792,89,512215,3600,955346,993280,-37934
4792,89,512215,750,954937,994380,-39443
4792,89,512215,1100,954987,995580,-40593
4792,89,512215,3200,955487,997066,-41579
4793,84,512270,3250,955396,999766,-44370
4793,84,512270,3400,955446,999980,-44534
4793,84,512270,3200,955496,925980,29516
4793,84,512270,2050,955987,926080,29907
4793,84,512270,4550,955546,926480,29066
4793,84,512270,4900,955596,926580,29016
4793,84,512270,1300,955646,926780,28866
4793,84,512270,3100,956146,928280,27866
4793,84,512270,1650,956037,929380,26657
4794,82,512418,4900,956537,930480,26057
4794,82,512418,1300,956196,932830,23366
4794,82,512418,2200,956696,933830,22866
4794,82,512418,6300,956587,936130,20457
4794,82,512418,2800,957087,937280,19807
4794,82,512418,1600,957196,938130,19066
4794,82,512418,2400,957137,938830,18307
4794,82,512418,1300,957187,939380,17807
4794,82,512418,1200,957687,939980,17707
4794,82,512418,3250,957696,941930,15766
4794,82,512418,5000,957737,943730,14007
4794,82,512418,4400,958196,944780,13416
4794,82,512418,2900,957787,947530,10257
4794,82,512418,4950,957837,949780,8057
4794,82,512418,3600,958337,951180,7157
4794,82,512418,1150,958246,952230,6016
4795,86,512591,4200,958296,954080,4216
4795,86,512591,5950,958796,956130,2666
4795,86,512591,2200,958387,958680,-293
4795,86,512591,1600,958437,959680,-1243
4795,86,512591,3700,958937,961280,-2343
4795,86,512591,1800,958846,962430,-3584
4795,86,512591,3250,958896,963530,-4634
4795,86,512591,3750,959396,964180,-4784
4795,86,512591,4700,959437,965830,-6393
4795,86,512591,3450,959896,966630,-6734
4795,86,512591,2950,959487,967780,-8293
4795,86,512591,4150,959987,969230,-9243
4795,86,512591,3050,959946,971830,-11884
4795,86,512591,3250,960446,973830,-13384
4796,82,512833,1750,960487,976230,-15743
4796,82,512833,3300,960496,976980,-16484
4796,82,512833,5450,960987,979180,-18193
4796,82,512833,2850,960546,981130,-20584
4796,82,512833,2850,960596,982430,-21834
4796,82,512833,2200,961096,983480,-22384
4796,82,512833,1800,961037,985080,-24043
4796,82,512833,1400,961537,986130,-24593
4796,82,512833,2850,961596,986980,-25384
4796,82,512833,2150,962037,988580,-26543
4797,81,512836,3650,962096,989780,-27684
4797,81,512836,3800,962537,990330,-27793
4797,81,512836,2900,962146,991880,-29734
4797,81,512836,3300,962646,993430,-30784
4797,81,512836,3700,962587,994530,-31943
4797,81,512836,3700,963087,995880,-32793
4797,81,512836,2800,963146,996930,-33784
4797,81,512836,3200,963587,998230,-34643
4796,82,512833,2900,963196,999180,-35984
4796,82,512833,1600,963246,999930,-36684
4797,81,512836,3300,963296,999980,-36684
4798,80,513107,3200,963796,964530,-734
4798,80,513107,3350,964087,965080,-993
4798,80,513107,2800,964296,966780,-2484
4798,80,513107,2650,964137,968880,-4743
4798,80,513107,3100,964637,970180,-5543
4798,80,513107,2100,964796,971780,-6984
4798,80,513107,1350,964687,972880,-8193
4798,80,513107,3150,965187,973880,-8693
4799,86,513179,3250,964846,976330,-11484
4799,86,513179,2300,964896,977980,-13084
4799,86,513179,1700,965396,979180,-13784
4799,86,513179,3700,965687,980930,-15243
4799,86,513179,3300,965446,982530,-17084
4799,86,513179,2200,965946,985130,-19184
4799,86,513179,4150,966187,987730,-21543
4800,87,513179,3200,965996,989080,-23084
4800,87,513179,3450,966496,989980,-23484
4800,87,513179,4100,966687,990580,-23893
4800,87,513179,2900,966546,991880,-25334
4800,87,513179,2250,966596,993630,-27034
4800,87,513179,4650,967096,995780,-28684
4800,87,513179,4800,967187,997380,-30193
4800,87,513179,3300,967596,999080,-31484
4798,80,513107,5150,967687,999630,-31943
4798,80,513107,1750,968096,939380,28716
4800,87,513179,3750,967737,939030,28707
4800,87,513179,1850,968237,939080,29157
4800,87,513179,5100,968596,939180,29416
4801,87,513374,1750,968737,939680,29057
4801,87,513374,2750,968646,939880,28766
4801,87,513374,4700,969146,940180,28966
4801,87,513374,2750,968787,940380,28407
4801,87,513374,3150,969287,940230,29057
4801,87,513374,2350,969646,940730,28916
4801,87,513374,1850,969337,941380,27957
4801,87,513374,3700,969387,941280,28107
4801,87,513374,1300,969437,941330,28107
4801,87,513374,4200,969937,941830,28107
4801,87,513374,2200,969696,941880,27816
4801,87,513374,4150,970196,941880,28316
4802,83,513410,5350,970437,941930,28507
4802,83,513410,2450,970246,942380,27866
4802,83,513410,2850,970296,941980,28316
4802,83,513410,4400,970796,942480,28316
4802,83,513410,2750,970937,937230,33707
4802,83,513410,3150,971296,937730,33566
4802,83,513410,2850,971437,938730,32707
4803,88,513667,2800,971346,938430,32916
4803,88,513667,4350,971846,939130,32716
4803,88,513667,1300,971487,940880,30607
4803,88,513667,3750,971537,941230,30307
4803,88,513667,1750,971587,942430,29157
4803,88,513667,3800,972087,942930,29157
4803,88,513667,2700,971896,942980,28916
4803,88,513667,4000,971946,942980,28966
4803,88,513667,3700,972446,943480,28966
4803,88,513667,2250,972137,943030,29107
4803,88,513667,1600,972637,943080,29557
4803,88,513667,4700,972946,943130,29816
4803,88,513667,4350,973137,943630,29507
4803,88,513667,5850,973446,943530,29916
4803,88,513667,5400,973637,944030,29607
4804,81,514043,5750,973946,943680,30266
4804,81,514043,4150,974137,943730,30407
4804,81,514043,4800,973996,944230,29766
4804,81,514043,1750,974046,944530,29516
4804,81,514043,1800,974096,944730,29366
4804,81,514043,1800,974596,945030,29566
4804,81,514043,2700,974187,945230,28957
4805,88,514143,2450,974237,945530,28707
4805,88,514143,3800,974737,945580,29157
4805,88,514143,4250,974646,945630,29016
4805,88,514143,3700,975146,945680,29466
4805,88,514143,4350,975237,945730,29507
4805,88,514143,2850,975646,946230,29416
4805,88,514143,3300,975737,946280,29457
4805,88,514143,3650,976146,947230,28916
4806,84,514193,3000,975787,947280,28507
4806,84,514193,1250,975837,947730,28107
4806,84,514193,3650,976337,947780,28557
4806,84,514193,2200,976196,948230,27966
4806,84,514193,5950,976696,947830,28866
4806,84,514193,2250,976387,947880,28507
4806,84,514193,3350,976887,948380,28507
4806,84,514193,2700,976746,948730,28016
4806,84,514193,3900,977246,948430,28816
4806,84,514193,2200,976937,948480,28457
4806,84,514193,3900,977437,945280,32157
4806,84,514193,2250,977296,945780,31516
4806,84,514193,1800,977346,946730,30616
4806,84,514193,2700,977846,946780,31066
4806,84,514193,1350,977937,948530,29407
4806,84,514193,3850,978346,949030,29316
4806,84,514193,3250,978437,949230,29207
4806,84,514193,4800,978846,949530,29316
4807,88,514225,3450,978487,949280,29207
4807,88,514225,4450,978987,949330,29657
4807,88,514225,4400,978896,949830,29066
4807,88,514225,2750,978946,950030,28916
4807,88,514225,3800,978996,949880,29116
4807,88,514225,2500,979487,950530,28957
4805,88,514143,3700,979496,950880,28616
4808,86,514311,1600,979537,950580,28957
4808,86,514311,4200,979546,951080,28466
4808,86,514311,5700,980037,951380,28657
4808,86,514311,3700,980046,951130,28916
4808,86,514311,3650,980537,951180,29357
4808,86,514311,3950,980546,951230,29316
4808,86,514311,4350,980587,951730,28857
4808,86,514311,2900,980596,951930,28666
4808,86,514311,2250,981087,951780,29307
4808,86,514311,3800,980646,951830,28816
4808,86,514311,3150,980696,952330,28366
4808,86,514311,6250,980746,952430,28316
4808,86,514311,2450,980796,952380,28416
4807,88,514225,5650,980846,952430,28416
4809,86,514831,2800,981346,952930,28416
4809,86,514831,1800,981137,952930,28207
4809,86,514831,1700,981187,953430,27757
4809,86,514831,3250,981687,953430,28257
4809,86,514831,2800,981846,950380,31466
4809,86,514831,3850,981737,953930,27807
4809,86,514831,2250,981787,953980,27807
4809,86,514831,2650,982287,953980,28307
4809,86,514831,2450,981896,954480,27416
4809,86,514831,5200,982396,954480,27916
4809,86,514831,2150,982787,954980,27807
4810,82,514948,2300,982446,954980,27466
4810,82,514948,4150,982946,955030,27916
4810,82,514948,1250,983287,955480,27807
4811,87,514960,1350,982996,955080,27916
4811,87,514960,3150,983496,955580,27916
4811,87,514960,5650,983787,955530,28257
4811,87,514960,1450,983546,955580,27966
4811,87,514960,1800,983596,956080,27516
4811,87,514960,2850,983646,956080,27566
4811,87,514960,2200,983696,957080,26616
4811,87,514960,2300,983746,957130,26616
4811,87,514960,4100,984246,957580,26666
4811,87,514960,2750,984287,957180,27107
4812,86,514977,2750,984746,957230,27516
4812,86,514977,4750,984337,957280,27057
4812,86,514977,3400,984387,957330,27057
4812,86,514977,1350,984437,957380,27057
4812,86,514977,3700,984487,951430,33057
4812,86,514977,2950,984537,957930,26607
4810,82,514948,5600,985037,958080,26957
4810,82,514948,2900,984796,958430,26366
4810,82,514948,800,984846,958580,26266
4812,86,514977,3350,984896,958480,26416
4813,84,515167,2200,984946,958980,25966
4813,84,515167,3300,985446,959080,26366
4813,84,515167,3500,985537,959030,26507
4813,84,515167,700,985496,959530,25966
4813,84,515167,3700,985996,959580,26416
4813,84,515167,2800,986037,959580,26457
4813,84,515167,2050,986496,959630,26866
4813,84,515167,4400,986537,959630,26907
4813,84,515167,3950,986546,959680,26866
4813,84,515167,2400,986587,960130,26457
4814,85,515577,1200,986596,960180,26416
4814,85,515577,3750,987087,960180,26907
4814,85,515577,5200,987096,960680,26416
4814,85,515577,3750,987137,953480,33657
4814,85,515577,1850,987146,961230,25916
4814,85,515577,2750,987187,961680,25507
4814,85,515577,3800,987196,961730,25466
4814,85,515577,4450,987687,962180,25507
4814,85,515577,850,987246,962230,25016
4814,85,515577,2700,987746,962680,25066
4814,85,515577,3650,988187,962280,25907
4814,85,515577,2700,988246,962780,25466
4814,85,515577,3150,988687,962730,25957
4814,85,515577,4850,988746,962780,25966
4814,85,515577,2550,988737,962830,25907
4814,85,515577,4850,989237,963280,25957
4815,87,515929,2750,988796,962880,25916
4815,87,515929,3250,989296,963380,25916
4815,87,515929,2650,989737,963330,26407
4815,87,515929,4600,989796,956580,33216
4815,87,515929,4150,989787,956580,33207
4815,87,515929,3650,990287,957080,33207
4815,87,515929,4900,990296,957430,32866
4815,87,515929,3750,990337,960680,29657
4815,87,515929,1400,990346,960730,29616
4815,87,515929,2850,990837,961180,29657
4815,87,515929,1250,990396,963380,27016
4815,87,515929,1400,990446,963880,26566
4815,87,515929,2300,990946,963430,27516
4816,80,515968,3100,991337,963930,27407
4816,80,515968,3850,990996,963930,27066
4816,80,515968,3700,991496,964430,27066
4816,80,515968,4350,991837,964430,27407
4816,80,515968,4250,991996,964930,27066
4816,80,515968,4650,992337,964930,27407
4816,80,515968,2850,992046,965430,26616
4816,80,515968,2400,992096,964980,27116
4816,80,515968,2650,992146,965030,27116
4816,80,515968,2800,992196,965080,27116
4815,87,515929,5750,992246,965130,27116
4815,87,515929,3300,992746,965480,27266
4817,89,516089,2350,992837,965980,26857
4817,89,516089,3600,992796,965780,27016
4817,89,516089,3300,993296,965830,27466
4817,89,516089,3350,992887,966330,26557
4817,89,516089,6850,997146,966030,31116
4818,82,516092,3050,997187,966530,30657
4819,81,516136,5450,996596,965180,31416
4820,83,516305,8050,999837,965230,34607
4821,80,516454,2200,999846,965730,34116
6927,81,727612,2850,982130,966380,15750
6927,81,727612,3800,983730,966880,16850
6927,81,727612,3000,985230,966580,18650
6927,81,727612,2750,989080,966630,22450
6927,81,727612,4950,989630,967130,22500
6927,81,727612,2700,989030,967380,21650
6927,81,727612,3600,991230,967630,23600
6927,81,727612,1350,991830,967880,23950
6928,81,727944,2400,995030,967680,27350
6928,81,727944,5700,995680,968180,27500
6928,81,727944,3350,997380,968380,29000
6928,81,727944,3950,999280,968230,31050
6928,81,727944,1600,999880,968730,31150
6928,81,727944,500,957130,968880,-11750
6928,81,727944,50,957080,968780,-11700
6929,85,727964,500,957580,969280,-11700
6929,85,727964,500,957630,969380,-11750
6929,85,727964,500,958080,969330,-11250
6929,85,727964,500,958130,969380,-11250
6929,85,727964,50,958130,969880,-11750
6929,85,727964,500,958630,969430,-10800
6929,85,727964,500,958630,969480,-10850
6929,85,727964,500,959130,969980,-10850
6929,85,727964,50,958680,970380,-11700
6929,85,727964,50,958730,970480,-11750
6929,85,727964,50,958780,970880,-12100
6930,86,728005,500,959280,970980,-11700
6930,86,728005,50,959180,970930,-11750
6930,86,728005,500,959680,970980,-11300
6930,86,728005,50,959330,971480,-12150
6930,86,728005,50,959380,971530,-12150
6930,86,728005,50,959430,971980,-12550
6930,86,728005,50,959480,972030,-12550
6929,85,727964,500,959980,972480,-12500
6931,81,728086,50,959730,972530,-12800
6931,81,728086,50,959780,972530,-12750
6931,81,728086,50,959830,972580,-12750
6931,81,728086,500,960330,972580,-12250
6931,81,728086,50,960030,972680,-12650
6931,81,728086,500,960530,973180,-12650
6930,86,728005,500,960830,973130,-12300
6930,86,728005,50,960580,973630,-13050
6932,88,728170,50,960630,973680,-13050
6932,88,728170,50,960680,973680,-13000
6932,88,728170,500,961180,973730,-12550
6932,88,728170,50,960880,973730,-12850
6932,88,728170,50,960930,974230,-13300
6932,88,728170,500,961430,974230,-12800
6932,88,728170,50,961230,971480,-10250
6932,88,728170,1050,961730,972630,-10900
6931,81,728086,1100,961930,973080,-11150
6931,81,728086,600,961780,974280,-12500
6933,82,728190,3800,962280,974730,-12450
6933,82,728190,2750,961980,974780,-12800
6933,82,728190,5300,962480,974780,-12300
6933,82,728190,2850,962780,975280,-12500
6933,82,728190,2350,962530,974830,-12300
6933,82,728190,2700,963030,975330,-12300
6933,82,728190,2800,962830,975780,-12950
6933,82,728190,2850,962880,975380,-12500
6933,82,728190,2800,963380,975880,-12500
6932,88,728170,3150,963080,975830,-12750
6932,88,728170,3750,963130,975880,-12750
6932,88,728170,4250,963180,975930,-12750
6934,87,728299,2800,963680,976380,-12700
6934,87,728299,2650,963880,976430,-12550
6934,87,728299,1750,963730,976880,-13150
6934,87,728299,1250,963780,976480,-12700
6934,87,728299,3150,964280,976980,-12700
6934,87,728299,3800,964380,976930,-12550
6934,87,728299,2750,964780,977430,-12650
6934,87,728299,3200,964880,977030,-12150
6934,87,728299,1950,964830,977080,-12250
6934,87,728299,2800,964880,977580,-12700
6934,87,728299,3350,965380,977930,-12550
6935,86,728396,4650,965380,977630,-12250
6935,86,728396,3800,965880,978130,-12250
6935,86,728396,3800,965880,977980,-12100
6935,86,728396,4300,965930,978030,-12100
6935,86,728396,2650,965930,978530,-12600
6935,86,728396,2350,966430,978630,-12200
6935,86,728396,4250,965980,979030,-13050
6935,86,728396,2250,966030,978680,-12650
6935,86,728396,3700,966530,979180,-12650
6935,86,728396,3800,966930,979530,-12600
6934,87,728299,4550,966580,979680,-13100
6934,87,728299,4700,967080,980030,-12950
6935,86,728396,2600,967430,980180,-12750
6936,84,728541,2200,967130,980080,-12950
6936,84,728541,5750,967180,980130,-12950
6936,84,728541,3300,967230,980180,-12950
6936,84,728541,850,967730,980680,-12950
6936,84,728541,2350,967480,980680,-13200
6936,84,728541,2650,967980,980730,-12750
6936,84,728541,3650,968230,980730,-12500
6936,84,728541,1800,968480,981230,-12750
6936,84,728541,4200,968730,981230,-12500
6936,84,728541,2500,968530,981730,-13200
6936,84,728541,3800,969030,981280,-12250
6936,84,728541,1400,968780,981780,-13000
6936,84,728541,4400,969280,981780,-12500
6937,87,728547,1800,969530,982280,-12750
6937,87,728547,3900,969780,981830,-12050
6937,87,728547,3350,969580,981880,-12300
6937,87,728547,1800,969630,982380,-12750
6937,87,728547,3800,970130,982330,-12200
6937,87,728547,1850,969830,982380,-12550
6937,87,728547,1350,969880,982430,-12550
6937,87,728547,3800,969930,982430,-12500
6937,87,728547,5600,969980,982930,-12950
6937,87,728547,2650,970030,982930,-12900
6937,87,728547,2750,970080,982980,-12900
6938,80,728590,1850,970130,983430,-13300
6938,80,728590,4400,970180,983480,-13300
6938,80,728590,4750,970630,983480,-12850
6938,80,728590,2750,970230,983980,-13750
6938,80,728590,3650,970730,984030,-13300
6938,80,728590,3250,971130,984480,-13350
6938,80,728590,1000,970780,984080,-13300
6938,80,728590,6300,971280,984130,-12850
6939,88,728743,3750,971630,984630,-13000
6939,88,728743,3700,971330,984980,-13650
6939,88,728743,2850,971380,984680,-13300
6939,88,728743,2250,971880,983980,-12100
6939,88,728743,2900,972130,985180,-13050
6939,88,728743,2200,972380,985480,-13100
6939,88,728743,3200,972180,985230,-13050
6939,88,728743,2200,972680,985730,-13050
6939,88,728743,6300,972880,985530,-12650
6939,88,728743,2650,973180,986030,-12850
6939,88,728743,3200,972930,985780,-12850
6940,80,728814,3900,972980,985830,-12850
6940,80,728814,2650,973030,985880,-12850
6940,80,728814,3100,973530,986380,-12850
6940,80,728814,2200,973680,986530,-12850
6940,80,728814,2200,973580,986880,-13300
6940,80,728814,3750,974080,986580,-12500
6940,80,728814,1600,973730,987080,-13350
6940,80,728814,2700,973780,986930,-13150
6940,80,728814,2250,973830,986980,-13150
6940,80,728814,2600,974330,987480,-13150
6940,80,728814,1400,974130,987580,-13450
6941,84,728834,2250,974630,987980,-13350
6941,84,728834,3650,974830,987630,-12800
6941,84,728834,4150,974680,988130,-13450
6941,84,728834,2250,975180,988480,-13300
6941,84,728834,2450,975330,988630,-13300
6941,84,728834,2750,975680,988530,-12850
6941,84,728834,2200,975830,988580,-12750
6941,84,728834,4050,975730,988630,-12900
6941,84,728834,2700,976230,989130,-12900
6940,80,728814,2250,975880,988680,-12800
6941,84,728834,5450,976380,988730,-12350
6942,90,729047,5300,976280,988780,-12500
6942,90,729047,2300,976780,988830,-12050
6942,90,729047,3600,976430,988880,-12450
6942,90,729047,5750,976480,989380,-12900
6942,90,729047,3300,976530,989180,-12650
6942,90,729047,5150,976580,989230,-12650
6942,90,729047,2800,976630,989280,-12650
6942,90,729047,6350,976680,989330,-12650
6942,90,729047,2350,976730,989830,-13100
6942,90,729047,4850,977230,989430,-12200
6943,87,729192,3250,977280,989930,-12650
6943,87,729192,2650,977730,990330,-12600
6943,87,729192,3750,977780,990430,-12650
6943,87,729192,3200,978230,990380,-12150
6943,87,729192,3150,978280,990430,-12150
6943,87,729192,2400,978280,990930,-12650
6943,87,729192,3350,978780,990480,-11700
6943,87,729192,2200,978330,990980,-12650
6944,82,729522,2950,978380,990980,-12600
6944,82,729522,2300,978430,991480,-13050
6944,82,729522,2750,978930,991030,-12100
6944,82,729522,3800,979280,991080,-11800
6944,82,729522,4800,979430,991580,-12150
6944,82,729522,2200,979330,991530,-12200
6944,82,729522,3300,979380,992080,-12700
6944,82,729522,3950,979430,991630,-12200
6944,82,729522,3200,979930,992130,-12200
6944,82,729522,1800,979930,992130,-12200
6944,82,729522,2450,980430,992630,-12200
6944,82,729522,3300,979980,992180,-12200
6945,89,729893,4200,980030,992680,-12650
6945,89,729893,2600,980530,992680,-12150
6945,89,729893,2650,980480,993180,-12700
6945,89,729893,4700,980980,992730,-11750
6945,89,729893,3100,980580,991580,-11000
6945,89,729893,2100,981080,992830,-11750
6945,89,729893,5550,981480,992880,-11400
6945,89,729893,2350,981130,992930,-11800
6945,89,729893,3350,981180,992980,-11800
6946,86,729907,2900,981680,993030,-11350
6946,86,729907,4750,981530,993530,-12000
6946,86,729907,3300,981580,993230,-11650
6946,86,729907,4250,981630,993730,-12100
6946,86,729907,2300,982130,994030,-11900
6946,86,729907,4200,982180,994230,-12050
6946,86,729907,2850,982630,992780,-10150
6946,86,729907,4100,983075,994080,-11005
6946,86,729907,2650,984525,994130,-9605
6945,89,729893,2400,984575,994630,-10055
6946,86,729907,1550,984595,994280,-9685
6947,80,730116,4700,986745,994330,-7585
6947,80,730116,3850,989545,994380,-4835
6947,80,730116,3650,990045,994430,-4385
6947,80,730116,4150,992095,994930,-2835
6947,80,730116,2250,993245,994680,-1435
6947,80,730116,2300,994075,995180,-1105
6947,80,730116,1250,994595,994980,-385
6947,80,730116,3750,997675,995230,2445
6947,80,730116,3900,998175,995280,2895
6948,81,730156,3800,999795,995780,4015
6948,81,730156,550,999845,996080,3765
6948,81,730156,500,985330,995830,-10500
6948,81,730156,500,985730,996330,-10600
6948,81,730156,50,985380,996130,-10750
6948,81,730156,50,985430,996180,-10750
6948,81,730156,50,985480,996230,-10750
6947,80,730116,500,985980,996280,-10300
6948,81,730156,500,986230,996330,-10100
6948,81,730156,500,986480,995030,-8550
6949,81,730322,500,986730,995080,-8350
6949,81,730322,50,986530,995580,-9050
6949,81,730322,500,987030,996380,-9350
6949,81,730322,500,987230,996830,-9600
6949,81,730322,50,987080,996430,-9350
6949,81,730322,50,987130,996930,-9800
6950,88,730407,500,987630,997330,-9700
6950,88,730407,500,987730,996980,-9250
6950,88,730407,500,988130,997480,-9350
6950,88,730407,50,987780,997380,-9600
6950,88,730407,50,987830,997430,-9600
6950,88,730407,50,987880,997930,-10050
6951,88,730444,50,987930,997530,-9600
6951,88,730444,50,987980,998030,-10050
6951,88,730444,500,988480,998430,-9950
6951,88,730444,500,988630,998530,-9900
6951,88,730444,500,988980,998930,-9950
6951,88,730444,500,989130,998580,-9450
6950,88,730407,500,989480,998630,-9150
6952,80,730523,50,989180,999130,-9950
6952,80,730523,500,989680,999430,-9750
6952,80,730523,500,989980,999630,-9650
6952,80,730523,500,990180,999480,-9300
6952,80,730523,500,990480,999530,-9050
6952,80,730523,50,990230,999580,-9350
6952,80,730523,500,990730,999630,-8900
6952,80,730523,500,990980,999680,-8700
6952,80,730523,500,991230,999730,-8500
6952,80,730523,500,991480,999780,-8300
6952,80,730523,50,991280,757180,234100
6952,80,730523,500,991780,757380,234400
6952,80,730523,500,991980,757230,234750
6951,88,730444,50,991830,757730,234100
6953,80,730556,50,991880,757430,234450
6953,80,730556,50,991930,757930,234000
6953,80,730556,50,991980,757780,234200
6953,80,730556,500,992480,757830,234650
6953,80,730556,50,992030,758330,233700
6953,80,730556,500,992530,758830,233700
6952,80,730523,50,992530,758480,234050
6953,80,730556,500,993030,758530,234500
6954,81,731038,500,993030,759030,234000
6954,81,731038,50,993080,758880,234200
6954,81,731038,500,993530,759380,234150
6954,81,731038,50,993130,759080,234050
6954,81,731038,500,993630,759580,234050
6954,81,731038,50,993580,758430,235150
6954,81,731038,50,993630,759880,233750
6954,81,731038,50,993680,759630,234050
6954,81,731038,500,994130,760130,234000
6954,81,731038,500,994180,760380,233800
6954,81,731038,500,994630,760180,234450
6954,81,731038,50,994230,760680,233550
6954,81,731038,50,994280,760880,233400
6954,81,731038,500,994780,760730,234050
6954,81,731038,500,995130,760780,234350
6954,81,731038,50,994830,761280,233550
6954,81,731038,500,995330,760930,234400
6954,81,731038,50,995180,760980,234200
6955,90,731162,500,995680,761030,234650
6955,90,731162,50,995380,761330,234050
6955,90,731162,50,995430,761380,234050
6955,90,731162,500,995930,761880,234050
6955,90,731162,50,995730,761630,234100
6955,90,731162,500,996230,761680,234550
6955,90,731162,500,996430,762180,234250
6955,90,731162,50,996280,762380,233900
6955,90,731162,500,996780,761080,235700
6955,90,731162,50,996480,761580,234900
6955,90,731162,500,996980,762230,234750
6955,90,731162,50,996830,762730,234100
6955,90,731162,50,996880,762430,234450
6955,90,731162,500,997380,762480,234900
6955,90,731162,500,997480,762980,234500
6956,81,731827,50,997430,763230,234200
6956,81,731827,50,997480,763030,234450
6956,81,731827,500,997980,763530,234450
6956,81,731827,500,997980,763730,234250
6956,81,731827,50,998030,764030,234000
6956,81,731827,50,998030,764230,233800
6956,81,731827,50,998080,764080,234000
6956,81,731827,50,998080,764580,233500
6956,81,731827,50,998130,764730,233400
6956,81,731827,500,998580,764630,233950
6956,81,731827,500,998630,765130,233500
6957,85,731849,50,998630,765630,233000
6957,85,731849,500,999130,767230,231900
6957,85,731849,50,998680,768980,229700
6957,85,731849,500,999180,770230,228950
6957,85,731849,500,999630,772430,227200
6957,85,731849,50,999230,775030,224200
6957,85,731849,50,999280,775680,223600
6957,85,731849,500,999780,778330,221450
6957,85,731849,50,999830,778930,220900
6957,85,731849,50,999880,780580,219300
6958,81,732058,50,999930,781630,218300
6958,81,732058,50,999980,783730,216250
5697,81,601515,500,893030,785180,107850
5697,81,601515,50,892669,786930,105739
5697,81,601515,500,893169,788480,104689
5697,81,601515,500,893530,790080,103450
5697,81,601515,500,893669,792230,101439
5697,81,601515,50,893580,793430,100150
5697,81,601515,50,893630,794930,98700
5697,81,601515,500,894130,796530,97600
5697,81,601515,500,894169,797730,96439
5697,81,601515,50,894180,799330,94850
5695,89,601448,50,894219,800880,93339
5695,89,601448,500,894680,802430,92250
5696,81,601476,50,894269,804080,90189
5696,81,601476,50,894319,804830,89489
5696,81,601476,500,894819,806330,88489
5697,81,601515,500,895180,808430,86750
5698,90,601644,500,895319,809530,85789
5698,90,601644,50,895230,810980,84250
5698,90,601644,50,895280,813530,81750
5698,90,601644,50,895330,814130,81200
5698,90,601644,50,895369,815230,80139
5698,90,601644,50,895380,817280,78100
5698,90,601644,500,895869,818530,77339
5698,90,601644,500,895880,819230,76650
5698,90,601644,500,896369,819930,76439
5698,90,601644,500,896380,821530,74850
5699,90,601801,50,896419,823530,72889
5699,90,601801,500,896880,825130,71750
5699,90,601801,50,896469,826730,69739
5699,90,601801,500,896969,827780,69189
5699,90,601801,500,897380,828730,68650
5699,90,601801,50,897019,829780,67239
5699,90,601801,500,897519,831130,66389
5699,90,601801,500,897880,832280,65600
5699,90,601801,50,897569,833480,64089
5699,90,601801,50,897619,835480,62139
5699,90,601801,50,897669,837030,60639
5700,83,601886,500,898169,840080,58089
5700,83,601886,50,897930,841730,56200
5700,83,601886,50,897980,843330,54650
5700,83,601886,500,898480,844880,53600
5700,83,601886,50,898219,846480,51739
5700,83,601886,500,898719,849230,49489
5700,83,601886,500,898980,850680,48300
5700,83,601886,50,898769,852280,46489
5700,83,601886,500,899269,853380,45889
5700,83,601886,50,899030,855480,43550
5699,90,601801,500,899530,856880,42650
5701,90,601905,50,899319,858430,40889
5701,90,601905,500,899819,859630,40189
5701,90,601905,50,899580,860730,38850
5701,90,601905,50,899630,862780,36850
5701,90,601905,50,899680,863080,36600
5701,90,601905,50,899730,865680,34050
5701,90,601905,50,899780,866730,33050
5701,90,601905,500,900280,868380,31900
5701,90,601905,50,899869,869280,30589
5701,90,601905,500,900369,869680,30689
5701,90,601905,50,900330,871230,29100
5701,90,601905,500,900830,872380,28450
5701,90,601905,500,900869,873930,26939
5701,90,601905,500,901330,874930,26400
5702,81,601940,50,900919,877080,23839
5702,81,601940,50,900969,878630,22339
5702,81,601940,500,901469,880480,20989
5702,81,601940,500,901830,881530,20300
5702,81,601940,50,901519,882580,18939
5702,81,601940,50,901569,884180,17389
5702,81,601940,50,901619,884780,16839
5702,81,601940,50,901669,885780,15889
5702,81,601940,50,901719,887280,14439
5702,81,601940,50,901769,888730,13039
5702,81,601940,500,902269,889530,12739
5702,81,601940,50,901880,890880,11000
5703,84,601978,50,901930,892480,9450
5703,84,601978,500,902430,893480,8950
5703,84,601978,50,902319,894880,7439
5703,84,601978,50,902369,896080,6289
5703,84,601978,500,902869,897680,5189
5703,84,601978,500,902930,899980,2950
5703,84,601978,50,902919,900530,2389
5703,84,601978,50,902969,902530,439
5703,84,601978,500,903430,904080,-650
5703,84,601978,500,903469,905730,-2261
5703,84,601978,500,903930,907580,-3650
5703,84,601978,500,903969,909780,-5811
5703,84,601978,500,904430,911630,-7200
5701,90,601905,500,904469,912130,-7661
5701,90,601905,500,904930,913230,-8300
5701,90,601905,500,904969,913830,-8861
5701,90,601905,50,904980,915480,-10500
5704,83,602254,50,905019,917030,-12011
5704,83,602254,500,905480,918980,-13500
5704,83,602254,500,905519,919530,-14011
5704,83,602254,50,905530,921480,-15950
5704,83,602254,500,906019,922580,-16561
5704,83,602254,50,905580,923380,-17800
5704,83,602254,50,905630,924880,-19250
5704,83,602254,500,906130,925730,-19600
5704,83,602254,500,906519,927630,-21111
5705,85,602418,50,906180,930230,-24050
5705,85,602418,50,906230,932030,-25800
5705,85,602418,500,906730,933880,-27150
5705,85,602418,500,907019,935580,-28561
5705,85,602418,50,906780,937230,-30450
5705,85,602418,500,907280,938180,-30900
5705,85,602418,500,907519,938730,-31211
5705,85,602418,50,907330,940480,-33150
5705,85,602418,50,907380,942230,-34850
5705,85,602418,50,907430,944780,-37350
5706,81,602473,500,907930,945980,-38050
5706,81,602473,50,907569,947080,-39511
5706,81,602473,50,907619,947730,-40111
5706,81,602473,50,907669,950280,-42611
5706,81,602473,50,907719,951280,-43561
5706,81,602473,50,907769,953330,-45561
5706,81,602473,50,907819,955130,-47311
5706,81,602473,50,907869,956980,-49111
5706,81,602473,500,908369,958880,-50511
5706,81,602473,500,908430,959280,-50850
5706,81,602473,50,908419,960380,-51961
5705,85,602418,500,908919,961030,-52111
5707,82,602533,500,908930,963030,-54100
5707,82,602533,50,908969,965380,-56411
5707,82,602533,50,908980,966730,-57750
5707,82,602533,50,909019,967330,-58311
5707,82,602533,50,909030,968880,-59850
5707,82,602533,50,909069,970030,-60961
5707,82,602533,50,909080,972180,-63100
5707,82,602533,50,909119,973780,-64661
5707,82,602533,50,909130,974780,-65650
5707,82,602533,50,909169,976130,-66961
5707,82,602533,500,909630,977180,-67550
5707,82,602533,50,909219,978380,-69161
5707,82,602533,500,909719,979330,-69611
5706,81,602473,500,910130,980530,-70400
5708,82,602818,500,910219,982330,-72111
5708,82,602818,500,910630,983480,-72850
5708,82,602818,500,910719,985530,-74811
5708,82,602818,500,911130,987130,-76000
5708,82,602818,500,911219,987830,-76611
5708,82,602818,500,911630,989430,-77800
5708,82,602818,50,911269,992330,-81061
5708,82,602818,500,911769,993930,-82161
5708,82,602818,500,912130,995480,-83350
5708,82,602818,500,912269,997130,-84861
5708,82,602818,500,912630,998880,-86250
5709,80,602828,50,912319,999980,-87661
5709,80,602828,50,912369,999830,-87461
