job_id,tasks_num_of_single_job,task_generation_time,total_time,complation_time,complation_time_ordered,shortened_completion_time
0,87,481,21000,1082,1082,0
1,89,755,28300,2482,1759,723
2,90,766,22950,2634,2305,329
3,89,1010,20200,2356,2834,-478
4,88,1228,25550,3810,2958,852
5,84,1298,26250,3909,3736,173
6,90,1650,24300,5032,3689,1343
7,83,2046,23950,5209,4006,1203
8,87,2079,24600,4559,4285,274
9,83,2320,22600,4837,4409,428
10,80,3664,22900,5234,4890,344
11,86,3851,21400,5490,5314,176
12,85,3965,21350,6062,5583,479
13,82,4366,23000,6358,5868,490
14,83,4817,23500,6834,6766,68
15,83,5074,23950,7384,7440,-56
16,80,5291,21550,8721,7562,1159
17,81,5488,22500,9937,7339,2598
18,84,5575,25800,10468,8506,1962
19,85,5611,25400,9385,8567,818
20,88,5653,23750,9911,9262,649
21,88,6080,26900,9034,9962,-928
22,83,6458,25750,9791,10366,-575
23,80,7089,20650,9986,9221,765
24,83,7783,22600,10838,9866,972
25,84,8174,22650,10862,10221,641
26,80,8244,22450,11210,10670,540
27,80,8538,22000,11619,11770,-151
28,87,9019,25050,12537,11875,662
29,82,9200,22100,11836,12163,-327
30,87,9908,23250,12962,12366,596
31,83,9998,22150,12571,11923,648
32,85,10120,22700,13663,12435,1228
33,83,10402,23950,13038,12713,325
34,81,11155,21150,13440,13546,-106
35,87,11684,21900,13837,13764,73
36,84,11715,22650,13767,13985,-218
37,81,12261,25200,15064,14596,468
38,80,12686,22900,15388,15116,272
39,90,13006,25650,15863,16321,-458
40,83,13091,22150,15090,16948,-1858
41,80,13192,23800,15590,17371,-1781
42,81,13247,18900,16771,15315,1456
43,86,13540,22750,17867,15880,1987
44,80,14180,21550,18367,16235,2132
45,83,14330,19900,16895,16780,115
46,83,15842,22150,17814,17548,266
47,90,16014,23400,18266,18098,168
48,89,16074,22000,18288,18598,-310
49,81,16097,24750,18493,18371,122
50,87,16613,23250,20894,19051,1843
51,90,16899,24300,19494,19598,-104
52,80,17004,19300,19612,19615,-3
53,84,17676,23550,21036,20528,508
54,89,17832,26050,20823,20119,704
55,84,17921,25350,21894,20832,1062
56,89,17965,25600,22394,21253,1141
57,88,18399,25550,22521,20865,1656
58,89,18490,24250,22422,21143,1279
59,87,19346,25950,22394,21726,668
60,80,20025,23350,22846,23250,-404
61,90,20463,27900,23673,24276,-603
62,87,20570,27750,24446,22618,1828
63,89,20596,22450,24594,22997,1597
64,83,20788,20350,24671,23955,716
65,86,21220,24550,25462,24592,870
66,86,21997,23200,26299,24330,1969
67,86,22023,23650,26586,25242,1344
68,81,22934,19350,27294,25505,1789
69,84,22965,21750,26646,25970,676
70,82,23014,23000,27197,26321,876
71,84,23049,25350,28146,27321,825
72,82,23328,23450,28473,26450,2023
73,80,23357,22900,28597,26667,1930
74,86,23832,20500,29496,27020,2476
75,83,24091,19450,27039,27807,-768
76,90,24305,23850,28247,28267,-20
77,89,24710,27850,28700,28279,421
78,89,24893,25600,28994,28909,85
79,85,25370,25850,30296,29910,386
80,80,25416,22000,30000,30410,-410
81,82,25541,21650,30950,29529,1421
82,82,25925,24350,31857,29778,2079
83,89,26146,24250,31889,30544,1345
84,89,26328,27400,31647,31144,503
85,83,26896,21700,32141,31694,447
86,89,26981,28300,32826,31402,1424
87,88,27047,25550,34397,32040,2357
88,83,27420,24400,35526,32753,2773
89,90,27561,25650,36597,33861,2736
90,90,27779,21150,32575,33320,-745
91,86,27805,21850,33075,33502,-427
92,89,27917,28300,33448,33457,-9
93,84,28003,20850,33775,34260,-485
94,87,28517,23700,34096,33090,1006
95,82,28642,22550,34589,34990,-401
96,83,29210,28450,35624,35005,619
97,86,29317,20950,37039,34378,2661
98,81,29471,18000,37910,34572,3338
99,88,30071,22400,35728,35129,599
100,84,30680,24900,36728,37105,-377
101,83,30796,24400,37718,39779,-2061
102,89,31761,24250,38218,40303,-2085
103,81,32215,18000,38353,40335,-1982
104,84,32250,21300,38549,37490,1059
105,85,32414,22250,39328,37609,1719
106,81,32609,20250,40028,38072,1956
107,90,32663,26550,40078,38844,1234
108,89,33007,22450,41089,40042,1047
109,85,33366,24500,41740,40349,1391
110,88,33637,28700,42739,38194,4545
111,85,33690,23600,42539,39309,3230
112,82,33833,21650,42940,40354,2586
113,86,33975,22300,40229,40904,-675
114,87,35252,25950,41329,42103,-774
115,88,35524,25100,40437,42709,-2272
116,83,35599,24400,40791,40608,183
117,85,35665,24500,41263,41963,-700
118,85,35915,24050,42346,43213,-867
119,89,35998,25600,43543,43739,-196
120,89,37055,22000,43654,43212,442
121,87,37284,22350,44154,43329,825
122,90,38080,25650,44946,43280,1666
123,83,38877,22150,45096,44153,943
124,88,39273,30050,45912,44653,1259
125,90,39774,26550,47041,45203,1838
126,90,40098,25200,48141,45480,2661
127,82,40149,26600,48662,45253,3409
128,87,40190,22350,49712,45140,4572
129,82,41674,20750,49196,46339,2857
130,88,41710,25100,49246,47065,2181
131,83,41736,22600,49746,47709,2037
132,85,42704,25850,50356,48054,2302
133,87,42723,27300,50301,48157,2144
134,84,43171,21300,50746,47903,2843
135,85,43174,20000,51050,48142,2908
136,80,43375,21100,48047,48603,-556
137,89,43477,26050,47698,48794,-1096
138,86,43582,22300,48143,48944,-801
139,83,43621,20800,48339,49444,-1105
140,87,43730,25950,49213,49880,-667
141,84,44377,23100,50803,49103,1700
142,85,46146,20000,51348,49674,1674
143,82,46445,26150,52353,50603,1750
144,87,47125,19200,52956,50594,2362
145,80,47327,22450,53448,50987,2461
146,88,48182,26450,54448,51700,2748
147,88,48370,27800,55498,52392,3106
148,87,48531,24600,56256,52700,3556
149,87,48883,20100,56996,52781,4215
150,88,48936,20150,57496,53041,4455
151,88,49026,24200,57508,54541,2967
152,87,49197,22800,53043,53490,-447
153,83,49199,23500,53835,53990,-155
154,83,49744,23050,55585,54605,980
155,82,49858,22550,56635,55142,1493
156,80,49886,20650,58050,55455,2595
157,87,50011,25950,56491,56005,486
158,85,50014,23150,56563,56444,119
159,86,50072,24100,58003,55844,2159
160,88,50120,23300,57748,55801,1947
161,80,51136,25150,59046,57501,1545
162,86,51236,23200,60046,58391,1655
163,88,52107,20600,60408,59641,767
164,85,52175,26750,60908,61191,-283
165,90,52707,24750,61703,62232,-529
166,87,52774,25500,62458,59157,3301
167,80,52986,22900,63253,59757,3496
168,81,53211,23850,63848,60465,3383
169,84,53472,21750,64458,60455,4003
170,89,54016,20200,64953,61505,3448
171,90,54118,27000,64508,62492,2016
172,84,54669,23100,59650,62155,-2505
173,90,55033,23850,62238,60571,1667
174,83,55127,26650,62450,60524,1926
175,85,55261,22700,66250,62601,3649
176,82,55329,22100,65188,63002,2186
177,82,55359,20750,66238,63701,2537
178,82,55361,25700,67788,62749,5039
179,90,55640,22950,62704,63252,-548
180,87,55835,25500,63804,64139,-335
181,80,56163,22000,64350,64757,-407
182,89,56859,24250,69303,65907,3396
183,90,57087,26100,69496,66899,2597
184,87,57215,20550,70046,67557,2489
185,80,57622,22900,70098,68057,2041
186,85,57834,25400,70610,67544,3066
187,83,57873,21700,71110,67959,3151
188,89,57903,24700,72298,68644,3654
189,80,57945,17950,72210,69144,3066
190,82,58488,21650,72760,69644,3116
191,85,58515,23150,73053,70405,2648
192,85,58755,23600,73410,70794,2616
193,88,58968,22400,75246,70505,4741
194,87,59053,25500,74898,65840,9058
195,83,59200,19450,75810,67488,8322
196,88,59364,23300,76410,68051,8359
197,86,61018,22750,76546,68854,7692
198,87,61372,20100,71037,71192,-155
199,90,61760,24750,69289,71104,-1815
200,86,61891,24550,69789,70249,-460
201,90,61983,24750,70051,70902,-851
202,83,62118,20350,69996,71496,-1500
203,82,62331,22550,70845,71552,-707
204,88,62355,22850,70650,72357,-1707
205,83,62573,23050,71852,73096,-1244
206,90,63145,25650,72852,73499,-647
207,82,63853,23900,73788,73989,-201
208,89,63938,25600,73503,73594,-91
209,88,64365,26450,74788,74544,244
210,84,64743,21300,76288,75155,1133
211,90,65103,23400,76838,75794,1044
212,85,65134,22250,76803,76642,161
213,80,65374,23800,73943,77164,-3221
214,81,66287,22500,75708,77744,-2036
215,89,66657,26500,77808,78394,-586
216,82,66914,21200,78411,78864,-453
217,81,67213,23400,80011,79494,517
218,83,67273,23050,81261,79844,1417
219,87,67876,19650,82911,78485,4426
220,88,68010,28250,78056,80135,-2079
221,89,68450,25600,78606,77554,1052
222,83,68517,24400,81002,79304,1698
223,81,68554,22500,81856,80104,1752
224,86,69668,22750,85406,81154,4252
225,82,69680,20300,85002,77409,7593
226,89,69742,24250,84952,78239,6713
227,89,69798,21100,86852,78554,8298
228,85,70123,25850,88806,79907,8899
229,83,70152,23950,83699,80964,2735
230,87,71088,24150,83996,81242,2754
231,81,71256,18900,85053,82094,2959
232,85,71289,22250,84710,82364,2346
233,83,71804,22600,85560,82907,2653
234,82,71941,26150,86560,83244,3316
235,81,71985,21150,86653,83842,2811
236,86,72187,24550,80038,84294,-4256
237,84,72364,28950,82088,85344,-3256
238,90,72753,22050,83306,85842,-2536
239,81,72870,24300,84688,86744,-2056
240,90,73596,24750,86006,87092,-1086
241,83,73621,24850,87060,88044,-984
242,85,73642,22250,87710,88694,-984
243,80,73791,19750,87900,89394,-1494
244,85,73958,18200,88538,89514,-976
245,83,74112,23500,89688,90014,-326
246,84,74317,23550,83549,90994,-7445
247,80,74924,21100,84259,91494,-7235
248,83,74971,23950,84670,91694,-7024
249,84,75164,28050,85556,92042,-6486
250,89,75268,24700,86099,87201,-1102
251,82,75882,20300,87013,88046,-1033
252,84,76068,23550,88210,88306,-96
253,83,76378,21700,88710,88689,21
254,85,76539,24050,89310,89606,-296
255,83,76705,28450,90251,90656,-405
256,86,76814,21400,90360,91456,-1096
257,84,77389,27150,91248,95054,-3806
258,82,77508,19850,91960,96206,-4246
259,90,77510,21600,92312,97704,-5392
260,82,78328,20300,94060,99754,-5694
261,84,78377,24900,94000,100954,-6954
262,84,78485,22200,94648,92446,2202
263,85,78835,28100,95550,93281,2269
264,85,79080,21350,96260,93946,2314
265,80,79177,22900,97260,94496,2764
266,87,79267,22350,98200,94613,3587
267,84,79286,26700,98348,93258,5090
268,90,79594,24300,99503,93909,5594
269,88,79679,26450,99500,94041,5459
270,84,79932,24450,100050,93715,6335
271,90,80410,23400,100710,94188,6522
272,81,80598,23850,95249,94705,544
273,81,80726,20250,96572,95396,1176
274,83,80733,23950,97999,95851,2148
275,83,80783,20800,93292,96477,-3185
276,83,81135,22600,95206,96718,-1512
277,86,81722,25900,97105,96496,609
278,80,82051,21100,99205,96542,2663
279,88,82240,27350,101605,97094,4511
280,80,82333,18400,101655,97559,4096
281,85,82634,22700,103306,97794,5512
282,81,83003,20250,104405,98294,6111
283,80,83016,23350,102210,98692,3518
284,88,83307,27350,102548,98944,3604
285,80,84041,18850,102509,99344,3165
286,88,84064,25100,97101,99494,-2393
287,86,84374,24100,98087,99660,-1573
288,82,85956,23000,99251,100263,-1012
289,86,86421,25450,100351,101096,-745
290,84,87080,22650,100363,101655,-1292
291,87,87816,25500,102513,102341,172
292,90,88111,26550,103366,103255,111
293,82,88657,19850,103960,103763,197
294,89,88940,21550,104698,104396,302
295,82,89084,23450,105452,104896,556
296,89,89302,25600,106052,105610,442
297,83,90171,25300,106760,106110,650
298,88,90333,21950,107310,106313,997
299,80,90614,22000,108102,104044,4058
300,83,90887,22150,108860,104614,4246
301,82,91717,27500,109453,105567,3886
302,87,92132,25050,109966,106201,3765
303,86,92291,22300,110152,107301,2851
304,88,92870,25100,111252,108351,2901
305,89,93670,21100,111698,107846,3852
306,87,94153,23700,111953,108496,3457
307,86,94345,26350,112616,108744,3872
308,88,95058,26450,113660,108994,4666
309,89,95153,27400,114152,103540,10612
310,87,95244,26400,106948,104486,2462
311,83,95268,22600,106940,106635,305
312,90,95351,23850,107490,107677,-187
313,82,96314,21650,108640,108301,339
314,85,96507,27200,112090,109696,2394
315,80,96577,21100,112590,110196,2394
316,90,96579,25650,113090,110361,2729
317,90,96831,24300,114740,110696,4044
318,84,97185,21300,115759,110041,5718
319,88,97200,26900,118340,110557,7783
320,82,97221,22550,118009,111110,6899
321,90,97376,27900,110442,112191,-1749
322,87,97504,26400,111101,112691,-1590
323,90,97770,25200,111601,113346,-1745
324,85,98810,21800,109964,113846,-3882
325,81,98959,20700,111991,114460,-2469
326,83,98993,19900,112313,115357,-3044
327,80,101028,22900,113191,115613,-2422
328,80,101275,22900,114453,115841,-1388
329,88,101450,25550,114862,115374,-512
330,83,102327,20800,115148,115815,-667
331,88,102589,24200,115698,115194,504
332,80,102824,22000,116248,115863,385
333,80,103384,18850,117102,116444,658
334,88,103437,30050,117702,117146,556
335,84,103683,19050,117948,117666,282
336,89,104548,25150,119066,118885,181
337,89,104616,20200,119902,120635,-733
338,80,104688,21100,120048,119544,504
339,81,105042,22500,121162,120163,999
340,90,105055,25200,121416,120763,653
341,80,105428,17950,121752,121413,339
342,89,105727,26050,122302,121566,736
343,85,105728,28100,123116,115894,7222
344,84,105835,19950,123862,116370,7492
345,89,105914,22450,124462,116975,7487
346,83,105978,23500,124503,119504,4999
347,80,106260,20650,125653,120211,5442
348,88,106325,24650,125802,122354,3448
349,81,106403,21150,126248,123411,2837
350,80,106854,22450,122217,124911,-2694
351,87,107341,24150,124113,126011,-1898
352,80,107783,24250,124467,120829,3638
353,82,108664,21650,121690,121329,361
354,80,108750,19300,123790,122094,1696
355,86,108801,22300,123362,121800,1562
356,87,109028,24600,125540,122457,3083
357,88,109095,22850,126740,122900,3840
358,84,109150,25350,127540,123414,4126
359,86,109236,24100,127612,124157,3455
360,85,109790,21800,128762,124914,3848
361,81,110222,21600,130412,125857,4555
362,90,111397,27900,132140,126907,5233
363,85,111753,21350,133162,127214,5948
364,88,111804,26000,135412,127850,7562
365,81,111999,22050,136290,128365,7925
366,88,112495,25550,138112,128941,9171
367,89,112661,23800,139212,126496,12716
368,85,112689,26300,126901,127354,-453
369,80,112875,18850,124808,127854,-3046
370,84,113055,24000,125048,127794,-2746
371,81,113830,21150,126100,128548,-2448
372,82,114010,22550,126552,128894,-2342
373,85,114274,23600,127012,129716,-2704
374,88,114503,25550,127798,130649,-2851
375,82,115257,24350,128166,130494,-2328
376,82,115826,17600,128402,130813,-2411
377,83,116319,20350,128798,126663,2135
378,90,116578,25650,130362,127681,2681
379,88,116616,23750,130548,128046,2502
380,86,117100,22300,131366,128546,2820
381,88,117498,25100,133352,129020,4332
382,82,117903,25700,135178,130020,5158
383,82,119543,22100,137752,130914,6838
384,81,119553,21600,137128,131464,5664
385,82,119591,23900,137278,132014,5264
386,85,119783,21800,136703,132363,4340
387,82,120293,23000,137253,132898,4355
388,90,120726,26550,137761,133568,4193
389,80,120822,19300,136862,134194,2668
390,82,120901,22550,137305,134420,2885
391,88,120986,26900,137067,135396,1671
392,90,121309,22500,137717,136411,1306
393,89,121392,26950,135351,137406,-2055
394,81,121490,22050,135949,137821,-1872
395,84,121796,25800,137951,138346,-395
396,80,121933,22000,141101,138364,2737
397,89,121984,24700,140699,138864,1835
398,90,122824,23850,143151,139541,3610
399,85,123067,23600,145499,139964,5535
400,81,123241,22500,146251,134726,11525
401,88,123490,23750,139266,135226,4040
402,88,123767,22400,139652,135794,3858
403,85,124132,24050,141105,136944,4161
404,89,124224,29650,141266,139494,1772
405,80,124362,19750,142114,140357,1757
406,89,124532,25150,142798,140602,2196
407,81,124789,19350,143402,141243,2159
408,87,125153,25950,144164,141564,2600
409,85,125592,24050,144948,142154,2794
410,83,125635,20350,145702,139646,6056
411,84,125703,21750,145805,139868,5937
412,90,125896,26100,146702,140248,6454
413,90,127149,27900,147414,140663,6751
414,84,127943,24450,147505,141294,6211
415,88,128435,26450,148402,142073,6329
416,80,128660,19300,148966,142905,6061
417,89,129415,26050,149614,143681,5933
418,82,129438,18950,150114,144322,5792
419,80,129973,17950,150516,144831,5685
420,83,130154,23050,144260,145399,-1139
421,80,130388,23800,148060,145922,2138
422,87,130486,23250,148464,146422,2042
423,85,131204,25850,145112,147081,-1969
424,80,131237,20650,146812,148055,-1243
425,84,131299,25350,146743,148581,-1838
426,82,131321,19850,146793,148722,-1929
427,83,131449,22150,148812,149231,-419
428,82,131656,23450,149893,151513,-1620
429,89,132711,25600,151162,153013,-1851
430,86,133073,26800,152593,154713,-2120
431,80,133367,18850,153693,156263,-2570
432,85,133484,25850,155112,158456,-3344
433,89,133706,20200,156712,158913,-2201
434,82,133716,19400,157212,150717,6495
435,88,133863,24200,152317,150804,1513
436,87,133968,23700,152917,151509,1408
437,87,134035,25500,145839,152009,-6170
438,87,134417,25950,146791,152987,-6196
439,90,134716,23400,148391,153454,-5063
440,86,134948,23650,149891,153514,-3623
441,86,135752,24550,150541,146363,4178
442,85,136700,23600,150855,147318,3537
443,90,137077,20700,151398,149141,2257
444,82,137459,25700,151955,150641,1314
445,82,137493,21650,152814,151022,1792
446,90,138261,28800,153005,151801,1204
447,81,138701,27000,153505,153344,161
448,83,139025,23500,154866,154014,852
449,84,139058,23550,154514,154564,-50
450,85,139120,22700,154848,154773,75
451,85,139614,23150,155398,155355,43
452,86,139679,27250,155704,155855,-151
453,82,139737,24350,156105,156522,-417
454,81,139937,27000,156754,157651,-897
455,81,140016,23400,157516,158022,-506
456,82,140689,21650,157855,158751,-896
457,82,140749,25700,158714,159655,-941
458,85,140977,25400,159316,160951,-1635
459,83,141345,22600,159954,161123,-1169
460,81,141412,20250,159755,161255,-1500
461,83,141578,23950,160598,161723,-1125
462,81,141793,24300,161814,162223,-409
463,86,141862,20950,162004,162922,-918
464,81,142064,22500,162305,163972,-1667
465,80,142099,22450,162805,164431,-1626
466,89,142386,24250,163817,165122,-1305
467,84,142513,19500,164317,165523,-1206
468,88,142964,27800,164805,166622,-1817
469,84,143014,23550,165640,166851,-1211
470,80,144088,20650,166140,160098,6042
471,80,144186,21100,166405,160648,5757
472,83,144929,23500,167333,160848,6485
473,81,144946,22050,167455,161248,6207
474,81,145323,22950,167840,161846,5994
475,80,145384,19750,166117,162298,3819
476,82,145528,21650,167957,164158,3799
477,82,145801,25700,169055,165387,3668
478,90,146308,17550,168367,165996,2371
479,85,146568,23150,168917,167637,1280
480,80,146983,21100,171070,169287,1783
481,82,147881,22100,170262,170946,-684
482,85,148043,20450,172395,171246,1149
483,85,148267,25400,161594,174287,-12693
484,87,148377,28650,175695,175787,-92
485,85,148424,25850,178395,177546,849
486,82,148460,19850,178112,178046,66
487,81,148850,20700,179262,163649,15613
488,90,149347,23850,180762,164143,16619
489,88,149360,25550,182812,164643,18169
490,81,149469,21600,183495,164298,19197
491,89,149957,23800,184562,164848,19714
492,80,150043,23350,185612,166201,19411
493,86,150152,23650,164614,167801,-3187
494,89,150272,25150,165569,170947,-5378
495,87,150283,26400,163850,172551,-8701
496,86,150457,26350,165401,173647,-8246
497,83,151773,21250,167104,168431,-1327
498,83,151833,24400,168654,169101,-447
499,85,151961,20000,171051,169123,1928
500,90,152058,23400,171054,169272,1782
501,84,152279,24900,172801,169772,3029
502,81,152636,25200,174351,171613,2738
503,88,152866,27800,176254,171231,5023
504,83,153494,22150,167466,171781,-4315
505,87,154730,26400,169306,172281,-2975
506,82,154789,22100,169566,172901,-3335
507,83,155067,21250,170666,173401,-2735
508,81,155143,25200,172716,174281,-1565
509,89,156091,23350,173766,175001,-1235
510,88,156163,21050,175256,175222,34
511,81,156374,26100,177216,175481,1735
512,83,156461,23500,177606,175873,1733
513,83,156920,26200,179806,176531,3275
514,88,157109,27800,180866,177151,3715
515,87,157917,23250,182516,178201,4315
516,82,158060,20750,183256,178957,4299
517,88,158421,24200,183806,179751,4055
518,88,158738,20600,178007,180251,-2244
519,84,158802,21750,178490,180722,-2232
520,88,158950,22850,179255,181323,-2068
521,89,159108,25150,181157,181823,-666
522,87,159199,18300,180985,182301,-1316
523,82,159475,24350,181790,182607,-817
524,86,159756,20500,182857,183107,-250
525,88,159769,25550,183105,183722,-617
526,87,159956,22350,183605,179719,3886
527,89,160448,20200,184040,180498,3542
528,89,160796,25150,184205,181050,3155
529,89,161532,26950,185090,181520,3570
530,80,162019,24700,185373,182548,2825
531,81,162126,22500,186707,182898,3809
532,82,162155,20750,186523,183220,3303
533,81,162257,22500,186985,183750,3235
534,84,162346,24000,187023,184013,3010
535,82,162381,23000,183261,184948,-1687
536,86,162415,27250,183655,184990,-1335
537,80,162541,21100,184104,186846,-2742
538,84,162607,26250,185096,188740,-3644
539,89,162616,26950,185419,191090,-5671
540,88,163054,25100,186204,192590,-6386
541,81,163166,22500,187703,194246,-6543
542,81,163733,19800,189303,196440,-7137
543,81,163949,24300,191104,197372,-6268
544,86,164049,23200,190903,198233,-7330
545,81,164098,20250,192503,198807,-6304
546,85,164997,20000,194003,199351,-5348
547,84,165189,22650,195204,199522,-4318
548,89,165371,26950,196393,200233,-3840
549,81,165947,21600,196944,200975,-4031
550,80,166244,25600,198543,201122,-2579
551,85,166275,26300,198649,199040,-391
552,85,166649,25850,197754,200690,-2936
553,80,166937,20650,198954,202496,-3542
554,83,167056,21250,201654,203596,-1942
555,85,167059,24050,201853,206196,-4343
556,90,167286,25200,185456,207840,-22384
557,83,167297,26650,184908,208896,-23988
558,87,167450,23250,185462,187474,-2012
559,84,167486,26250,185852,188251,-2399
560,85,167649,20450,186012,188751,-2739
561,81,167817,23400,188633,189395,-762
562,87,167875,25050,188683,189843,-1160
563,81,168365,22500,189373,185683,3690
564,82,168593,19850,189873,186256,3617
565,82,169024,23450,190659,186763,3896
566,84,169367,20400,192448,187948,4500
567,88,170312,24650,194112,188550,5562
568,82,170858,23000,196362,189370,6992
569,87,170917,25500,198548,189900,8648
570,86,171527,22300,199212,190198,9014
571,84,171743,24900,200358,190698,9660
572,86,171815,24100,200557,191770,8787
573,89,172103,24700,201757,192250,9507
574,85,172226,25850,201966,192870,9096
575,86,172282,24100,202466,194100,8366
576,89,173418,24700,203148,194748,8400
577,80,173598,18850,203608,195248,8360
578,85,175116,23150,204116,195750,8366
579,86,176627,23650,202162,196100,6062
580,85,176716,22250,203498,196600,6898
581,80,176740,19300,203362,197100,6262
582,85,176851,25850,204512,197548,6964
583,84,177185,23100,206198,197820,8378
584,86,177863,24100,206762,198420,8342
585,90,178187,22500,208348,199200,9148
586,85,178446,24500,209312,199970,9342
587,84,178621,21750,202823,200250,2573
588,82,178953,24350,203823,200765,3058
589,80,178987,25150,204285,201350,2935
590,86,179090,23200,204409,202098,2311
591,84,179758,22650,204835,202450,2385
592,81,180210,20250,205209,203415,1794
593,88,180213,22850,205573,198310,7263
594,83,180388,21250,206073,200286,5787
595,81,180945,24750,201019,201360,-341
596,89,181006,21100,201346,204200,-2854
597,84,181060,23100,201796,204948,-3152
598,90,181085,25200,196423,205250,-8827
599,83,181306,19900,197620,205702,-8082
600,90,181674,25650,206559,206350,209
601,81,181748,22050,207259,206515,744
602,85,181890,22700,208659,207020,1639
603,84,182049,25800,212370,207515,4855
604,82,182146,25250,212719,206257,6462
605,85,182425,21350,213268,207748,5520
606,83,182457,23500,213748,208515,5233
607,80,183440,21550,214296,209122,5174
608,82,183513,22550,214748,209622,5126
609,81,184637,17100,215448,208835,6613
610,80,184735,24250,215468,209798,5670
611,82,185317,22100,216046,209914,6132
612,81,185424,19800,216468,209674,6794
613,90,185537,25650,214209,210457,3752
614,90,185555,27000,217959,210951,7008
615,88,185621,26900,218209,211825,6384
616,83,185876,22150,220959,212825,8134
617,89,185882,22450,221159,213485,7674
618,86,186597,22300,221759,214051,7708
619,82,186697,23000,223259,214657,8602
620,83,187252,21700,211255,215225,-3970
621,86,187350,22750,211293,216135,-4842
622,88,187886,24650,213543,216975,-3432
623,86,187902,23200,212905,217575,-4670
624,88,187920,29150,213644,218557,-4913
625,80,189025,19300,214055,218735,-4680
626,81,189324,22500,214543,219225,-4682
627,87,190788,25050,215593,219785,-4192
628,88,190813,23300,216049,220335,-4286
629,87,190879,21900,214883,220872,-5989
630,82,190928,22100,214056,221325,-7269
631,81,191103,18450,215656,221501,-5845
632,89,191234,22900,216632,221222,-4590
633,82,191614,28850,217833,222222,-4389
634,80,191629,18850,217456,222325,-4869
635,81,191820,25200,218333,212439,5894
636,89,191930,21550,215455,213989,1466
637,88,191931,22400,215844,215060,784
638,86,192269,23200,216005,215160,845
639,88,192761,25100,216473,216289,184
640,83,192938,23950,217159,218889,-1730
641,80,193063,23800,217444,220389,-2945
642,84,193267,20850,218557,222439,-3882
643,80,193451,23350,219553,222539,-2986
644,86,194454,25900,220357,224060,-3703
645,80,194758,23800,220907,225789,-4882
646,88,194768,21050,221953,227439,-5486
647,81,195423,19800,223507,228514,-5007
648,85,195862,24050,225553,229200,-3647
649,84,196083,23550,226557,230250,-3693
650,90,196199,26100,227753,230581,-2828
651,87,196673,23700,229453,230929,-1476
652,82,196963,28850,231757,230489,1268
653,88,197079,19700,232803,231214,1589
654,81,197083,25650,214957,231733,-16776
655,88,197181,25100,216201,232160,-15959
656,81,198388,20700,218962,233189,-14227
657,84,198462,24900,219301,225296,-5995
658,81,198588,21600,220762,225846,-5084
659,82,198911,23900,221466,227343,-5877
660,85,199499,26300,222566,228125,-5559
661,81,199536,21150,222916,228851,-5935
662,82,199827,20300,223358,228972,-5614
663,82,199927,21650,223850,229351,-5501
664,83,200196,23050,224382,229657,-5275
665,90,200493,26100,224932,230022,-5090
666,87,200520,20100,226426,229993,-3567
667,89,200605,25150,226719,227047,-328
668,86,200902,23650,228819,229147,-328
669,85,201002,23150,229776,230847,-1071
670,84,201115,19950,231426,232047,-621
671,89,201135,24700,235169,233647,1522
672,85,201209,23600,235176,234058,1118
673,88,201412,28700,237976,235058,2918
674,85,201889,23600,238869,236947,1922
675,84,202419,20400,240926,237808,3118
676,89,202807,23350,243369,238747,4622
677,84,203075,23100,243776,238858,4918
678,84,203930,19950,244576,230441,14135
679,89,203951,24250,245376,230857,14519
680,84,204512,24450,245319,231491,13828
681,88,204740,21500,232409,231327,1082
682,90,205517,21600,233118,232151,967
683,87,206973,24600,233508,232641,867
684,85,207462,24950,234108,233022,1086
685,85,207855,25400,234950,234022,928
686,81,207924,24750,234709,234451,258
687,81,208221,24300,236808,235622,1186
688,81,208279,22950,236818,236622,196
689,89,208428,25150,237359,236991,368
690,86,208943,22750,238250,238041,209
691,85,209398,23600,238459,239091,-632
692,87,209621,27750,238959,239641,-682
693,83,209677,22150,239850,240741,-891
694,87,209730,20550,240218,241241,-1023
695,81,209828,19800,240618,242157,-1539
696,84,210108,22200,241509,243077,-1568
697,82,210325,21650,242109,243577,-1468
698,81,210541,25200,243018,244207,-1189
699,81,210662,23850,243518,244951,-1433
700,88,211343,25100,244500,245541,-1041
701,89,211388,26500,244568,245827,-1259
702,84,211633,19950,245568,246307,-739
703,87,212427,25050,245958,247027,-1069
704,82,212481,25700,246218,248091,-1873
705,83,213630,21250,247118,248641,-1523
706,86,214533,23200,247950,249477,-1527
707,89,214593,22450,248368,250007,-1639
708,88,214669,22850,248508,250607,-2099
709,86,215091,20050,249100,250951,-1851
710,90,215387,21150,246961,251077,-4116
711,85,215506,24050,249411,239637,9774
712,88,215597,26000,249759,239701,10058
713,86,215821,25450,251511,239157,12354
714,82,216485,23900,240845,239750,1095
715,88,216493,22400,242211,240215,1996
716,85,216808,21350,243811,237043,6768
717,89,216914,26050,245461,238093,7368
718,87,217584,23250,246461,239098,7363
719,90,217737,24750,248882,240598,8284
720,82,217801,20300,248611,241298,7313
721,87,218275,22350,249482,242298,7184
722,83,218293,25300,251182,244343,6839
723,85,219112,22250,251682,245943,5739
724,87,219434,23700,245820,247993,-2173
725,80,219754,21100,246970,249198,-2228
726,80,219763,22000,248070,251259,-3189
727,80,219877,18850,249770,251841,-2071
728,81,220000,18450,242073,252341,-10268
729,82,220109,25250,242496,252511,-10015
730,88,221253,25100,243005,261654,-18649
731,90,221604,25200,243837,244483,-646
732,80,222476,19300,245323,243556,1767
733,84,222533,27150,245205,240360,4845
734,83,222959,21250,245873,240626,5247
735,86,223176,23650,247559,241560,5999
736,86,223464,22750,249209,242155,7054
737,83,223583,22150,250809,243039,7770
738,80,224220,24700,251773,244639,7134
739,80,224502,22450,252459,245214,7245
740,82,225292,26600,254159,246214,7945
741,89,225311,24700,254310,247763,6547
742,90,226492,27000,255709,249263,6446
743,87,226617,24150,257909,251413,6496
744,81,227515,24750,260859,252441,8418
745,83,227587,25750,261359,253153,8206
746,81,228337,21600,262523,253724,8799
747,87,228445,24150,263559,254224,9335
748,87,228581,22350,254323,254791,-468
749,86,229233,24550,254887,255324,-437
750,88,229845,20150,255387,255811,-424
751,85,229905,21800,255073,256029,-956
752,87,230608,24150,252004,256861,-4857
753,85,230608,22700,252314,257541,-5227
754,86,231536,20050,252914,257974,-5060
755,86,231792,25000,254114,258841,-4727
756,80,231947,21100,255354,259474,-4120
757,88,232056,24650,257764,259829,-2065
758,82,232113,24800,258054,260524,-2470
759,87,232539,25050,259859,261379,-1520
760,81,232651,22950,260650,261879,-1229
761,80,232797,19750,261620,262674,-1054
762,86,232866,23200,261918,262979,-1061
763,83,232903,21700,263200,263853,-653
764,90,232998,21600,263420,264041,-621
765,80,233346,21550,263970,264529,-559
766,83,233466,22600,264610,265061,-451
767,88,233903,23300,264900,266129,-1229
768,90,234099,25200,265268,266761,-1493
769,81,234216,21600,265420,267603,-2183
770,87,234788,28200,265710,268124,-2414
771,84,234871,24900,267222,268679,-1457
772,83,234942,24400,268876,269291,-415
773,81,234949,21150,268926,269791,-865
774,82,235001,24800,269426,270791,-1365
775,80,235244,26050,271176,271311,-135
776,88,235776,27800,272226,272203,23
777,89,236331,25600,275054,272911,2143
778,82,236427,26600,275322,273911,1411
779,86,236558,23200,275976,274274,1702
780,81,237103,21150,277714,274874,2840
781,88,237603,27800,279376,275041,4335
782,89,238241,24250,279772,275503,4269
783,80,238263,23800,264171,276374,-12203
784,87,239322,26400,264802,277053,-12251
785,89,239675,23350,265574,277591,-12017
786,86,239698,20500,265402,278141,-12739
787,90,239975,24750,266502,278361,-11859
788,80,239978,19300,266921,259661,7260
789,88,240219,23300,267068,260558,6510
790,84,240265,24900,262361,262861,-500
791,87,240476,23250,265162,265011,151
792,86,240562,26800,264911,266561,-1650
793,86,240656,24550,266662,268461,-1799
794,84,240830,23550,269562,269550,12
795,82,240875,20300,269161,270911,-1750
796,88,241410,24200,271812,272511,-699
797,84,241430,18150,272261,273061,-800
798,83,241786,26200,273412,272850,562
799,82,242181,21650,274611,270748,3863
800,85,242822,23150,276361,272746,3615
801,87,243107,23700,277561,274848,2713
802,85,243769,27650,278061,277448,613
803,89,244457,26050,279064,278911,153
804,86,244612,23200,280282,279103,1179
805,84,245124,22200,281432,279424,2008
806,82,245214,21650,282464,279513,2951
807,84,245326,23100,283482,280148,3334
808,88,245480,26900,282162,275508,6654
809,82,245512,21650,280562,277058,3504
810,83,245515,22150,283462,278413,5049
811,88,245590,26000,283562,279708,3854
812,83,245726,21250,284203,280863,3340
813,82,246304,21650,285903,280913,4990
814,88,247083,25550,271455,273409,-1954
815,85,247356,22250,271061,273909,-2848
816,90,247400,23400,270807,274156,-3349
817,83,247679,22600,271405,272334,-929
818,84,248117,22200,271449,272639,-1190
819,87,249336,22350,272207,273239,-1032
820,84,249849,20850,272599,273484,-885
821,83,250055,24850,273455,273928,-473
822,80,250162,25600,274057,273663,394
823,82,250289,23450,274961,275041,-80
824,80,250512,21550,276703,276641,62
825,85,250584,21350,277211,277391,-180
826,84,250586,25800,277107,279463,-2356
827,85,250875,22250,277861,280222,-2361
828,82,251057,21200,278955,281972,-3017
829,80,251222,22900,279453,283516,-4063
830,80,251633,28300,280011,284566,-4555
831,90,252273,28350,280555,286272,-5717
832,83,252496,20350,277121,287372,-10251
833,81,252751,22500,277570,289072,-11502
834,89,253048,25600,278260,284774,-6514
835,80,253252,22900,278800,285274,-6474
836,84,253603,20400,279350,286041,-6691
837,81,254250,23400,281000,286663,-5663
838,86,254278,19600,280863,287041,-6178
839,80,254325,20650,280771,287453,-6682
840,89,254512,25600,282050,288574,-6524
841,83,254676,20350,282318,288763,-6445
842,88,255776,24200,283260,289191,-5931
843,83,256365,23500,283670,289553,-5883
844,83,256441,21700,283360,290563,-7203
845,85,256620,25400,282787,291070,-8283
846,81,256680,25200,283287,293488,-10201
847,84,256739,24450,283705,294538,-10833
848,80,256777,25600,284448,296188,-11740
849,83,256878,22600,284475,296688,-12213
850,89,257217,25600,284975,293653,-8678
851,87,257823,25050,285948,294133,-8185
852,80,257854,20650,286537,294924,-8387
853,88,258399,26900,286998,295524,-8526
854,86,258516,21400,287548,295683,-8135
855,88,259324,23750,288698,296363,-7665
856,87,259421,28200,288720,296624,-7904
857,87,259526,25050,289830,297174,-7344
858,90,259885,22050,292630,297611,-4981
859,85,259967,22700,291870,299211,-7341
860,89,260019,25150,296730,301361,-4631
861,87,260072,23700,296720,302053,-5333
862,86,260823,24100,299780,305061,-5281
863,88,261404,25550,299970,306211,-6241
864,89,262181,26500,298007,307103,-9096
865,87,262512,21000,298314,308511,-10197
866,87,263286,22800,299857,310111,-10254
867,81,263764,24300,300464,311653,-11189
868,84,263785,25350,303214,312153,-8939
869,86,264157,23200,304064,303791,273
870,81,264384,24300,305707,304803,904
871,88,264514,25550,306864,305013,1851
872,84,264564,21750,307614,298241,9373
873,82,264853,21650,309664,288976,20688
874,84,265372,21750,311762,289476,22286
875,88,265387,25100,311900,290309,21591
876,86,266572,24100,312762,290912,21850
877,84,266732,21300,313364,291462,21902
878,84,266762,23550,313764,291962,21802
879,83,266805,22600,312857,292561,20296
880,89,267092,26500,314264,293061,21203
881,86,267523,23200,314661,293730,20931
882,80,267653,20650,315857,294598,21259
883,88,267950,24200,314511,296248,18263
884,86,268018,24550,314114,297748,16366
885,81,268268,17100,311979,298049,13930
886,90,268937,23850,312822,300099,12723
887,90,269050,24750,314422,302249,12173
888,84,269810,25800,316072,303899,12173
889,83,270610,25750,296707,305185,-8478
890,82,270805,20300,297415,305724,-8309
891,84,271344,24000,299553,306324,-6771
892,86,271634,25450,300215,306493,-6278
893,83,272120,19000,301253,306824,-5571
894,85,272246,21800,302253,307099,-4846
895,89,272890,24700,302753,295420,7333
896,89,273138,24700,304265,296020,8245
897,88,274256,26450,306453,296764,9689
898,86,275123,22750,307553,297314,10239
899,88,275447,23300,309053,298468,10585
900,90,275938,25650,310253,300122,10131
901,89,276050,24250,311853,301154,10699
902,83,276218,22600,312565,301780,10785
903,89,276218,24250,315453,302519,12934
904,82,276274,26600,316115,303056,13059
905,84,276371,21750,317215,303669,13546
906,80,277341,22900,319353,302722,16631
907,87,277393,24150,322365,303272,19093
908,82,277848,20750,323965,304106,19859
909,83,277929,21250,324653,304322,20331
910,88,278383,24650,300127,304906,-4779
911,86,278411,27250,301607,305937,-4330
912,81,279138,22050,302727,306764,-4037
913,89,279315,26500,300963,307335,-6372
914,81,279681,21600,301601,307643,-6042
915,89,279857,26050,303563,308687,-5124
916,88,279902,25100,303725,309237,-5512
917,81,279940,22050,303560,310335,-6775
918,86,280083,19600,304113,310470,-6357
919,81,280232,22050,304610,310664,-6054
920,83,280424,21700,305075,310724,-5649
921,82,281233,22550,306051,310793,-4742
922,84,281307,21750,306013,311793,-5780
923,89,281887,20200,306907,312455,-5548
924,87,281889,24150,306960,312843,-5883
925,82,281951,20300,307201,313343,-6142
926,83,283141,22600,307751,314224,-6473
927,87,283193,24600,308801,314565,-5764
928,87,283258,21900,309213,315165,-5952
929,83,283364,22600,310225,315605,-5380
930,80,284603,22450,310460,315993,-5533
931,88,284785,28700,311510,316993,-5483
932,85,284938,22700,311801,317635,-5834
933,90,285228,23850,312275,318315,-6040
934,82,285845,24800,312775,318993,-6218
935,90,286132,22950,313163,319324,-6161
936,87,286244,24600,314007,319924,-5917
937,86,286393,20950,314560,320193,-5633
938,80,287134,19750,314751,320955,-6204
939,90,287166,22950,315307,321524,-6217
940,81,287359,19350,317539,322215,-4676
941,87,287421,19650,317368,323143,-5775
942,82,287436,24800,317318,323685,-6367
943,90,287794,26100,319018,324574,-5556
944,88,288947,19250,320939,325065,-4126
945,84,288972,19500,321439,325793,-4354
946,82,289212,23000,322568,326424,-3856
947,90,289509,20700,325039,327105,-2066
948,81,289522,21150,324868,327674,-2806
949,86,289863,26350,326868,328205,-1337
950,86,290226,22300,328539,328865,-326
951,89,290345,29650,329268,329965,-697
952,88,290401,24650,330639,330805,-166
953,88,291044,23750,332668,331615,1053
954,88,291437,24650,332389,332024,365
955,86,291526,22750,323920,332574,-8654
956,90,291578,21600,324083,333074,-8991
957,81,291879,24750,325083,333985,-8902
958,84,292166,24000,329470,334415,-4945
959,87,292212,23250,329933,335155,-5222
960,86,292239,25450,329383,336205,-6822
961,89,293428,22900,331533,336785,-5252
962,83,293429,22150,331313,318359,12954
963,80,293612,21100,332520,318909,13611
964,81,293736,19800,318567,319459,-892
965,82,293783,23450,319067,319509,-442
966,86,293985,27250,320067,319770,297
967,90,294249,27450,320804,320770,34
968,83,294693,23050,321014,322020,-1006
969,81,294914,22500,321514,323720,-2206
970,85,295097,22700,322014,326172,-4158
971,84,295365,23100,322661,326921,-4260
972,89,296365,26950,323214,327211,-3997
973,89,296694,22000,323964,327711,-3747
974,84,296840,21300,325177,328171,-2994
975,85,296887,25400,325472,328313,-2841
976,86,296957,27700,326582,329171,-2589
977,85,297010,24050,326772,330749,-3977
978,82,297165,21650,328982,333400,-4418
979,90,297204,23400,329822,334749,-4927
980,86,298851,24100,332872,335849,-2977
981,90,298918,27000,334572,338100,-3528
982,87,298991,25500,334782,340300,-5518
983,88,299180,24650,337432,341149,-3717
984,87,299386,21900,339082,328035,11047
985,85,299553,24050,339939,328535,11404
986,81,300529,20250,340459,329058,11401
987,85,300763,26750,341350,330020,11330
988,80,301141,20650,341609,330266,11343
989,84,302110,23100,342089,331285,10804
990,83,302823,23500,342361,331835,10526
991,80,302956,23350,343325,332739,10586
992,80,303020,22000,343209,333558,9651
993,80,303404,21550,343500,334239,9261
994,90,304097,23400,343082,335208,7874
995,80,304130,22900,343582,336166,7416
996,82,304299,22100,345272,336666,8606
997,83,304640,21250,346322,336908,9414
998,80,304847,22450,347982,337139,10843
999,82,305702,23900,350372,333406,16966
1000,89,305844,24700,351732,334006,17726
1001,80,305894,22000,338317,334237,4080
1002,86,305911,23650,336017,335491,526
1003,89,305957,22900,338817,336913,1904
1004,89,306495,22900,340917,337117,3800
1005,84,306539,22200,335957,337593,-1636
1006,86,306552,22300,336411,338143,-1732
1007,90,306586,22050,337217,338693,-1476
1008,84,307070,27150,338417,339243,-826
1009,80,308036,19750,340407,339505,902
1010,83,308474,27100,338553,340467,-1914
1011,89,308866,23800,339859,340843,-984
1012,88,308882,25550,340153,341185,-1032
1013,80,310182,20200,340409,341724,-1315
1014,81,310410,22050,341407,342217,-810
1015,80,310732,24700,342009,342767,-758
1016,90,310941,25650,342761,343593,-832
1017,88,311302,22850,343057,344093,-1036
1018,81,311688,20250,337444,344835,-7391
1019,87,311825,23700,337994,345517,-7523
1020,84,312803,21300,338507,346293,-7786
1021,88,313794,25100,339007,347393,-8386
1022,86,314065,23650,339494,347635,-8141
1023,81,314171,25200,338910,348393,-9483
1024,90,314409,23850,339460,349117,-9657
1025,84,314734,23550,340013,349617,-9604
1026,81,315026,19350,340453,350324,-9871
1027,87,315193,21450,340953,350667,-9714
1028,88,315367,21500,342503,351643,-9140
1029,84,315723,22650,343867,352085,-8218
1030,90,315854,22500,345353,352574,-7221
1031,89,315933,22450,344967,352717,-7750
1032,86,316274,22300,344057,353217,-9160
1033,80,316426,20650,344561,353717,-9156
1034,90,316642,23400,344863,353955,-9092
1035,85,317064,22700,345453,354605,-9152
1036,89,317207,27850,346310,355393,-9083
1037,87,317624,23250,346827,355993,-9166
1038,90,317812,26550,347809,356324,-8515
1039,86,317873,26350,348309,357205,-8896
1040,89,318050,20650,348460,357717,-9257
1041,88,319441,26000,349077,357993,-8916
1042,81,319776,26100,349663,358643,-8980
1043,82,319816,23900,350163,359424,-9261
1044,80,319965,21550,350663,359867,-9204
1045,80,320073,27850,350953,360555,-9602
1046,83,320596,19450,348652,360943,-12291
1047,82,320686,21650,349122,361635,-12513
1048,85,321268,22700,349702,361755,-12053
1049,80,321447,22900,350561,362993,-12432
1050,80,321486,20650,350902,363555,-12653
1051,83,322328,25750,351372,364117,-12745
1052,82,322914,25250,351952,364774,-12822
1053,87,322929,25950,352111,365374,-13263
1054,88,323602,26900,350089,352218,-2129
1055,89,324641,19750,351109,352739,-1630
1056,85,325740,23600,351609,352958,-1349
1057,80,326209,19300,352109,353458,-1349
1058,88,326420,23300,354309,353889,420
1059,80,326457,23350,353663,354439,-776
1060,82,326476,23900,354089,354808,-719
1061,80,327432,22000,355213,355308,-95
1062,90,327509,24300,355309,355487,-178
1063,86,327665,22300,356200,356418,-218
1064,80,327767,23800,357770,357037,733
1065,87,327878,23250,358320,357739,581
1066,82,327912,18950,358359,357968,391
1067,82,327918,20300,358563,358349,214
1068,87,328008,23250,358739,360049,-1310
1069,82,328245,23000,359509,362149,-2640
1070,89,329262,23800,360009,363752,-3743
1071,81,329568,20250,360509,365002,-4493
1072,83,330054,25300,361100,366487,-5387
1073,84,330089,22200,361489,367493,-6004
1074,87,330402,21900,362200,368037,-5837
1075,90,330539,24300,362825,369293,-6468
1076,81,330701,26550,363959,369793,-5834
1077,84,330797,21300,364689,367102,-2413
1078,83,330814,24850,365213,367899,-2686
1079,87,331199,21000,365850,369602,-3752
1080,83,331535,26200,366339,370702,-4363
1081,84,331760,19500,366989,372749,-5760
1082,84,332334,25800,367109,373552,-6443
1083,83,332581,22150,364407,374549,-10142
1084,80,332809,22450,366569,362865,3704
1085,86,333265,27700,367307,363673,3634
1086,82,333350,19850,367669,363965,3704
1087,90,333715,23850,364603,364606,-3
1088,80,333817,17950,365153,365156,-3
1089,85,333837,24500,366853,365991,862
1090,85,334282,22700,368620,366856,1764
1091,81,334576,23400,369770,367491,2279
1092,84,334672,21750,370920,368491,2429
1093,85,334813,19550,372003,369315,2688
1094,82,335308,20300,373253,369815,3438
1095,81,335338,19800,374253,370091,4162
1096,89,335413,26500,373920,370865,3055
1097,83,335761,25300,375470,371206,4264
1098,81,336317,20250,377253,371915,5338
1099,84,336562,20850,379003,372465,6538
1100,81,336771,22950,379653,373406,6247
1101,81,336879,22500,382570,374215,8355
1102,80,336896,20650,383070,375141,7929
1103,90,337705,29700,383753,375741,8012
1104,83,337995,26650,385170,376656,8514
1105,80,338117,23350,385103,377206,7897
1106,85,338193,22700,375727,370069,5658
1107,80,338300,22900,376727,370705,6022
1108,86,338920,20500,377827,371305,6522
1109,81,339122,21150,380818,371905,8913
1110,85,339536,22700,382177,372405,9772
1111,86,339786,20950,383977,372587,11390
1112,88,340264,25550,385127,373087,12040
1113,89,340800,22450,373709,373505,204
1114,88,340834,26000,373789,374369,-580
1115,87,341056,22350,374177,375124,-947
1116,82,341197,23450,374567,375437,-870
1117,88,341600,23300,374174,375937,-1763
1118,82,342095,22100,371624,376437,-4813
1119,80,342566,21100,373464,377255,-3791
1120,80,342591,22900,373522,377755,-4233
1121,89,342649,22900,373363,378224,-4861
1122,89,342707,19750,374013,378593,-4580
1123,89,342767,24700,374522,379105,-4583
1124,90,342825,23400,375264,379655,-4391
1125,81,342866,19800,375202,380374,-5172
1126,82,343333,20750,375702,381424,-5722
1127,89,343395,22450,376314,381493,-5179
1128,86,344278,28150,376863,382205,-5342
1129,83,344401,24400,377463,382705,-5242
1130,81,344412,18000,377952,383387,-5435
1131,80,345006,25150,378663,384043,-5380
1132,87,345074,24150,379074,384887,-5813
1133,90,345165,23400,379922,385043,-5121
1134,87,345737,23700,380472,385437,-4965
1135,85,345806,23150,380624,386055,-5431
1136,84,346074,23550,376511,386537,-10026
1137,84,346233,21750,376835,387087,-10252
1138,82,346570,24350,377885,387605,-9720
1139,80,346801,21100,379874,387874,-8000
1140,81,346985,22050,380585,388293,-7708
1141,80,347059,24250,382174,389187,-7013
1142,82,347518,20750,384274,389687,-5413
1143,82,347522,22100,386274,390169,-3895
1144,87,348395,22800,386774,390505,-3731
1145,90,348729,24750,388785,391055,-2270
1146,80,349306,22450,389535,391243,-1708
1147,86,350626,27250,391285,391787,-502
1148,86,351553,22750,393174,392519,655
1149,83,351842,26650,396924,392837,4087
1150,84,351893,24900,398674,393069,5605
1151,81,351932,24300,398974,393943,5031
1152,84,351985,22650,398235,394669,3566
1153,86,352019,20950,399335,395437,3898
1154,89,352294,27850,402774,395955,6819
1155,80,352374,19300,402535,396437,6098
1156,90,352946,22950,403424,396624,6800
1157,80,353143,20200,404024,397037,6987
1158,86,354331,20950,404135,397305,6830
1159,84,354466,24450,405224,397537,7687
1160,85,354560,21350,405724,397905,7819
1161,86,354948,22750,407474,398274,9200
1162,85,355050,28100,408285,388758,19527
1163,85,355215,24050,410074,389243,20831
1164,87,355947,21000,411335,390058,21277
1165,88,356021,24650,413074,390665,22409
1166,82,356224,23000,414174,391406,22768
1167,81,356347,22050,415435,392208,23227
1168,80,356643,22900,419674,392673,27001
1169,84,356717,22650,418074,392815,25259
1170,85,356728,24950,419835,393043,26792
1171,81,356977,25200,421324,393706,27618
1172,85,357300,25400,422585,394143,28442
1173,81,357383,22950,425585,394693,30892
1174,89,357463,23800,427274,395058,32216
1175,80,357715,25600,429474,396023,33451
1176,86,358128,22300,431174,396515,34659
1177,85,358260,25400,432035,396743,35292
1178,89,358491,24250,434524,397273,37251
1179,85,358772,26300,435435,398106,37329
1180,82,359402,22100,436724,398715,38009
1181,81,359410,18450,437585,399215,38370
1182,89,360900,23800,410340,399923,10417
1183,82,361235,23900,404909,400573,4336
1184,87,361381,24600,405253,401206,4047
1185,86,361419,20050,405711,402108,3603
1186,85,361780,24950,406211,402608,3603
1187,84,361865,19050,407013,403006,4007
1188,83,362042,24850,407809,403373,4436
1189,90,362567,21150,408163,403808,4355
1190,84,362746,20850,408403,404308,4095
1191,83,362948,20350,409003,404793,4210
1192,86,363549,23200,409413,405343,4070
1193,83,363808,23500,410803,405665,5138
1194,85,363828,23150,410813,404304,6509
1195,83,364282,24400,411413,394717,16696
1196,85,364390,24500,411913,395607,16306
1197,85,364669,23600,412463,396181,16282
1198,90,364851,24750,412963,396619,16344
1199,84,364908,21300,413609,396705,16904
1200,85,365023,24500,413411,395572,17839
1201,87,365208,21450,414109,397896,16213
1202,86,366258,22300,414709,398822,15887
1203,80,366964,20200,415653,400022,15631
1204,87,367132,23700,416463,401522,14941
1205,84,367273,22650,417359,403072,14287
1206,84,367537,25800,417909,404596,13313
1207,83,367624,20800,418459,406246,12213
1208,84,367728,25350,419003,407545,11458
1209,89,368045,21100,419603,408122,11481
1210,82,368537,23000,420603,408845,11758
1211,90,369028,26550,421103,409510,11593
1212,90,369403,23850,421659,409870,11789
1213,89,369523,22450,422209,410660,11549
1214,88,369737,25100,422709,411160,11549
1215,86,369851,24100,423161,411660,11501
1216,88,370101,22400,424259,412210,12049
1217,88,370333,26450,425103,412822,12281
1218,82,371018,26600,425859,413220,12639
1219,85,371659,21350,426353,413510,12843
1220,83,372498,25750,426761,414320,12441
1221,80,372785,23800,410088,414820,-4732
1222,80,372951,23800,411938,415595,-3657
1223,90,373049,25650,412472,416660,-4188
1224,88,373316,24650,414522,417345,-2823
1225,87,373656,20550,416288,417845,-1557
1226,80,374349,22000,417388,417710,-322
1227,87,374766,22800,419222,410895,8327
1228,86,375215,23650,420872,411624,9248
1229,87,375531,21450,422572,413146,9426
1230,80,375760,24250,424288,413696,10592
1231,90,375761,22050,403870,414846,-10976
1232,84,375896,24000,405570,415422,-9852
1233,87,376225,26400,407220,416946,-9726
1234,88,376625,22850,407967,418172,-10205
1235,86,376823,25000,403572,419972,-16400
1236,86,377199,21850,404187,421696,-17509
1237,90,377272,24300,404404,423672,-19268
1238,84,377437,20850,405026,425272,-20246
1239,90,377981,21150,405671,426422,-20751
1240,85,378101,26750,406654,426922,-20268
1241,80,378608,24250,407114,428446,-21332
1242,87,378762,22800,408271,430096,-21825
1243,89,379362,26950,408821,432146,-23325
1244,88,379662,21950,409049,421345,-12296
1245,81,379906,21600,409477,422174,-12697
1246,81,380066,20700,410487,422545,-12058
1247,81,380223,21150,410749,422860,-12111
1248,84,380228,27600,411171,423389,-12218
1249,84,380442,24900,411788,423889,-12101
1250,80,380760,20200,412271,424360,-12089
1251,89,381057,23800,413137,424695,-11558
1252,85,381216,27200,414399,425521,-11122
1253,84,381255,21750,414388,425795,-11407
1254,80,381623,24250,415787,426560,-10773
1255,87,381652,23250,415677,427171,-11494
1256,86,381819,25000,414813,427495,-12682
1257,81,382267,20250,415172,427821,-12649
1258,80,382551,21100,416026,428424,-12398
1259,81,382972,24750,416714,428974,-12260
1260,82,383701,23450,417214,429421,-12207
1261,90,383920,25650,417714,429971,-12257
1262,81,384122,22500,418863,430345,-11482
1263,85,384125,25850,418822,431224,-12402
1264,88,384379,23750,419604,431710,-12106
1265,86,384460,21400,416898,431971,-15073
1266,87,384526,26400,417157,432324,-15167
1267,87,385138,25950,418701,432795,-14094
1268,90,385208,22050,418707,433360,-14653
1269,88,385425,22400,419198,433489,-14291
1270,87,385695,21900,419459,426410,-6951
1271,80,385839,22900,420459,427073,-6614
1272,87,386070,24150,421051,427565,-6514
1273,88,386321,22850,419844,428043,-8199
1274,87,386334,25500,424073,428665,-4592
1275,86,386377,22300,424623,429060,-4437
1276,90,386695,26100,426794,429773,-2979
1277,89,387581,22000,429873,430208,-335
1278,86,387649,26350,430094,431258,-1164
1279,88,388282,24650,431444,431060,384
1280,87,388459,23700,432023,432165,-142
1281,88,389173,22850,435173,432793,2380
1282,80,389836,21100,437973,433293,4680
1283,86,389924,24100,438394,433793,4601
1284,85,390449,22700,439023,434793,4230
1285,84,390520,17700,429573,435673,-6100
1286,84,391021,21750,430073,436208,-6135
1287,90,391824,22950,431077,436708,-5631
1288,84,392423,26250,425667,437365,-11698
1289,89,392540,23800,426243,437923,-11680
1290,90,392904,24300,426743,438465,-11722
1291,88,394164,28250,428470,438973,-10503
1292,81,394245,24750,430620,439473,-8853
1293,83,394343,21700,432970,439860,-6890
1294,90,394360,26550,433470,440615,-7145
1295,89,395010,24700,436220,441393,-5173
1296,88,395101,21950,436009,441773,-5764
1297,84,395238,25800,437320,429063,8257
1298,83,395810,21700,438509,429161,9348
1299,80,396377,22450,440559,430208,10351
1300,89,396802,21550,442709,431258,11451
1301,83,397059,21700,443970,431913,12057
1302,87,397452,21450,444909,433001,11908
1303,81,398473,20250,447670,433511,14159
1304,81,398552,23850,448159,434563,13596
1305,81,399870,25200,450470,435058,15412
1306,88,401125,23300,452720,435258,17462
1307,87,401190,26400,452259,435208,17051
1308,84,401545,23100,455209,431645,23564
1309,88,401568,21950,454920,432245,22675
1310,84,401906,20850,455959,432272,23687
1311,83,402212,25300,458009,433141,24868
1312,89,402338,26950,459159,434741,24418
1313,80,402704,18850,460770,435789,24981
1314,81,402769,23400,461270,436778,24492
1315,81,402819,22500,461820,437974,23846
1316,89,402837,23800,447471,440674,6797
1317,89,403390,26050,447610,441893,5717
1318,81,403523,22050,439762,442615,-2853
1319,81,404362,19800,440063,443493,-3430
1320,80,404461,22450,440765,444115,-3350
1321,85,404529,22250,441277,444862,-3585
1322,82,404603,23900,441827,445023,-3196
1323,85,404637,20000,442313,445793,-3480
1324,90,404799,27450,443012,446573,-3561
1325,86,405000,17350,443515,447123,-3608
1326,87,405433,25050,444455,444277,178
1327,84,405716,23550,444565,446577,-2012
1328,86,406487,25900,445677,449177,-3500
1329,83,406527,22600,445665,449827,-4162
1330,86,406893,22750,441859,450924,-9065
1331,87,407010,24150,442753,452924,-10171
1332,86,407124,24100,443309,454574,-11265
1333,81,407312,18900,444309,455574,-11265
1334,90,407409,22950,444253,457174,-12921
1335,82,407456,20300,444763,449545,-4782
1336,81,407626,22050,446211,449874,-3663
1337,85,407665,24950,445813,450374,-4561
1338,85,407666,25850,445909,450978,-5069
1339,85,407767,23150,446711,451978,-5267
1340,87,408005,21450,446963,452145,-5182
1341,83,408215,22150,447963,452924,-4961
1342,89,408629,21550,449403,453678,-4275
1343,82,408654,21650,448511,454228,-5717
1344,85,408712,24500,449061,454710,-5649
1345,80,409385,16150,449903,455260,-5357
1346,83,409605,19900,450861,455760,-4899
1347,90,410054,26550,451361,456424,-5063
1348,86,410306,23650,451915,457289,-5374
1349,88,410856,25550,452563,457789,-5226
1350,80,411284,19300,453061,458289,-5228
1351,84,411411,23100,454063,458624,-4561
1352,82,412117,20300,455238,459124,-3886
1353,84,412183,22650,455175,459789,-4614
1354,84,412325,24900,459988,460578,-590
1355,80,412373,24250,463325,461078,2247
1356,84,412381,26700,460075,461495,-1420
1357,85,412434,25850,462038,462128,-90
1358,86,412459,22300,463825,462728,1097
1359,80,412574,23350,465238,463989,1249
1360,85,412735,23600,467225,464374,2851
1361,85,413744,25400,468888,464989,3899
1362,81,414340,21150,469388,465574,3814
1363,81,414631,22050,450116,465978,-15862
1364,88,415487,24650,451378,466345,-14967
1365,83,415544,24850,451272,466945,-15673
1366,86,415754,23200,451666,467578,-15912
1367,84,415963,24000,452378,468078,-15700
1368,82,416172,20750,452613,468728,-16115
1369,84,416272,24450,453554,469728,-16174
1370,87,416480,24150,454163,469939,-15776
1371,83,417260,21700,454654,456962,-2308
1372,81,418115,22950,455204,457565,-2361
1373,80,419054,19300,455704,458443,-2739
1374,80,419203,20650,455177,459310,-4133
1375,83,419278,22600,456675,459593,-2918
1376,86,419450,21400,458477,460223,-1746
1377,81,419757,26100,461425,460812,613
1378,82,419956,20300,462327,461362,965
1379,88,420631,20600,465077,461860,3217
1380,88,420656,25550,465577,462662,2915
1381,84,420794,21300,466725,463162,3563
1382,84,421643,23550,470825,463523,7302
1383,87,421670,28650,469327,464262,5065
1384,88,421732,19700,471377,464765,6612
1385,88,421732,26000,471375,465273,6102
1386,82,421887,22100,473025,465943,7082
1387,84,421909,24000,474477,466493,7984
1388,81,422130,23850,474126,467043,7083
1389,81,422303,21600,475785,467543,8242
1390,80,422946,21100,476926,468143,8783
1391,82,423513,22550,479576,468473,11103
1392,90,423606,23850,480076,469123,10953
1393,82,423969,21200,482385,469843,12542
1394,82,424045,23000,481926,470604,11322
1395,90,424447,24750,483685,472904,10781
1396,87,424769,21900,485685,473754,11931
1397,84,425022,23550,487685,475704,11981
1398,89,425230,25600,488835,475954,12881
1399,80,425560,20650,489835,472465,17370
1400,86,426043,23650,491385,473112,18273
1401,89,426140,22000,461222,473743,-12521
1402,83,426474,24400,461772,474360,-12588
1403,88,426603,21950,462623,474715,-12092
1404,89,426876,24700,463623,475360,-11737
1405,87,427505,22800,465273,475910,-10637
1406,90,427510,24750,466196,476462,-10266
1407,87,427708,21900,468396,477365,-8969
1408,85,427813,21350,468773,477562,-8789
1409,89,428193,26950,470496,476912,-6416
1410,87,428374,24600,471096,477474,-6378
1411,84,428564,28950,470973,478399,-7426
1412,81,428638,23850,467276,478899,-11623
1413,83,429249,20350,468290,479574,-11284
1414,89,429494,26950,467377,479999,-12622
1415,88,429670,25100,468215,480824,-12609
1416,80,431148,20650,468577,481499,-12922
1417,87,431709,18300,469812,481974,-12162
1418,88,432224,26900,471562,482524,-10962
1419,81,432670,18900,472971,482799,-9828
1420,86,433183,21400,474571,475751,-1180
1421,90,433755,24750,475362,477612,-2250
1422,87,434276,25500,478421,478351,70
1423,85,434348,26750,478712,471349,7363
1424,88,434539,24200,479212,471828,7384
1425,86,435250,25000,480812,472574,8238
1426,83,435788,21700,481321,473378,7943
1427,82,435929,24350,481921,473878,8043
1428,84,436210,25350,472011,474429,-2418
1429,82,436298,20750,471865,476479,-4614
1430,80,436649,23350,472611,478529,-5918
1431,82,437066,23000,473265,480179,-6914
1432,86,437087,23200,473765,482174,-8409
1433,88,437267,27800,474965,484329,-9364
1434,85,437382,24500,475365,486074,-10709
1435,83,437800,25300,475903,488179,-12276
1436,89,437906,20650,476361,489929,-13568
1437,89,438769,27400,477059,491479,-14420
1438,83,439260,28450,477559,493479,-15920
1439,85,439478,23600,475455,495324,-19869
1440,85,439479,27200,476116,497279,-21163
1441,87,440075,22800,476677,498929,-22252
1442,82,441203,24350,477655,501274,-23619
1443,89,441687,24700,477963,503262,-25299
1444,84,441786,21750,478563,504293,-25730
1445,82,442027,20300,478916,504667,-25751
1446,88,442109,27350,479313,504793,-25480
1447,80,442984,26500,480065,504612,-24547
1448,90,443003,24300,481215,504979,-23764
1449,82,443028,20750,480963,506374,-25411
1450,88,443931,25100,481977,507979,-26002
1451,82,444145,23450,483313,508024,-24711
1452,90,444212,22050,483405,489274,-5869
1453,89,444358,26950,483905,490128,-6223
1454,88,444639,24200,484527,490810,-6283
1455,80,445051,15700,484863,491310,-6447
1456,87,445130,22800,485363,491889,-6526
1457,87,445777,26400,486027,491924,-5897
1458,90,445973,24300,487005,492389,-5384
1459,89,446165,21100,487655,492947,-5292
1460,83,446346,22600,488177,493589,-5412
1461,85,446482,23600,488963,494474,-5511
1462,85,446930,24500,489463,494589,-5126
1463,90,447720,21150,490105,495147,-5042
1464,90,447846,22500,490663,495739,-5076
1465,81,447988,22050,491066,496197,-5131
1466,90,448631,25200,491705,496939,-5234
1467,86,448945,20950,492015,497439,-5424
1468,80,449274,21550,492527,497774,-5247
1469,87,449328,21450,492913,498374,-5461
1470,87,449530,23700,493513,498874,-5361
1471,81,449771,22050,494355,499489,-5134
1472,81,451242,21600,495063,500210,-5147
1473,82,451489,22550,495427,500524,-5097
1474,90,451720,25650,495977,500710,-4733
1475,84,452672,25350,496666,501197,-4531
1476,88,452975,21950,497077,501724,-4647
1477,86,453081,24100,497905,502274,-4369
1478,81,453652,18450,498127,502310,-4183
1479,86,453738,26800,498266,488062,10204
1480,80,453997,21550,498905,488562,10343
1481,85,454646,22250,498966,489263,9703
1482,84,454795,23100,489943,489913,30
1483,90,454809,22500,489517,491080,-1563
1484,80,454840,20650,489679,492446,-2767
1485,89,455878,22000,490608,493546,-2938
1486,87,457259,22800,490993,494380,-3387
1487,80,457963,20650,491659,495496,-3837
1488,85,458169,24950,492627,496696,-4069
1489,86,458337,25900,494377,498680,-4303
1490,81,458504,25200,495277,500380,-5103
1491,80,458842,21100,497226,501446,-4220
1492,83,458969,23950,501126,502730,-1604
1493,89,459037,20200,500746,503696,-2950
1494,87,459155,24150,502626,504746,-2120
1495,81,459356,22950,503746,506180,-2434
1496,82,459537,20300,505476,507596,-2120
1497,89,460498,24250,507676,508530,-854
1498,84,460657,24000,509446,509730,-284
1499,87,460878,25500,514496,510646,3850
1500,87,460936,24600,514076,512780,1296
1501,85,461527,24950,516596,513330,3266
1502,87,461632,20550,517646,514296,3350
1503,82,461955,20750,519146,515396,3750
1504,80,462544,18850,519696,515996,3700
1505,88,463230,21950,502967,518096,-15129
1506,80,463334,17050,503467,519346,-15879
1507,90,463546,22500,504409,520696,-16287
1508,81,463835,23400,505893,521696,-15803
1509,85,463901,24050,506059,522480,-16421
1510,82,464458,22100,506393,524630,-18237
1511,86,464715,26350,507408,526446,-19038
1512,81,464837,20250,507917,528096,-20179
1513,90,465179,24750,497571,529646,-32075
1514,85,465190,25850,498071,531146,-33075
1515,82,465203,18950,499765,532330,-32565
1516,84,465300,21750,499421,533180,-33759
1517,88,465889,21050,501421,534330,-32909
1518,89,466045,24700,503371,535051,-31680
1519,80,466172,25150,505421,518164,-12743
1520,85,467007,26750,507165,519701,-12536
1521,89,467248,23350,510015,520901,-10886
1522,87,467343,19200,510221,522151,-11930
1523,89,467492,27850,514565,523714,-9149
1524,90,467584,27900,514471,526351,-11880
1525,84,467627,24000,515065,527601,-12536
1526,88,467671,23750,516165,528414,-12249
1527,87,467721,22800,502951,528151,-25200
1528,85,467733,20450,503559,503321,238
1529,85,468028,24500,504157,503133,1024
1530,86,468761,25000,505478,504183,1295
1531,87,468826,25500,505235,505162,73
1532,85,469895,20900,506535,505675,860
1533,82,470118,23900,508778,506017,2761
1534,88,470193,24650,508835,506399,2436
1535,88,470801,25100,511928,507312,4616
1536,83,470885,21700,512485,508062,4423
1537,81,471029,22050,514578,508343,6235
1538,85,471152,25400,516135,508943,7192
1539,86,471303,24100,517378,509875,7503
1540,80,471604,21100,519935,510162,9773
1541,89,471657,25600,520435,510712,9723
1542,81,471832,22050,521485,511567,9918
1543,82,471998,23450,522485,511912,10573
1544,87,472735,27300,524328,512725,11603
1545,90,473352,26550,527635,513225,14410
1546,88,474062,23750,528728,513843,14885
1547,83,475496,19000,529285,514267,15018
1548,88,475937,24200,532735,514817,17918
1549,84,475947,22650,532878,515367,17511
1550,87,476146,27300,534285,515762,18523
1551,87,476219,25500,534985,516517,18468
1552,88,476409,27350,538535,517362,21173
1553,83,476567,21250,541085,517475,23610
1554,84,476764,24900,543135,518243,24892
1555,86,476918,22750,543728,518912,24816
1556,90,477089,22050,544885,519162,25723
1557,83,477497,22150,545435,519412,26023
1558,81,477605,22500,547935,520225,27710
1559,88,477646,24200,548028,520775,27253
1560,90,477742,26550,519316,521275,-1959
1561,81,478621,22950,519866,521562,-1696
1562,88,478703,21950,520217,522162,-1945
1563,86,478951,25450,521163,522941,-1778
1564,89,479040,27400,521217,523862,-2645
1565,86,479404,20950,522163,524312,-2149
1566,80,479556,21100,522805,525293,-2488
1567,89,481524,23350,523355,525867,-2512
1568,87,481654,21450,523867,526467,-2600
1569,84,482779,24900,521777,527062,-5285
1570,89,482852,25150,521729,527675,-5946
1571,87,482974,20100,522879,528175,-5296
1572,82,483106,24350,525427,528675,-3248
1573,85,483871,22700,526577,529212,-2635
1574,81,484053,23400,530327,529667,660
1575,86,484073,24550,529077,530812,-1735
1576,89,484093,24700,530827,531562,-735
1577,81,485186,23400,533679,532475,1204
1578,89,485654,28300,535779,533093,2686
1579,88,485794,26900,537429,533643,3786
1580,87,486497,25050,538479,534025,4454
1581,86,486819,22750,539479,532749,6730
1582,84,487145,19950,540779,533141,7638
1583,84,487359,18600,541279,533610,7669
1584,80,487805,19300,542527,533949,8578
1585,83,487808,19000,543729,534410,9319
1586,85,488184,22250,545677,534891,10786
1587,83,488430,19450,547827,535391,12436
1588,87,488746,30000,548877,536049,12828
1589,88,489224,26450,550879,529223,21656
1590,83,490341,23500,552479,530038,22441
1591,88,490411,26000,552277,530588,21689
1592,87,490513,26400,553763,531638,22125
1593,81,490840,20250,554265,531882,22383
1594,86,490957,26800,555061,532622,22439
1595,85,491359,23150,555357,533023,22334
1596,82,491640,23000,555863,533738,22125
1597,89,492224,26500,555079,534623,20456
1598,89,492453,21550,556265,534759,21506
1599,86,492697,21400,556765,534193,22572
1600,80,493898,22450,557069,534462,22607
1601,85,494125,19100,556977,534843,22134
1602,83,494702,24400,535974,535069,905
1603,81,494942,22950,538115,535662,2453
1604,82,495269,23000,539165,536312,2853
1605,90,495478,26550,540369,537112,3257
1606,88,495798,22400,541056,536725,4331
1607,86,496658,21850,541619,535582,6037
1608,89,496825,26950,542669,536524,6145
1609,89,497134,27400,543206,538506,4700
1610,88,497140,25100,543706,540606,3100
1611,90,497476,24750,544928,542306,2622
1612,80,497522,20650,545118,543506,1612
1613,88,497861,25100,545869,544106,1763
1614,85,498309,22700,546469,546606,-137
1615,81,498378,19800,546969,547856,-887
1616,83,498725,24850,547374,549506,-2132
1617,84,499023,19500,548169,549756,-1587
1618,83,499463,24400,548818,551256,-2438
1619,83,499667,22150,548874,551456,-2582
1620,89,499865,22450,544015,553606,-9591
1621,90,501498,23400,545265,554206,-8941
1622,90,501587,22500,545815,555056,-9241
1623,90,501787,21150,547174,556056,-8882
1624,86,501788,26350,549774,557356,-7582
1625,90,501877,24300,551424,559006,-7582
1626,82,503274,19850,553915,559906,-5991
1627,85,503318,22700,555015,560256,-5241
1628,85,503404,24950,556665,545285,11380
1629,88,503466,23750,556574,545980,10594
1630,90,503505,27900,558074,547085,10989
1631,84,503801,23550,560024,549130,10894
1632,89,503844,24250,560965,549529,11436
1633,81,503993,22050,560774,550238,10536
1634,87,504161,27300,548508,550836,-2328
1635,84,504760,26700,548807,551338,-2531
1636,81,504992,19350,549351,552270,-2919
1637,87,505164,24150,550408,552438,-2030
1638,84,505229,21300,550561,551280,-719
1639,82,505292,20750,550507,552938,-2431
1640,83,505406,23950,551411,553488,-2077
1641,83,505526,23500,551608,553580,-1972
1642,83,505862,23500,552608,554280,-1672
1643,86,505900,20950,553611,541195,12416
1644,89,505930,23350,553951,541765,12186
1645,80,507621,22450,554711,542815,11896
1646,88,507707,22850,554951,543660,11291
1647,81,507905,22950,555501,544505,10996
1648,81,508009,19350,555957,545055,10902
1649,82,508336,22100,556808,545464,11344
1650,88,508441,23750,557657,546755,10902
1651,85,508455,20000,557701,547310,10391
1652,90,508633,21600,557911,548065,9846
1653,86,508937,19150,558911,548664,10247
1654,83,509037,25300,559251,549415,9836
1655,83,509384,25750,560807,550263,10544
1656,82,509435,24350,560751,550715,10036
1657,84,509801,22200,561801,551214,10587
1658,84,509955,22650,562208,551814,10394
1659,85,510290,23150,555046,552460,2586
1660,82,510431,21200,556146,552864,3282
1661,82,510755,21200,556379,550725,5654
1662,86,510771,19150,553681,550862,2819
1663,84,510884,21300,554113,551362,2751
1664,90,511147,27000,554769,552275,2494
1665,87,511861,22800,556213,552775,3438
1666,80,511908,25150,555869,553745,2124
1667,90,512064,25650,556855,554295,2560
1668,85,512249,23600,557331,554975,2356
1669,90,512293,26550,557881,555475,2406
1670,85,512884,21800,558116,556412,1704
1671,86,512985,26800,558563,557345,1218
1672,80,513681,22900,559063,558014,1049
1673,89,514062,24700,549978,560004,-10026
1674,84,514771,26700,550760,561054,-10294
1675,85,515581,25850,551652,562564,-10912
1676,81,515993,24750,552228,564164,-11936
1677,83,516785,23950,552336,564804,-12468
1678,81,516849,22950,553336,566054,-12718
1679,83,517598,26200,554436,567054,-12618
1680,89,517677,23350,554778,567554,-12776
1681,88,517823,25550,554936,563975,-9039
1682,83,518685,24850,547765,564575,-16810
1683,88,518789,22850,548705,565125,-16420
1684,87,518974,23250,550038,565625,-15587
1685,80,519097,25600,553278,566262,-12984
1686,82,519557,23900,555443,566780,-11337
1687,83,519898,25300,556678,567312,-10634
1688,84,520094,27150,558178,568280,-10102
1689,83,520568,23950,560778,568762,-7984
1690,89,520841,25150,561343,569412,-8069
1691,87,521292,25950,563178,569880,-6702
1692,88,521557,26000,565493,570412,-4919
1693,88,521753,20600,566078,570945,-4867
1694,89,522047,21550,567678,571545,-3867
1695,83,522207,23500,569228,572630,-3402
1696,86,522327,21850,570843,573012,-2169
1697,83,522426,23050,570828,563112,7716
1698,86,522602,27250,567938,563280,4658
1699,89,522675,24250,567828,556612,11216
1700,81,522797,21600,569538,557113,12425
1701,82,523125,21200,571678,557613,14065
1702,90,523245,23850,572838,558205,14633
1703,81,523517,24300,574438,558864,15574
1704,84,523645,26250,577131,559805,17326
1705,83,524015,23950,577681,560805,16876
1706,82,524184,21650,578212,561064,17148
1707,83,524755,21700,578609,562114,16495
1708,83,524825,24850,579545,562715,16830
1709,82,524839,19850,579367,563265,16102
1710,82,524981,24800,580331,563955,16376
1711,86,525042,25450,581012,564555,16457
1712,89,525066,22000,581331,565105,16226
1713,80,525078,22900,581517,565605,15912
1714,84,525321,21300,581881,566514,15367
1715,87,525904,23700,582909,567105,15804
1716,90,526128,23850,583381,567965,15416
1717,89,526745,27850,583945,569385,14560
1718,83,526942,24850,584562,570935,13627
1719,87,527051,22800,585059,572774,12285
1720,84,527065,22200,585262,573774,11488
1721,88,527292,24200,585945,575274,10671
1722,80,527557,22450,578438,576824,1614
1723,85,527584,24500,579588,577874,1714
1724,83,527852,19900,580928,579435,1493
1725,85,528779,22250,582988,580485,2503
1726,90,529157,25200,584178,582174,2004
1727,89,529824,25150,586081,583585,2496
1728,90,530131,27450,587231,582306,4925
1729,82,530221,24350,587467,583708,3759
1730,86,530642,23650,588161,609090,-20929
1731,85,530725,24950,588695,609590,-20895
1732,90,531009,28800,588088,587458,630
1733,87,531029,23250,588588,589176,-588
1734,89,531150,23350,589112,589401,-289
1735,85,531575,25850,589578,589928,-350
1736,82,532445,18950,590288,590093,195
1737,84,532606,20400,589918,590476,-558
1738,80,532615,20650,575165,590793,-15628
1739,87,532891,22350,576013,591343,-15330
1740,88,533988,22850,576563,591628,-15065
1741,88,534174,27350,577259,592128,-14869
1742,88,534650,18800,577713,592678,-14965
1743,90,534800,27000,578315,593301,-14986
1744,85,535297,24500,578963,593878,-14915
1745,81,535436,22500,579509,594901,-15392
1746,86,536265,22300,580009,595860,-15851
1747,81,536288,23400,579869,596360,-16491
1748,84,536369,20400,580369,596578,-16209
1749,90,536732,23400,582159,597078,-14919
1750,82,536753,19850,582063,597651,-15588
1751,80,536788,21100,582069,598128,-16059
1752,80,536843,18400,582463,598151,-15688
1753,85,537247,24950,583013,590156,-7143
1754,84,537341,22200,583813,591558,-7745
1755,86,537456,26800,584813,592456,-7643
1756,80,537736,22450,585119,594056,-8937
1757,84,537935,26250,586009,595758,-9749
1758,84,538059,24450,587213,597358,-10145
1759,80,538088,22000,587119,598356,-11237
1760,88,538642,26900,588009,600406,-12397
1761,85,539313,22700,588415,601456,-13041
1762,89,539405,25600,589119,603956,-14837
1763,85,540006,23600,589213,606006,-16793
1764,84,540244,25350,588465,607108,-18643
1765,85,540673,26300,589065,608556,-19491
1766,85,540676,24950,590677,610158,-19481
1767,90,541134,22950,592415,612008,-19593
1768,81,541190,22950,595377,613008,-17631
1769,86,541274,24550,595115,613508,-18393
1770,86,542702,25000,596477,588217,8260
1771,86,543299,24100,598015,588717,9298
1772,85,543604,26750,599565,591267,8298
1773,87,544371,25050,602815,592054,10761
1774,87,544382,24600,603277,592667,10610
1775,88,545144,24650,604927,594717,10210
1776,90,545404,24300,605927,598204,7723
1777,82,545561,21650,608077,600217,7860
1778,80,546282,24700,609077,601804,7273
1779,87,546445,22350,610224,603167,7057
1780,80,546905,22450,610970,605167,5803
1781,80,546983,21100,611924,606704,5220
1782,87,547077,21000,612408,608017,4391
1783,90,547286,24300,612570,609067,3503
1784,84,547435,22650,611677,610554,1123
1785,89,547622,24700,612177,611654,523
1786,80,547913,23800,613865,613517,348
1787,89,548035,26050,614415,613804,611
1788,90,548324,21600,615415,614854,561
1789,82,548514,21200,598481,616417,-17936
1790,82,548867,21200,585093,617467,-32374
1791,87,548885,21450,585593,620254,-34661
1792,81,549365,18000,586193,621404,-35211
1793,88,549465,25550,587431,622904,-35473
1794,80,549818,23350,589181,623513,-34332
1795,85,549961,22700,591593,624455,-32862
1796,80,550179,25600,593081,624666,-31585
1797,88,550648,29150,595231,625166,-29935
1798,84,551091,24000,598181,625455,-27274
1799,85,551097,21800,598443,626213,-27770
1800,82,551260,23450,599543,626914,-27371
1801,80,551473,22450,601093,627615,-26522
1802,84,551654,21300,603393,627913,-24520
1803,82,551679,26150,603031,626617,-23586
1804,87,551858,24150,604493,627817,-23324
1805,82,551982,21650,606443,628605,-22162
1806,83,552169,20350,607543,629118,-21575
1807,82,552439,24350,607931,629615,-21684
1808,83,552620,22600,609293,630115,-20822
1809,87,553166,23700,610943,630307,-19364
1810,80,554000,21550,613093,605662,7431
1811,87,554045,21900,615293,606080,9213
1812,86,555467,26800,616793,606912,9881
1813,80,555975,20200,618331,607912,10419
1814,85,556026,23600,622781,608630,14151
1815,83,556026,22600,623281,609412,13869
1816,86,556119,24100,622743,610325,12418
1817,81,556647,27000,624931,610825,14106
1818,80,557497,21550,626093,608632,17461
1819,89,557500,22000,629243,597133,32110
1820,82,557580,24800,628743,598448,30295
1821,86,557720,22750,630943,600448,30495
1822,89,558371,24250,632593,601548,31045
1823,83,558843,22150,633593,602748,30845
1824,84,558971,22200,634981,604998,29983
1825,87,559384,23700,635681,607298,28383
1826,82,559678,21200,604081,608398,-4317
1827,81,559835,20250,605131,608948,-3817
1828,86,559837,25450,605392,610583,-5191
1829,82,560386,25250,606681,613083,-6402
1830,86,560415,22300,607137,613848,-6711
1831,90,560578,23850,607637,615433,-7796
1832,82,561714,26600,607692,617098,-9406
1833,88,561988,23750,608957,617583,-8626
1834,86,562005,26350,608781,600020,8761
1835,87,562177,25950,609637,600296,9341
1836,83,562354,23500,610225,601120,9105
1837,81,562407,25200,611557,601620,9937
1838,81,562445,19350,611542,602535,9007
1839,82,562562,24800,612057,603976,8081
1840,82,562961,20300,612631,605376,7255
1841,81,563080,23850,612825,607224,5601
1842,90,563221,24750,613731,608774,4957
1843,87,563383,25050,614575,610279,4296
1844,87,563547,27300,615231,610926,4305
1845,86,563794,25450,615781,611825,3956
1846,87,563950,21900,616425,612429,3996
1847,86,564441,20500,616742,612897,3845
1848,89,564545,22900,617257,614112,3145
1849,89,564761,22900,617525,614712,2813
1850,87,564763,24150,616813,615175,1638
1851,90,564789,25200,617562,615725,1837
1852,87,564916,23700,618317,616047,2270
1853,90,564940,27450,619413,616547,2866
1854,84,565298,22200,619983,616725,3258
1855,81,565311,21150,620367,614085,6282
1856,81,565680,23850,620745,615476,5269
1857,89,566152,24700,621245,617080,4165
1858,81,566268,24750,622295,617275,5020
1859,86,566354,24550,622883,618212,4671
1860,90,566386,21150,622867,618812,4055
1861,87,567432,22350,625313,619180,6133
1862,80,567473,22450,625067,618862,6205
1863,86,567495,23650,625083,618776,6307
1864,89,567661,25150,625612,620785,4827
1865,90,567743,26100,622309,621785,524
1866,83,567756,23500,622165,622285,-120
1867,80,568032,23800,622615,618714,3901
1868,86,568458,23200,623169,619205,3964
1869,85,568765,24500,623763,619414,4349
1870,90,570049,27000,623415,619755,3660
1871,80,570105,21550,620010,620415,-405
1872,81,570502,21600,620838,621214,-376
1873,81,570623,19800,621806,621814,-8
1874,90,571611,26100,623438,622615,823
1875,88,571649,23750,623185,638590,-15405
1876,90,571837,26550,624650,639140,-14490
1877,86,572113,23200,626800,640040,-13240
1878,82,573243,21200,628379,640740,-12361
1879,88,573561,22400,629929,641096,-11167
1880,87,573607,23250,631350,641920,-10570
1881,89,574294,26950,633400,642890,-9490
1882,82,574605,22100,634129,643579,-9450
1883,85,574620,24500,635629,643896,-8267
1884,81,574659,20700,636200,644770,-8570
1885,82,574708,20300,637200,626476,10724
1886,90,575094,27000,624524,627451,-2927
1887,85,575338,20900,628631,627843,788
1888,80,575348,21550,631218,628576,2642
1889,83,575369,21700,631718,629062,2656
1890,84,575400,26700,631324,629893,1431
1891,90,576134,28350,633318,631128,2190
1892,89,576204,25150,635974,631662,4312
1893,81,576660,23400,637568,632178,5390
1894,81,577002,22050,639218,632712,6506
1895,84,577273,24900,637581,633151,4430
1896,82,577407,24350,638138,624208,13930
1897,80,577472,23350,639288,624980,14308
1898,85,577494,18200,639788,625212,14576
1899,85,578482,24050,636531,625712,10819
1900,86,579498,23200,639730,626369,13361
1901,84,579704,23550,640230,627431,12799
1902,84,580324,23100,641481,628419,13062
1903,90,580445,24300,645630,630019,15611
1904,84,580466,19500,645231,630766,14465
1905,81,581175,19800,647881,631372,16509
1906,88,582041,24200,649931,631972,17959
1907,80,583066,22900,653780,638914,14866
1908,82,583084,24350,654280,640028,14252
1909,90,583484,18450,655481,640876,14605
1910,84,583891,23100,656631,641614,15017
1911,88,584679,24650,658680,642526,16154
1912,83,584807,26650,661180,643076,18104
1913,85,585576,24950,662531,643828,18703
1914,89,585615,22900,663081,644176,18905
1915,86,585899,25450,635732,644943,-9211
1916,83,585959,21250,635369,645828,-10459
1917,88,587000,25100,635919,646764,-10845
1918,90,587002,25200,637370,647328,-9958
1919,81,587096,19800,638208,647826,-9618
1920,90,587171,26100,637969,648914,-10945
1921,88,587363,26900,639474,649951,-10477
1922,86,587408,22750,639470,650451,-10981
1923,87,587565,24600,639769,651076,-11307
1924,87,588117,23700,640520,641565,-1045
1925,83,588347,23050,640819,642115,-1296
1926,90,589108,22050,641520,642857,-1337
1927,89,589319,28300,642132,643216,-1084
1928,86,589785,24100,642774,643722,-948
1929,86,589986,24550,643020,644207,-1187
1930,89,590455,31000,643519,645559,-2040
1931,87,590730,25050,644274,646560,-2286
1932,88,591038,28250,645070,648759,-3689
1933,83,591647,21700,645374,649359,-3985
1934,88,591813,24650,645924,651010,-5086
1935,90,592171,22950,645508,651193,-5685
1936,87,592612,25050,638789,651743,-12954
1937,80,594169,22450,639889,652180,-12291
1938,90,594335,29250,640539,652351,-11812
1939,84,594367,22200,640992,652793,-11801
1940,86,594689,22750,641507,653726,-12219
1941,87,594792,17400,642139,654343,-12204
1942,87,594868,22350,643081,655201,-12120
1943,82,595006,24350,643631,655380,-11749
1944,83,595144,22150,644131,654976,-10845
1945,88,595156,24200,644731,654707,-9976
1946,85,595419,26750,645231,655766,-10535
1947,90,596039,24300,646331,656415,-10084
1948,85,596081,24050,645939,657166,-11227
1949,88,596135,28250,646692,658122,-11430
1950,90,596204,22050,646939,658907,-11968
1951,88,596341,24200,647275,659065,-11790
1952,82,596769,22100,647589,659466,-11877
1953,81,597601,21600,648042,659966,-11924
1954,85,597960,22250,648542,660565,-12023
1955,80,598069,20650,649525,661257,-11732
1956,81,598107,23850,649542,661872,-12330
1957,90,598242,24300,650525,662716,-12191
1958,86,598671,24550,651507,663216,-11709
1959,86,599018,27250,652039,664266,-12227
1960,88,599400,23300,652725,664916,-12191
1961,83,599652,25750,653192,665966,-12774
1962,86,599910,21850,652380,666607,-14227
1963,83,599932,23500,657530,667115,-9585
1964,86,599947,25900,655480,667607,-12127
1965,83,600001,23050,657030,668116,-11086
1966,89,600260,22000,658965,668716,-9751
1967,87,600629,21000,660880,669207,-8327
1968,83,600890,23050,661980,669316,-7336
1969,85,601331,22700,664165,669766,-5601
1970,84,601338,19500,665580,670665,-5085
1971,83,601354,21250,666680,671266,-4586
1972,86,601928,22750,667315,671872,-4557
1973,80,602302,21550,668780,672572,-3792
1974,89,602755,22000,669715,673457,-3742
1975,89,603529,27400,670715,674266,-3551
1976,86,603620,19600,658462,674766,-16304
1977,80,603836,20650,659233,675515,-16282
1978,80,604463,16600,659763,675672,-15909
1979,85,604500,25850,660313,676172,-15859
1980,85,604740,24950,660883,677407,-16524
1981,81,605335,26100,662212,677672,-15460
1982,89,605457,23800,662533,663342,-809
1983,81,605662,21600,662712,663892,-1180
1984,81,606071,20700,663819,664478,-659
1985,81,606850,21600,663895,665181,-1286
1986,86,608180,28150,660131,666388,-6257
1987,81,608333,24300,661781,667181,-5400
1988,86,609276,23650,663081,667963,-4882
1989,85,609560,24500,664168,668181,-4013
1990,87,609786,24150,666931,668228,-1297
1991,87,610392,21000,669331,669382,-51
1992,90,610420,23850,669496,669982,-486
1993,87,610575,25950,671181,671532,-351
1994,84,611255,21300,671681,672244,-563
1995,85,611422,20450,673381,673229,152
1996,81,612065,27000,674400,674279,121
1997,89,612523,26050,676181,674779,1402
1998,87,612852,23700,677646,675340,2306
1999,89,613117,23350,678431,675670,2761
2000,85,613266,18650,679431,676220,3211
2001,84,613811,22650,680768,676440,4328
2002,84,613933,21750,682081,677220,4861
2003,84,614019,22200,684455,677794,6661
2004,83,614099,22150,684910,678140,6770
2005,85,614258,22250,685996,672790,13206
2006,90,614314,26100,686231,674340,11891
2007,83,614577,20800,687163,675390,11773
2008,84,614770,24000,687607,676982,10625
2009,86,614795,22300,688771,678294,10477
2010,80,614882,22450,689163,678772,10391
2011,86,614995,22300,689663,679272,10391
2012,87,615310,21450,690020,679894,10126
2013,90,615561,22050,690857,680240,10617
2014,85,615585,24500,692313,681340,10973
2015,82,615602,25700,692407,682432,9975
2016,82,616424,19850,692210,682140,10070
2017,84,616451,26250,692361,679418,12943
2018,80,616740,26050,692710,679406,13304
2019,87,616903,24150,694481,681667,12814
2020,81,616904,26100,694546,682767,11779
2021,87,617610,22800,695681,677538,18143
2022,86,617640,24100,697296,678281,19015
2023,90,617668,24300,698846,678842,20004
2024,88,617709,24650,700231,678780,21451
2025,88,617992,21950,693668,679467,14201
2026,86,618030,25000,694927,680065,14862
2027,83,618125,19450,695368,670201,25167
2028,88,618539,21050,697218,670316,26902
2029,90,618591,24750,697577,671001,26576
2030,84,619181,24000,698418,671501,26917
2031,83,619380,23050,700927,672101,28826
2032,85,619720,24050,701677,672382,29295
2033,90,620059,21150,703668,673226,30442
2034,88,620888,24200,703718,673982,29736
2035,87,621331,22350,697883,674851,23032
2036,87,621513,22800,699983,675132,24851
2037,86,622257,23200,701288,675901,25387
2038,90,622447,26100,702938,676951,25987
2039,85,622877,23150,705183,677726,27457
2040,86,623897,25000,706733,678451,28282
2041,87,624128,24150,707383,679393,27990
2042,85,624710,27200,712733,679826,32907
2043,82,624739,22550,710838,680376,30462
2044,90,624752,28800,712888,680926,31962
2045,82,625076,22550,713783,681251,32532
2046,82,625658,24800,716038,682026,34012
2047,87,626224,27300,715833,682532,33301
2048,90,626358,25650,681424,683032,-1608
2049,81,626516,23850,682524,683582,-1058
2050,87,627036,21450,683270,684101,-831
2051,85,627069,23150,683584,684682,-1098
2052,87,627187,22350,684184,685316,-1132
2053,86,627230,21850,683820,685993,-2173
2054,80,627718,22450,684419,686526,-2107
2055,83,628132,23050,685224,687351,-2127
2056,90,628235,27000,685284,688126,-2842
2057,84,628275,25800,684413,688916,-4503
2058,90,628412,20700,685365,689332,-3967
2059,86,628438,23650,685711,689843,-4132
2060,81,628634,21150,686463,690101,-3638
2061,84,628825,24900,687067,690482,-3415
2062,84,628979,21750,688065,690943,-2878
2063,83,629395,23050,688565,691532,-2967
2064,81,629487,22050,688569,692476,-3907
2065,82,630808,20750,689069,693132,-4063
2066,83,631044,22600,689565,694143,-4578
2067,90,631367,22950,690361,693732,-3371
2068,80,631436,22900,690719,694643,-3924
2069,80,631503,21100,690911,694801,-3890
2070,84,631506,22650,691511,695301,-3790
2071,84,631552,20850,692519,696366,-3847
2072,89,631618,26950,692315,696966,-4651
2073,84,632649,26700,692815,697343,-4528
2074,80,632726,21550,693317,697616,-4299
2075,84,632936,24000,694119,698182,-4063
2076,80,633701,23350,694367,698476,-4109
2077,83,633879,23050,685885,693172,-7287
2078,82,634018,21650,686405,694015,-7610
2079,83,634832,20350,686935,694272,-7337
2080,84,634964,23550,685565,695065,-9500
2081,80,635154,23350,687115,695318,-8203
2082,82,635718,21200,688215,696068,-7853
2083,80,635822,23800,690533,696568,-6035
2084,90,636325,25650,695765,697072,-1307
2085,90,636379,25650,693983,697468,-3485
2086,90,636383,23850,694983,698257,-3274
2087,89,636560,26500,698583,698757,-174
2088,81,636814,24750,700515,699665,850
2089,81,637114,19350,701065,699857,1208
2090,82,637667,23900,703565,700818,2747
2091,86,638097,20500,708315,701318,6997
2092,89,638152,23800,708533,701968,6565
2093,80,638186,24250,708365,702572,5793
2094,85,638702,24950,710183,703072,7111
2095,89,638952,24700,712533,704072,8461
2096,85,639017,25850,712715,704572,8143
2097,85,639208,27200,715265,705172,10093
2098,82,639406,25700,717733,706172,11561
2099,86,639559,21400,718783,706518,12265
2100,83,639719,22600,721365,707068,14297
2101,84,639721,25350,721533,707568,13965
2102,81,639793,22950,722033,707965,14068
2103,80,639933,18850,725683,708618,17065
2104,90,639964,23850,725165,709322,15843
2105,90,640205,19800,726315,709765,16550
2106,85,640456,21350,727783,710668,17115
2107,81,640810,22050,729433,711265,18168
2108,86,640948,22300,731233,711418,19815
2109,87,641680,22800,732215,711765,20450
2110,89,641949,25600,734033,712418,21615
2111,86,641998,23200,735783,712818,22965
2112,84,642686,26700,737033,713568,23465
2113,87,642948,21000,740733,713865,26868
2114,84,642960,21750,741215,714515,26700
2115,86,643083,21400,742315,714768,27547
2116,87,643463,24600,744183,715918,28265
2117,81,644111,18000,746715,716565,30150
2118,90,644174,27450,746883,717065,29818
2119,86,645882,27250,747883,717568,30315
2120,83,646108,21700,748765,718272,30493
2121,84,646287,25800,749978,718957,31021
2122,80,646464,19750,750284,719507,30777
2123,85,646922,24950,750834,719968,30866
2124,90,647539,26100,751810,720557,31253
2125,90,647560,22950,752270,721018,31252
2126,88,648559,21950,752283,721257,31026
2127,82,648969,21200,753065,721915,31150
2128,80,649605,23350,753983,722322,31661
2129,90,650557,22950,755815,722857,32958
2130,87,650797,23250,756315,723268,33047
2131,83,651389,21700,697631,723507,-25876
2132,88,652019,25100,698489,723865,-25376
2133,90,652824,21150,700139,724422,-24283
2134,82,652851,20750,699877,724915,-25038
2135,80,653332,17950,700639,725457,-24818
2136,81,653742,24300,701139,726015,-24876
2137,86,653832,23650,701877,726318,-24441
2138,82,654025,22550,702509,726957,-24448
2139,89,654161,26050,702844,728637,-25793
2140,86,654469,24100,703344,729401,-26057
2141,82,654634,26600,704227,729780,-25553
2142,89,654723,23350,704259,729966,-25707
2143,86,654801,23200,704494,730501,-26007
2144,81,655131,24300,705731,731116,-25385
2145,88,655158,23750,706931,731701,-24770
2146,87,655957,26400,708633,732851,-24218
2147,87,656215,23700,710333,733179,-22846
2148,84,657134,24450,711983,730337,-18354
2149,87,657509,25500,713331,731378,-18047
2150,90,657984,24300,714831,732937,-18106
2151,80,658126,24250,716483,733679,-17196
2152,89,659088,26950,718233,734653,-16420
2153,87,659264,26850,721783,734729,-12946
2154,89,659270,25600,722283,734578,-12295
2155,84,659315,19500,721931,735128,-13197
2156,85,659614,20900,723981,715372,8609
2157,83,659812,20800,726910,715779,11131
2158,82,659878,22100,726912,716348,10564
2159,90,660080,27000,727585,716879,10706
2160,90,660615,23850,728382,713762,14620
2161,90,660884,22500,729162,714126,15036
2162,82,661317,19850,729890,714645,15245
2163,89,662001,26050,729485,715226,14259
2164,82,662618,20300,729283,716058,13225
2165,87,662906,25050,732483,718208,14275
2166,88,662917,21500,732983,719067,13916
2167,86,663253,26350,735083,721217,13866
2168,85,664161,26300,734831,722417,12414
2169,89,664763,25600,722126,723708,-1582
2170,81,665019,23400,721496,725908,-4412
2171,80,665130,21550,722596,727124,-4528
2172,87,665371,25050,722344,727468,-5124
2173,84,665486,28500,723239,727968,-4729
2174,86,665570,23650,723177,729018,-5841
2175,90,666235,21600,723781,729615,-5834
2176,83,666502,22600,725289,730407,-5118
2177,89,666590,26950,724944,731024,-6080
2178,83,666735,21250,724927,731815,-6888
2179,84,667092,19950,720673,732118,-11445
2180,82,667185,21650,721057,728767,-7710
2181,88,667264,22850,721135,731058,-9923
2182,83,667611,23050,721635,732558,-10923
2183,83,668297,23050,722557,734508,-11951
2184,82,668571,21200,723063,735508,-12445
2185,88,668681,20600,723373,736467,-13094
2186,85,669410,22700,723970,737158,-13188
2187,84,669774,23100,725235,739317,-14082
2188,90,669813,26100,725570,739867,-14297
2189,87,669823,25500,725223,728751,-3528
2190,85,670605,24050,725773,729745,-3972
2191,82,670847,21200,726363,730245,-3882
2192,90,670956,25200,726863,730745,-3882
2193,81,671195,21600,727423,731245,-3822
2194,81,671460,22950,728707,731576,-2869
2195,83,671496,20350,728635,732368,-3733
2196,84,671622,22650,729735,732868,-3133
2197,82,671637,18950,729807,733101,-3294
2198,88,672079,20150,730570,733745,-3175
2199,85,672085,24950,731407,734295,-2888
2200,85,672404,25400,729915,734751,-4836
2201,87,672701,22800,730371,735126,-4755
2202,82,672788,25700,730817,736126,-5309
2203,82,673382,22100,730913,736618,-5705
2204,81,673894,18450,723431,737118,-13687
2205,89,674012,26050,725202,737826,-12624
2206,86,674063,19600,725444,738201,-12757
2207,83,674249,20350,725944,738926,-12982
2208,86,674496,22750,726859,739418,-12559
2209,84,674611,20850,727383,739595,-12212
2210,88,675326,18800,727959,740145,-12186
2211,83,675371,21250,728089,740645,-12556
2212,89,675834,26050,729644,741032,-11388
2213,84,675840,19050,729739,728605,1134
2214,82,676114,24800,730609,728788,1821
2215,86,676218,24100,730927,729605,1322
2216,80,676286,22900,731289,729912,1377
2217,86,677188,20500,731683,730486,1197
2218,84,677325,22200,732177,731503,674
2219,84,677721,30750,733194,733686,-492
2220,88,678078,27350,733309,734103,-794
2221,86,678314,24550,728081,732420,-4339
2222,81,678739,19350,730231,733174,-2943
2223,87,678941,22800,731781,733718,-1937
2224,82,679867,22100,733848,734557,-709
2225,88,680695,26900,738898,735274,3624
2226,89,680703,24700,737131,735824,1307
2227,82,680736,21650,738781,736424,2357
2228,80,681492,23350,740331,736618,3713
2229,85,681624,20450,743531,737218,6313
2230,86,681670,21850,743448,737857,5591
2231,82,681807,19850,744681,738220,6461
2232,85,682268,21350,748098,738957,9141
2233,83,682274,22600,747931,739174,8757
2234,83,683012,23050,749181,739607,9574
2235,85,683164,24500,750681,740274,10407
2236,87,683638,26850,752231,741018,11213
2237,80,683791,22450,755331,741970,13361
2238,87,683849,26850,755248,742715,12533
2239,90,684196,23850,757481,743307,14174
2240,88,684401,21050,757981,743857,14124
2241,85,684721,26300,739145,744618,-5473
2242,90,685306,25650,740215,744820,-4605
2243,83,685382,20800,740217,745465,-5248
2244,81,686121,19350,740815,745965,-5150
2245,82,686124,21650,741315,746674,-5359
2246,83,686365,22600,741415,747515,-6100
2247,88,686496,29150,742762,748015,-5253
2248,87,686990,21450,743015,748774,-5759
2249,86,687318,25000,744080,749274,-5194
2250,80,687982,22450,744263,749565,-5302
2251,86,688037,24550,744519,749774,-5255
2252,88,688312,26000,745069,750565,-5496
2253,87,688327,22800,745465,751057,-5592
2254,81,689406,24300,746415,751615,-5200
2255,88,689707,22400,747013,752470,-5457
2256,85,690816,23150,747367,753607,-6240
2257,81,691030,26100,748163,754615,-6452
2258,86,691110,21850,748619,755215,-6596
2259,80,691228,22000,749163,755770,-6607
2260,90,691268,27000,749315,757024,-7709
2261,84,691748,22200,745836,757757,-11921
2262,81,692965,23850,747486,757815,-10329
2263,82,693191,22100,747988,758257,-10269
2264,83,693571,25300,750086,759168,-9082
2265,85,694524,24950,751086,759807,-8721
2266,80,695331,22000,752388,760315,-7927
2267,86,695491,25000,753438,760607,-7169
2268,84,696012,25350,756238,761415,-5177
2269,87,696089,24600,758388,762120,-3732
2270,80,696123,22900,758286,762574,-4288
2271,85,696265,24050,758988,763124,-4136
2272,81,697446,23400,761636,763624,-1988
2273,84,697668,21750,761638,764018,-2380
2274,84,697880,23550,750315,764720,-14405
2275,87,698001,26850,750815,765618,-14803
2276,82,698201,18050,751465,766165,-14700
2277,80,698665,19750,752313,766674,-14361
2278,85,698874,24950,752913,767857,-14944
2279,87,700168,27750,753413,768365,-14952
2280,85,700470,23600,754369,768674,-14305
2281,82,700568,20750,754265,769065,-14800
2282,82,701348,24350,754919,769557,-14638
2283,81,702873,21150,755269,770018,-14749
2284,88,702967,24650,752333,771018,-18685
2285,87,703085,21450,753009,771470,-18461
2286,81,703258,22050,754531,771974,-17443
2287,80,703264,23350,755631,772207,-16576
2288,82,703371,23900,757436,772707,-15271
2289,81,703589,21150,757831,773524,-15693
2290,88,703716,23300,758931,774265,-15334
2291,80,703955,22450,760286,774857,-14571
2292,89,704169,21100,761281,775520,-14239
2293,86,704740,25900,763531,776174,-12643
2294,83,704789,25300,764086,776865,-12779
2295,83,705573,24850,759691,777218,-17527
2296,83,705867,22600,760577,777824,-17247
2297,81,706096,22050,761241,778268,-17027
2298,80,707356,20200,762791,778415,-15624
2299,88,707362,20600,762533,763768,-1235
2300,88,707664,22850,763309,764029,-720
2301,80,707854,19750,763541,764680,-1139
2302,90,708695,26100,764296,765179,-883
2303,83,708890,20350,764733,765468,-735
2304,82,709700,19400,765333,766262,-929
2305,83,709739,21700,765446,766762,-1316
2306,90,710117,26550,765833,767080,-1247
2307,86,710413,25900,766241,767479,-1238
2308,84,710793,24450,767146,767953,-807
2309,85,711244,23600,767877,768453,-576
2310,88,711977,20150,768309,768953,-644
2311,87,711988,22350,768646,769379,-733
2312,83,712072,20350,769091,770103,-1012
2313,87,712241,27300,769527,771168,-1641
2314,90,712430,27450,769696,771780,-2084
2315,86,712582,21850,770677,772029,-1352
2316,88,712628,22850,770609,772662,-2053
2317,90,712708,24300,771677,773518,-1841
2318,86,713006,20050,772446,774329,-1883
2319,84,713526,22650,772983,774062,-1079
2320,89,713895,25150,774041,767882,6159
2321,86,713945,25900,773959,768482,5477
2322,89,714567,19750,774791,769226,5565
2323,81,714603,22050,775109,769776,5333
2324,88,714787,22850,768512,770282,-1770
2325,89,715257,19300,769278,770876,-1598
2326,86,715259,22300,769684,771505,-1821
2327,82,715773,20750,770278,772382,-2104
2328,87,716098,22800,770320,772797,-2477
2329,90,716255,27900,771169,773618,-2449
2330,89,716880,26050,771834,774817,-2983
2331,90,717858,24300,772062,776010,-3948
2332,88,718109,20600,772669,777060,-4391
2333,89,718237,22000,773719,777667,-3948
2334,87,718565,26850,775634,779370,-3736
2335,84,718614,26250,775212,780407,-5195
2336,80,719286,22000,776828,780907,-4079
2337,86,719321,23200,776969,781120,-4151
2338,84,719696,23550,777670,781720,-4050
2339,86,720037,25900,777834,782620,-4786
2340,82,720079,22100,778428,783720,-5292
2341,90,720549,24750,779569,784470,-4901
2342,89,720590,24700,779820,785020,-5200
2343,86,720790,27250,780728,785607,-4879
2344,83,720853,22150,780734,781632,-898
2345,85,720940,19550,781169,782147,-978
2346,89,721094,22450,782020,782467,-447
2347,85,721289,23150,782234,783510,-1276
2348,85,721519,22700,782819,784967,-2148
2349,87,722409,24600,783234,786126,-2892
2350,84,722431,23550,784234,786657,-2423
2351,80,722438,22000,784069,787176,-3107
2352,89,722538,24250,785119,787520,-2401
2353,86,722897,25000,785819,787676,-1857
2354,83,722986,23500,786020,787976,-1956
2355,89,724643,24250,786869,788660,-1791
2356,85,724875,23600,788133,789497,-1364
2357,84,725300,25350,790233,789918,315
2358,87,725381,23700,790783,768692,22091
2359,85,725898,20450,791833,769300,22533
2360,84,726203,27600,792818,770098,22720
2361,90,726352,26100,795418,770242,25176
2362,84,727008,24000,798418,771124,27294
2363,85,727242,24500,799783,772050,27733
2364,81,727981,25200,801618,772798,28820
2365,87,728103,23250,802668,773674,28994
2366,83,728269,22600,805433,774100,31333
2367,86,728321,23200,805768,774432,31336
2368,83,729055,27550,808431,775424,33007
2369,81,729090,22050,809033,775992,33041
2370,87,729114,24600,810183,776624,33559
2371,86,729250,26350,811131,777148,33983
2372,81,729523,24750,812351,777444,34907
2373,83,729944,22150,814101,778217,35884
2374,83,730067,21250,816301,778646,37655
2375,88,730366,26450,817501,779292,38209
2376,85,731334,25850,819331,780100,39231
2377,85,731633,26300,821381,780650,40731
2378,88,731989,22400,822031,781865,40166
2379,90,732210,26550,824215,783365,40850
2380,89,732651,22000,824825,784611,40214
2381,82,732858,21200,825087,786711,38376
2382,87,733342,26400,826157,788815,37342
2383,83,733425,25300,826325,790418,35907
2384,88,734144,25100,826875,791068,35807
2385,88,734265,22850,828757,791855,36902
2386,83,734314,30700,828787,792826,35961
2387,88,734316,18800,828572,793332,35240
2388,88,735082,23750,830257,793976,36281
2389,90,735161,25650,830115,794418,35697
2390,86,735745,22750,830887,794455,36432
2391,88,735845,23750,831072,792065,39007
2392,87,736088,21450,828131,793061,35070
2393,82,736170,22550,828001,794015,33986
2394,84,736451,22650,829551,794918,34633
2395,83,736887,18550,830281,795228,35053
2396,87,737062,26850,831717,795918,35799
2397,84,737081,19050,831572,796761,34811
2398,89,737207,27400,832375,798311,34064
2399,85,737763,25850,832637,794517,38120
2400,83,737812,25750,832951,795307,37644
2401,80,737855,18850,833501,795620,37881
2402,81,737905,22500,802215,796567,5648
2403,84,737942,24000,803215,797170,6045
2404,80,738320,20200,805015,797626,7389
2405,82,739091,18950,805615,798217,7398
2406,88,739629,23300,806986,798370,8616
2407,82,739739,23450,807965,798876,9089
2408,82,739971,23000,809136,799426,9710
2409,81,740433,22500,811315,800257,11058
2410,80,741460,23800,812886,800926,11960
2411,82,741464,21650,814915,801417,13498
2412,83,741776,20800,817265,802122,15143
2413,83,741812,18100,817765,802407,15358
2414,87,741927,22800,819536,803172,16364
2415,90,742335,25200,821086,803470,17616
2416,87,742880,22350,822736,804017,18719
2417,82,743518,23450,825436,804322,21114
2418,81,743582,23850,825365,804526,20839
2419,87,744499,27300,828015,805170,22845
2420,84,744520,24900,813768,805557,8211
2421,86,745185,24550,814722,805870,8852
2422,90,745292,25200,801662,806767,-5105
2423,86,745377,21400,801634,807057,-5423
2424,86,745939,24100,802840,807870,-5030
2425,88,746363,25550,803362,808420,-5058
2426,81,746645,22950,804287,808967,-4680
2427,80,747245,23350,805112,809467,-4355
2428,86,747755,23650,805387,809972,-4585
2429,82,748213,26600,805887,810607,-4720
2430,88,748390,24650,806534,811157,-4623
2431,81,748845,20250,806634,811326,-4692
2432,85,748893,24050,807090,811570,-4480
2433,82,749361,20750,807640,812120,-4480
2434,81,749676,23400,808434,812672,-4238
2435,82,750037,19850,808640,813076,-4436
2436,86,750338,25000,809012,813672,-4660
2437,90,750520,25200,810836,814172,-3336
2438,87,750666,20100,811584,814957,-3373
2439,90,750873,25650,812334,815526,-3192
2440,81,751245,22500,804777,815967,-11190
2441,81,751420,22050,805283,817147,-11864
2442,85,751856,26750,805833,818832,-12999
2443,80,752080,22000,806859,820397,-13538
2444,80,752122,24250,807177,821632,-14455
2445,85,752289,23150,816771,823697,-6926
2446,90,752574,28350,817562,824882,-7320
2447,87,752704,22800,818062,826397,-8335
2448,81,753066,20700,818634,826897,-8263
2449,90,753185,24300,819134,827282,-8148
2450,87,753299,21450,819471,822107,-2636
2451,88,753420,26000,820834,822567,-1733
2452,85,753473,24050,821334,823067,-1733
2453,84,753474,27150,821172,824520,-3348
2454,87,753874,24150,822078,824857,-2779
2455,89,754163,20200,822872,825520,-2648
2456,88,754257,24650,823171,826372,-3201
2457,90,754282,27000,823762,826967,-3205
2458,84,754866,24450,824471,827676,-3205
2459,89,754936,22000,824622,828120,-3498
2460,89,755098,27400,825328,828567,-3239
2461,80,755426,22450,826071,829207,-3136
2462,83,755437,26650,827121,829770,-2649
2463,90,755638,24750,827562,830626,-3064
2464,90,755741,20250,828434,830857,-2423
2465,80,755810,22900,828271,831726,-3455
2466,84,756386,25800,829072,832320,-3248
2467,90,756665,27000,829662,833320,-3658
2468,83,757386,23500,830578,833657,-3079
2469,86,757622,23200,831222,833876,-2654
2470,87,757728,25050,831678,834520,-2842
2471,85,757982,22250,831984,835522,-3538
2472,86,758403,19150,832572,835926,-3354
2473,85,758550,25850,833034,836917,-3883
2474,86,759526,23650,833571,837572,-4001
2475,90,759676,22950,833878,838626,-4748
2476,86,759821,23200,834378,839607,-5229
2477,85,759969,23600,834978,840276,-5298
2478,87,760240,24600,835684,840876,-5192
2479,89,761705,23800,836421,841270,-4849
2480,88,761755,23300,836828,841820,-4992
2481,87,762412,22800,837722,824957,12765
2482,87,762552,23700,838272,825507,12765
2483,89,762774,25150,838571,826499,12072
2484,90,763476,24300,839533,827182,12351
2485,88,764085,25100,840387,827732,12655
2486,90,764346,24750,842283,828232,14051
2487,82,764487,23900,844237,828732,15505
2488,82,764557,23450,844483,829268,15215
2489,80,764851,20650,841778,830257,11521
2490,87,765019,21900,843071,830378,12693
2491,83,765038,20800,842722,831318,11404
2492,86,765088,21850,843128,831928,11200
2493,82,765762,21200,843721,832882,10839
2494,83,765765,21700,844272,833399,10873
2495,82,766513,22550,844928,833899,11029
2496,89,766672,26950,845821,834499,11322
2497,86,766885,21850,846628,835132,11496
2498,85,767022,22700,847184,835907,11277
2499,90,767050,20700,847562,836378,11184
2500,81,767462,20700,848262,837007,11255
2501,87,767487,25050,848762,837507,11255
2502,88,767690,25100,849078,838118,10960
2503,83,767795,20800,849412,837778,11634
2504,90,767949,24300,849578,838857,10721
2505,86,767989,26800,850171,839328,10843
2506,88,768203,24650,850684,839878,10806
2507,84,769760,22200,851022,839999,11023
2508,82,769869,26150,851371,840978,10393
2509,90,770138,24300,851884,841528,10356
2510,81,770424,23400,852412,842299,10113
2511,87,770907,24600,853772,842707,11065
2512,81,770908,21600,853728,843582,10146
2513,84,771580,21300,854671,844549,10122
2514,87,771642,23700,854928,845257,9671
2515,82,771783,25700,855372,845332,10040
2516,83,772086,26650,855912,842222,13690
2517,81,772087,22050,856372,842420,13952
2518,81,772464,21600,856784,843009,13775
2519,83,772714,21250,857462,843322,14140
2520,82,772865,24350,858422,843867,14555
2521,90,773307,25200,836117,844776,-8659
2522,84,773613,24000,836615,845472,-8857
2523,81,773740,19350,837215,844010,-6795
2524,88,773947,23300,838019,845510,-7491
2525,85,774040,23150,838415,846161,-7746
2526,88,774389,23750,838915,846426,-7511
2527,80,774671,23800,839317,847310,-7993
2528,85,774792,27200,839569,847360,-7791
2529,80,774899,25600,840121,834074,6047
2530,86,775470,26350,840469,834498,5971
2531,89,775628,25150,843031,835134,7897
2532,82,776250,23450,844008,835750,8258
2533,85,776684,25400,845781,836234,9547
2534,87,776792,24600,845831,836800,9031
2535,90,776883,21150,844017,836698,7319
2536,86,777465,21850,844169,835196,8973
2537,88,777807,22850,844521,835844,8677
2538,87,778045,26400,845465,836832,8633
2539,80,778420,22450,846017,837332,8685
2540,80,779028,23350,846515,837832,8683
2541,86,779268,26350,847665,838117,9548
2542,84,779351,16800,847617,838631,8986
2543,90,781048,27000,848265,839617,8648
2544,83,782154,23500,846982,840144,6838
2545,82,782540,21200,847268,840744,6524
2546,88,782744,23300,841196,841394,-198
2547,82,783196,24350,842399,841646,753
2548,88,783298,25100,846496,840518,5978
2549,82,783368,24350,848146,842668,5478
2550,83,783430,18100,847899,843761,4138
2551,90,783559,25200,849049,844818,4231
2552,87,784070,26850,851199,846811,4388
2553,80,784196,18850,852296,847518,4778
2554,81,784491,20700,855596,848618,6978
2555,80,784790,20650,856949,850361,6588
2556,90,785088,24300,859149,851911,7238
2557,87,785331,25050,859846,852418,7428
2558,86,785498,25900,849639,853968,-4329
2559,88,785652,27350,852289,856461,-4172
2560,80,785681,17500,852741,857718,-4977
2561,87,785830,21000,854391,858911,-4520
2562,88,786133,21950,855641,860061,-4420
2563,89,786399,25150,857791,860711,-2920
2564,80,786561,23350,861389,861761,-372
2565,81,786633,20250,863491,862811,680
2566,90,786665,27900,862991,864311,-1320
2567,86,787011,26800,866519,866811,-292
2568,80,787063,24250,866449,868268,-1819
2569,81,787410,19800,866323,869468,-3145
2570,89,787841,23350,868669,852267,16402
2571,89,787869,25150,868814,852976,15838
2572,82,788150,22100,869183,853620,15563
2573,80,788345,18850,869699,854620,15079
2574,85,788650,27650,870183,854826,15357
2575,83,789580,24850,870564,855367,15197
2576,85,789827,21350,870973,855722,15251
2577,90,790026,24300,871399,856417,14982
2578,84,790418,24450,872073,857213,14860
2579,83,790607,22150,872814,857726,15088
2580,89,790875,21550,873169,857922,15247
2581,82,791048,19850,874673,858776,15897
2582,86,791124,24550,874169,859172,14997
2583,90,791140,21600,874669,859917,14752
2584,89,791173,24250,874849,860563,14286
2585,85,791255,22700,870441,861822,8619
2586,83,791319,22600,870439,862322,8117
2587,82,791484,22100,874141,862720,11421
2588,87,791550,28200,873789,863117,10672
2589,80,792074,22900,875219,863363,11856
2590,86,792280,24100,876499,863770,12729
2591,88,792282,22850,876316,864270,12046
2592,84,792624,21300,877466,864963,12503
2593,86,793072,23200,877966,865022,12944
2594,90,793183,25200,876841,865513,11328
2595,81,793696,24300,881041,866013,15028
2596,83,793749,23050,881541,866613,14928
2597,82,794126,22100,882541,867113,15428
2598,89,794681,26950,880789,867567,13222
2599,89,794684,22450,884389,868076,16313
2600,81,794690,21600,883984,868626,15358
2601,83,794956,22150,886184,868970,17214
2602,89,795507,25150,887789,869826,17963
2603,85,795902,22700,891539,870520,21019
2604,83,795923,19900,891484,871017,20467
2605,84,796134,24000,891984,871517,20467
2606,90,796225,28350,863909,872117,-8208
2607,80,796335,23350,864498,872620,-8122
2608,81,796583,21150,864729,872863,-8134
2609,89,796721,22000,865379,873620,-8241
2610,80,796739,20650,865264,874120,-8856
2611,84,796917,21300,865864,874517,-8653
2612,82,797086,18050,865928,875117,-9189
2613,86,797416,28600,866364,875526,-9162
2614,82,797828,23450,867421,876217,-8796
2615,88,798512,24200,867928,876472,-8544
2616,82,798855,26150,869128,876972,-7844
2617,90,798900,23850,869171,877763,-8592
2618,80,799905,24250,869628,878767,-9139
2619,88,800018,25100,869698,879313,-9615
2620,84,800225,21300,869509,880932,-11423
2621,89,801174,26500,870485,881982,-11497
2622,81,801485,22500,871283,880820,-9537
2623,89,802130,26050,872383,881820,-9437
2624,85,802507,22250,873883,882363,-8480
2625,84,803057,21750,875433,882913,-7480
2626,87,803431,22350,876883,883476,-6593
2627,85,803672,21350,878033,884022,-5989
2628,84,803750,19950,880640,884320,-3680
2629,84,803818,23100,879590,884572,-4982
2630,86,804196,26800,883290,885026,-1736
2631,82,804534,24800,883890,885463,-1573
2632,87,804690,22350,885283,886017,-734
2633,82,805276,22100,887933,886563,1370
2634,81,805546,19800,889290,887063,2227
2635,83,805617,24850,891183,887270,3913
2636,90,805799,26100,892683,887972,4711
2637,88,805899,20150,893833,888270,5563
2638,90,806167,28350,895983,888770,7213
2639,90,806356,29250,901033,889676,11357
2640,87,806389,24150,901990,890663,11327
2641,82,806402,22550,901583,891420,10163
2642,89,806902,21100,904090,892067,12023
2643,84,807330,23100,905333,892876,12457
2644,85,807629,20900,905883,893113,12770
2645,89,807953,24700,906433,894117,12316
2646,89,808110,23350,907633,894413,13220
2647,89,808582,22900,909233,895272,13961
2648,89,808596,24250,910840,896013,14827
2649,87,809347,24150,911483,896872,14611
2650,88,809535,29150,913190,898026,15164
2651,81,809643,20700,914633,898422,16211
2652,87,810071,25500,915183,899076,16107
2653,84,810267,24450,918233,899472,18761
2654,80,810287,21100,918040,899863,18177
2655,82,810338,22100,917940,900370,17570
2656,81,810751,23850,919833,900567,19266
2657,90,811547,22050,921190,901063,20127
2658,82,812133,24800,922533,901572,20961
2659,89,812264,22900,923640,902072,21568
2660,83,812265,22150,924790,903070,21720
2661,81,812633,22050,926490,903326,23164
2662,84,812885,26700,928040,904070,23970
2663,83,813227,20800,930183,886549,43634
2664,80,813239,21550,929740,887282,42458
2665,80,814567,25150,932390,888149,44241
2666,82,814703,18500,933790,888430,45360
2667,86,815031,22750,935133,889430,45703
2668,81,815403,21150,936390,889968,46422
2669,86,815555,23200,938490,890657,47833
2670,80,817144,21550,940090,891082,49008
2671,82,817157,22550,941090,892030,49060
2672,88,817733,22850,943090,892718,50372
2673,83,818010,23050,945790,893749,52041
2674,85,818060,26300,945933,893307,52626
2675,87,818391,21450,947140,877530,69610
2676,89,818870,25600,947183,878625,68558
2677,90,819506,25200,879311,879352,-41
2678,87,820340,21900,880431,879852,579
2679,84,821274,19050,881581,880402,1179
2680,90,822056,26100,882811,880829,1982
2681,89,823113,25600,885511,881686,3825
2682,88,823193,22850,885531,882236,3295
2683,83,824030,20350,886311,882752,3559
2684,80,824601,20650,886961,878942,8019
2685,83,824651,21250,888161,879350,8811
2686,82,824770,22100,889681,879726,9955
2687,81,825625,19800,890331,880350,9981
2688,86,825973,24100,891981,881922,10059
2689,85,826249,19100,893461,883360,10101
2690,87,826638,23700,894081,884822,9259
2691,83,827360,23950,895311,886922,8389
2692,90,827601,26100,897961,888122,9839
2693,87,827762,26400,899561,889510,10051
2694,90,828305,27450,901131,892010,9121
2695,82,828561,23450,902631,893872,8759
2696,86,828615,24550,904681,894760,9921
2697,88,828902,26900,906831,895810,11021
2698,86,828907,25900,906911,897772,9139
2699,88,829327,22850,908431,898522,9909
2700,87,829502,25050,909761,900560,9201
2701,83,829675,22150,912661,901560,11101
2702,82,829703,24350,912731,903422,9309
2703,86,829829,21400,913231,904463,8768
2704,83,830846,19000,914561,904576,9985
2705,87,831194,22800,895072,905170,-10098
2706,86,831271,25900,896272,906074,-9802
2707,87,831274,26400,896128,905360,-9232
2708,81,831426,21150,896822,906574,-9752
2709,90,831662,23400,897778,907174,-9396
2710,89,831729,25150,898328,907372,-9044
2711,87,832043,25500,899522,896584,2938
2712,89,832141,25600,900022,897380,2642
2713,88,832304,23300,901014,898168,2846
2714,87,833277,22800,902828,898807,4021
2715,89,833304,21100,903284,899357,3927
2716,88,833338,24650,903828,899907,3921
2717,90,833430,26100,904334,900484,3850
2718,84,833505,24900,904473,900799,3674
2719,86,833724,24550,905322,901984,3338
2720,87,833781,22350,905073,902568,2505
2721,80,834871,26500,906614,903107,3507
2722,88,834950,21950,906534,903607,2927
2723,85,835077,19550,906822,904157,2665
2724,87,835099,22800,907084,904418,2666
2725,80,835194,20650,907578,904968,2610
2726,85,835333,22700,909173,905568,3605
2727,86,835406,24100,909384,906284,3100
2728,84,836023,22200,909878,907218,2660
2729,85,836811,25400,910064,907449,2615
2730,88,836833,22400,910428,908018,2410
2731,85,837265,22250,911122,908984,2138
2732,82,838507,21200,912034,909518,2516
2733,88,838845,25550,912722,910507,2215
2734,81,838902,21600,912464,910930,1534
2735,84,838915,22650,912973,911234,1739
2736,85,839217,22250,913473,912199,1274
2737,84,839264,19950,913973,903064,10909
2738,84,839717,22650,914322,903222,11100
2739,83,839844,21700,914523,903689,10834
2740,89,840904,26050,915084,904239,10845
2741,81,840960,20250,915573,904514,11059
2742,83,841566,20350,915728,904885,10843
2743,81,841707,21150,916723,905107,11616
2744,84,842142,22650,917022,905657,11365
2745,86,842323,24550,917734,906707,11027
2746,82,842552,25700,918478,909018,9460
2747,86,842819,24550,918834,911168,7666
2748,87,843740,27750,919714,913268,6446
2749,85,844806,23150,920372,914363,6009
2750,85,844955,24500,920578,916563,4015
2751,86,845263,26350,921696,919113,2583
2752,85,845490,23600,925596,919818,5778
2753,90,845518,30150,925702,921863,3839
2754,86,845570,21400,926202,923463,2739
2755,83,845688,19900,926746,925263,1483
2756,82,846076,21200,917221,926318,-9097
2757,80,846123,20650,917299,929418,-12119
2758,83,847140,23500,917933,930713,-12780
2759,80,847603,21550,918471,932963,-14492
2760,89,847865,24700,919471,935513,-16042
2761,87,847925,22350,919749,936163,-16414
2762,86,847976,18700,920083,937263,-17180
2763,90,848214,21150,920971,938418,-17447
2764,81,848846,20700,921549,938713,-17164
2765,86,849662,24100,922016,939963,-17947
2766,81,849954,21600,922423,940418,-17995
2767,84,850258,24900,922683,927300,-4617
2768,89,850271,22900,923466,928034,-4568
2769,89,850287,22450,924066,928728,-4662
2770,85,850454,20450,924573,928952,-4379
2771,82,850562,23450,925173,929452,-4279
2772,88,851060,22850,925799,929950,-4151
2773,88,851199,25100,926921,930550,-3629
2774,87,851256,22800,926873,930692,-3819
2775,80,851613,21550,927921,931192,-3271
2776,88,852568,29150,928766,932302,-3536
2777,85,853012,20900,924219,932742,-8523
2778,88,853667,24200,924719,933352,-8633
2779,87,854245,23700,924819,933892,-9073
2780,81,854431,21600,925373,934392,-9019
2781,85,854723,24950,925819,935350,-9531
2782,89,854954,20200,926615,935352,-8737
2783,80,854997,22900,927165,925932,1233
2784,84,856001,20400,927265,926703,562
2785,88,856181,23750,927573,927803,-230
2786,81,856220,24750,928419,929353,-934
2787,80,856457,22450,928573,930953,-2380
2788,82,856644,21650,929069,933003,-3934
2789,83,857067,24850,929265,934982,-5717
2790,80,857261,22000,929865,936442,-6577
2791,89,857361,25600,930269,937378,-7109
2792,89,857588,22000,930523,937552,-7029
2793,90,858249,26550,932065,937978,-5913
2794,87,858292,23250,932073,938736,-6663
2795,87,858760,25950,933069,939602,-6533
2796,89,858851,25600,933173,939700,-6527
2797,85,859050,20450,938291,938153,138
2798,90,859053,23850,938365,938782,-417
2799,86,859070,20500,938841,939282,-441
2800,86,859094,25000,938915,940152,-1237
2801,88,859213,21050,940441,940752,-311
2802,85,859237,24500,942041,940800,1241
2803,83,859700,21700,943365,941553,1812
2804,88,860727,27350,946791,941882,4909
2805,85,860767,24050,946665,938730,7935
2806,83,861050,21250,947491,939313,8178
2807,80,861342,23800,950115,939730,10385
2808,88,861441,25100,951765,940374,11391
2809,83,861473,19450,951691,940913,10778
2810,80,861725,28750,954791,942220,12571
2811,84,861787,25800,955291,943030,12261
2812,80,861933,21100,957015,943513,13502
2813,88,862615,22850,958841,944374,14467
2814,82,863019,22550,961915,945113,16802
2815,86,863085,22300,961591,945317,16274
2816,88,863185,24200,963465,946113,17352
2817,90,863647,22500,964741,946970,17771
2818,81,863715,24750,966791,947470,19321
2819,80,863758,20650,969491,947967,21524
2820,82,863810,23450,969991,948680,21311
2821,89,864597,23350,971015,949313,21702
2822,85,864830,21350,972141,949717,22424
2823,81,864953,21150,973815,950730,23085
2824,80,865224,21100,975391,951267,24124
2825,86,865922,20500,976315,951663,24652
2826,86,866133,23650,976865,952030,24835
2827,89,866201,19300,978515,952670,25845
2828,90,866680,25650,981115,953467,27648
2829,87,866799,21900,981491,953924,27567
2830,89,866864,24250,954941,954474,467
2831,87,866959,22350,933234,955024,-21790
2832,87,867067,21900,934704,955780,-21076
2833,81,867200,26100,936854,956624,-19770
2834,88,867564,23300,938354,957624,-19270
2835,85,867737,24050,940534,958124,-17590
2836,89,867881,27850,941534,959413,-17879
2837,85,867953,29000,943854,959780,-15926
2838,86,868054,21850,944904,960013,-15109
2839,80,868249,19750,946434,960270,-13836
2840,85,868643,22250,947954,960567,-12613
2841,80,868734,21550,933541,961167,-27626
2842,82,868793,22550,936034,961830,-25796
2843,87,869188,21900,936591,962663,-26072
2844,83,869420,22600,937741,962970,-25229
2845,86,869525,22750,940941,963713,-22772
2846,80,869635,23800,942941,964263,-21322
2847,82,870046,23450,944534,965080,-20546
2848,86,870150,25450,945784,965520,-19736
2849,90,870151,22500,946834,966013,-19179
2850,89,870427,23350,948691,966570,-17879
2851,83,870818,24850,950411,967563,-17152
2852,90,870886,24750,950911,968167,-17256
2853,86,870887,25450,953291,968420,-15129
2854,84,871223,21750,953791,968574,-14783
2855,90,871453,22500,955134,948796,6338
2856,90,871698,28350,957441,949296,8145
2857,87,871731,21000,958491,950046,8445
2858,86,871829,22300,958834,950784,8050
2859,90,872325,22050,960784,951346,9438
2860,88,873007,24650,962434,952334,10100
2861,81,874443,25200,963891,952839,11052
2862,87,874784,25050,965641,953889,11752
2863,82,874885,25250,967334,954623,12711
2864,84,874950,19950,968484,955539,12945
2865,85,875445,24950,968411,955734,12677
2866,90,875840,26550,969334,956723,12611
2867,87,876825,22350,970084,957534,12550
2868,89,877609,19750,971134,958134,13000
2869,82,877956,22100,973234,958684,14550
2870,88,878522,26900,974161,959339,14822
2871,85,878627,23600,977034,960234,16800
2872,89,878664,24250,976961,960796,16165
2873,86,878854,23200,979011,961346,17665
2874,86,879089,27250,980884,961746,19138
2875,88,879839,22400,982534,962296,20238
2876,88,880811,21500,983734,959886,23848
2877,87,881192,23250,984934,960580,24354
2878,80,881528,23350,986661,960768,25893
2879,85,881728,20000,987884,961199,26685
2880,83,881839,20800,988961,961657,27304
2881,88,882498,26000,991161,962449,28712
2882,81,882581,21150,993134,962907,30227
2883,81,883266,25200,996884,963480,33404
2884,81,883307,24300,997061,964007,33054
2885,81,884087,25650,998561,964186,34375
2886,82,884177,24800,999684,965049,34635
2887,84,884533,17700,999734,965168,34566
2888,89,884749,23050,968839,963048,5791
2889,85,885318,18850,971871,963634,8237
2890,85,885338,24150,972371,964346,8025
2891,82,885623,22850,973921,965346,8575
2892,83,886649,19700,975471,965648,9823
2893,81,887239,19200,980489,966496,13993
2894,90,887240,21500,980871,967139,13732
2895,81,887251,17150,981371,968023,13348
2896,87,887281,21250,981489,968573,12916
2897,81,887517,20650,982639,969922,12717
2898,90,887558,23500,982621,971263,11358
2899,83,888259,23550,985771,974022,11749
2900,89,888357,21900,985489,975813,9676
2901,82,888572,21700,988321,978522,9799
2902,88,888883,22800,990516,981072,9444
2903,81,889754,18050,991066,982063,9003
2904,84,889882,18100,991767,982713,9054
2905,83,890244,16500,992066,983713,8353
2906,90,890421,24500,992467,984672,7795
2907,85,890601,21900,993621,985872,7749
2908,88,890657,27350,959438,986922,-27484
2909,80,890676,22450,959690,972723,-13033
2910,81,891035,23400,960012,962794,-2782
2911,90,891037,24300,958128,963294,-5166
2912,86,891052,20950,958628,963412,-4784
2913,86,891214,21850,959272,964662,-5390
2914,81,891719,20700,960084,964442,-4358
2915,86,892011,24100,960684,964965,-4281
2916,82,892088,21650,960966,965762,-4796
2917,86,892102,23650,961784,966210,-4426
2918,90,892333,28800,961966,967042,-5076
2919,80,892482,22000,962516,967644,-5128
2920,81,892752,23850,963566,968260,-4694
2921,86,893001,24550,964116,968865,-4749
2922,86,893205,23650,965022,969460,-4438
2923,85,893244,23600,965116,969794,-4678
2924,80,893317,20650,966622,970125,-3503
2925,83,893391,25750,966833,971108,-4275
2926,80,893454,23800,966784,971327,-4543
2927,86,893585,24550,967816,972125,-4309
2928,81,893755,19800,967983,972377,-4394
2929,90,894405,21600,968573,974215,-5642
2930,88,894762,24650,969123,975818,-6695
2931,81,895106,18000,969566,976115,-6549
2932,87,895222,19200,971023,977018,-5995
2933,90,895284,24300,971766,978118,-6352
2934,89,895345,21100,971699,979118,-7419
2935,84,895459,24900,971923,981168,-9245
2936,90,895596,22950,972699,982165,-9466
2937,85,896750,21800,973423,984368,-10945
2938,80,897320,18400,973983,985568,-11585
2939,85,897486,22250,974966,986565,-11599
2940,89,897707,21550,975966,987368,-11402
2941,83,898561,23050,976133,988568,-12435
2942,81,899083,21150,978183,989118,-10935
2943,86,899132,24100,978223,991165,-12942
2944,80,899164,23800,978266,993165,-14899
2945,81,900080,23400,979723,994715,-14992
2946,83,900800,23050,980883,995968,-15085
2947,86,900838,23650,980849,998415,-17566
2948,87,901199,25500,981583,999818,-18235
2949,87,901199,22350,982083,977292,4791
2950,84,901964,26250,982399,977792,4607
2951,81,901995,25200,974119,978740,-4621
2952,90,902499,25650,974669,979290,-4621
2953,81,903449,19800,975219,979402,-4183
2954,90,903505,27450,976065,980492,-4427
2955,82,903773,25250,976665,981052,-4387
2956,86,904206,25000,977215,981492,-4277
2957,81,904743,24300,978015,982502,-4487
2958,82,905486,24800,978265,983078,-4813
2959,84,905545,20400,978865,983152,-4287
2960,80,905966,20650,979271,984042,-4771
2961,90,906282,22500,979619,984702,-5083
2962,82,907019,22550,980271,985390,-5119
2963,89,907529,26950,981271,985752,-4481
2964,80,907565,18400,981215,986092,-4877
2965,85,907857,21350,981523,986590,-5067
2966,85,908028,21800,981715,987090,-5375
2967,85,908166,24500,982523,987502,-4979
2968,82,908329,18950,982721,988342,-5621
2969,87,909897,24600,983215,988840,-5625
2970,87,910902,20550,983669,989342,-5673
2971,82,911155,22550,984465,989652,-5187
2972,83,911445,23050,984971,990452,-5481
2973,86,911766,25000,985465,990702,-5237
2974,90,911871,26100,986455,991390,-4935
2975,84,911889,21300,988046,991502,-3456
2976,87,912297,21900,989255,991778,-2523
2977,83,912453,22150,991296,992328,-1032
2978,81,912550,19350,991605,992878,-1273
2979,90,912616,25200,989073,993052,-3979
2980,83,913220,22150,989623,993292,-3669
2981,88,913374,24650,990421,988588,1833
2982,87,913533,18300,990869,989461,1408
2983,89,914186,27850,991471,990988,483
2984,89,914281,23350,991965,992011,-46
2985,83,914586,22600,992465,990720,1745
2986,83,914849,19900,993215,991119,2096
2987,82,914875,21200,993271,991574,1697
2988,84,915313,23100,993815,992530,1285
2989,90,915353,22500,994365,993030,1335
2990,87,915407,25500,995023,993563,1460
2991,82,915661,22100,988537,993680,-5143
2992,87,916189,26400,990837,994224,-3387
2993,85,916227,26300,991387,995113,-3726
2994,87,916551,23250,992937,995663,-2726
2995,89,916681,24250,994204,996230,-2026
2996,86,916829,21400,994754,996720,-1966
2997,83,917132,21700,996404,997419,-1015
2998,86,917416,22750,996987,998074,-1087
2999,81,917614,24750,998987,999363,-376
3000,88,917716,21600,999987,999520,467
3001,81,918001,20550,993099,999963,-6864
3002,89,918026,20500,993066,999724,-6658
3003,85,918145,23200,993725,978185,15540
3004,88,918927,25600,994275,979329,14946
3005,89,919131,26650,995099,980254,14845
3006,84,919346,15650,995383,980479,14904
3007,84,919726,22150,995775,980804,14971
3008,88,920618,22200,996375,981936,14439
3009,89,920955,19800,997123,982581,14542
3010,86,921097,17800,997999,982656,15343
3011,81,921405,15700,998375,983706,14669
3012,85,921827,19950,998766,985256,13510
3013,80,922393,19750,999525,986732,12793
3014,88,922487,20700,999549,987282,12267
3015,86,922813,21250,998134,989382,8752
3016,89,923200,21700,998723,991006,7717
3017,81,923242,18500,999273,992082,7191
3018,80,923738,20150,999978,993552,6426
3019,83,923901,15900,992491,994252,-1761
3020,84,924276,19950,995091,994802,289
3021,81,924384,14400,996844,995602,1242
3022,81,924441,16200,996741,995680,1061
3023,85,924613,16200,997944,996180,1764
3024,84,925523,16700,999441,995840,3601
3025,80,925558,16650,999991,996782,3209
3042,86,929955,14100,997623,998056,-433
3043,86,930903,11450,998165,999582,-1417
3043,86,930903,13750,998371,999856,-1485
3043,86,930903,18200,998915,991548,7367
3043,86,930903,17650,999273,991739,7534
3043,86,930903,15050,999873,992096,7777
3043,86,930903,13850,999915,992748,7167
3043,86,930903,15400,983993,993146,-9153
3043,86,930903,14050,984533,993925,-9392
3043,86,930903,16450,985333,994489,-9156
3044,90,930962,13600,985611,994998,-9387
3044,90,930962,12700,986348,995896,-9548
3044,90,930962,12950,986483,996625,-10142
3044,90,930962,16250,987348,997298,-9950
3044,90,930962,16850,988454,998188,-9734
3044,90,930962,16200,989242,998825,-9583
3044,90,930962,14450,990039,999238,-9199
3044,90,930962,13900,991589,999738,-8149
3044,90,930962,17600,991543,999788,-8245
3045,82,930973,16900,992139,993994,-1855
3046,87,931065,15950,992383,994612,-2229
3047,88,931689,20200,992933,995094,-2161
3048,82,931806,16500,994033,995594,-1561
3049,80,932279,19300,995384,996262,-878
3050,81,932354,16400,995393,996962,-1569
3051,81,933924,18700,996493,997694,-1201
3052,84,935234,19950,998643,998094,549
3053,90,935397,21800,999693,999062,631
3054,89,935404,17800,997261,999662,-2401
3055,82,936017,14350,997885,999912,-2027
3056,80,936177,15400,998485,999962,-1477
3057,84,936380,17300,999793,998749,1044
3058,86,938461,17500,999948,999118,830
3059,83,938672,14900,999998,999749,249
3060,85,938891,14050,999818,999899,-81
3061,81,938901,14250,999939,993564,6375
3062,86,939012,12350,999918,994343,5575
3063,87,939076,16800,986783,994761,-7978
3064,80,939317,12700,988033,995674,-7641
3065,88,939332,15250,989433,996461,-7028
3066,81,939585,12150,990183,996714,-6531
3067,82,940011,13950,993333,997214,-3881
3068,86,940066,15100,993483,998091,-4608
3069,86,940086,12700,993433,998743,-5310
3070,84,940231,13800,994583,998914,-4331
3071,83,940254,14300,995833,999824,-3991
3072,85,940517,10550,996133,999911,-3778
3073,80,940539,12900,997783,999961,-2178
3074,90,940894,17900,998483,999592,-1109
3075,83,941267,17750,999783,999902,-119
3076,88,941389,13700,999973,999952,21
3163,85,970919,11500,999883,999131,752
3163,85,970919,13750,999933,999684,249
3163,85,970919,10100,999983,999979,4
3080,82,941937,9900,995718,974588,21130
3081,80,942709,13100,996791,975688,21103
3082,83,943068,15100,998418,977788,20630
3083,82,944268,17150,999541,979673,19868
3136,80,959643,11600,998122,981038,17084
3136,80,959643,10150,998436,983023,15413
3136,80,959643,9500,999186,984238,14948
3136,80,959643,15400,999928,985423,14505
3136,80,959643,14250,999978,986538,13440
3137,84,960253,11650,997215,988173,9042
3137,84,960253,10950,997567,988823,8744
3137,84,960253,11250,998067,989873,8194
3137,84,960253,6750,998617,991088,7529
3137,84,960253,13200,999359,991738,7621
3137,84,960253,11850,999715,992888,6827
3137,84,960253,14050,999968,994138,5830
3137,84,960253,9850,997511,995738,1773
3137,84,960253,10850,998069,997273,796
3137,84,960253,11750,998381,998538,-157
3137,84,960253,6000,999481,999873,-392
3137,84,960253,6450,999981,998141,1840
3138,85,960363,6150,989980,999741,-9761
3138,85,960363,6600,992630,972912,19718
3138,85,960363,5600,993130,976041,17089
3138,85,960363,5500,994880,978291,16589
3138,85,960363,3850,996880,979896,16984
3138,85,960363,5450,999680,981496,18184
3138,85,960363,9550,999680,982570,17110
3138,85,960363,3150,985291,984896,395
3138,85,960363,4250,984913,986670,-1757
3138,85,960363,4700,986633,988746,-2113
3138,85,960363,4000,988383,990246,-1863
3138,85,960363,2800,989783,991220,-1437
3138,85,960363,2850,991983,992246,-263
3139,82,960385,2900,994583,994246,337
3139,82,960385,6950,995083,995420,-337
3139,82,960385,7900,998372,997670,702
3139,82,960385,8600,999329,999720,-391
3139,82,960385,6450,999219,999696,-477
3139,82,960385,3650,999539,998490,1049
3139,82,960385,5250,999972,999561,411
3139,82,960385,3800,999979,999711,268
3140,89,960417,2950,987163,991743,-4580
3140,89,960417,2200,987663,993343,-5680
3140,89,960417,2300,987341,994434,-7093
3140,89,960417,3950,989033,996043,-7010
3140,89,960417,4300,990946,998184,-7238
3140,89,960417,2900,992205,999193,-6988
3139,82,960385,1800,992705,999693,-6988
3140,89,960417,4400,994855,988587,6268
3140,89,960417,2400,996055,990337,5718
3140,89,960417,6650,998798,992437,6361
3141,87,961479,2850,998805,994437,4368
3141,87,961479,6900,999905,995887,4018
3141,87,961479,5650,995336,997937,-2601
3141,87,961479,1300,995993,999537,-3544
3141,87,961479,6100,998836,999687,-851
3141,87,961479,1950,999743,991374,8369
3141,87,961479,900,999936,991924,8012
3141,87,961479,50,989313,993424,-4111
3141,87,961479,500,989813,994974,-5161
3141,87,961479,2150,994763,996574,-1811
3142,81,961506,3650,992513,998062,-5549
3143,82,961563,3900,994341,999731,-5390
3144,90,961608,3750,996441,999869,-3428
3145,87,962297,2200,997541,986669,10872
3146,89,963001,3450,999263,986719,12544
3147,81,963215,1150,999913,986769,13144
3153,89,965744,500,992619,986769,5850
3153,89,965744,500,993031,987269,5762
3153,89,965744,50,992669,986819,5850
3153,89,965744,500,993169,986869,6300
3152,85,965687,50,993081,986919,6162
3153,89,965744,500,993581,989980,3601
3154,80,967919,3300,994942,991241,3701
3155,80,968052,2250,996042,992291,3751
3156,82,968168,1950,997021,994380,2641
3157,90,969071,4450,999792,997531,2261
3158,81,969161,1100,999842,998691,1151
3194,80,979261,50,993631,999781,-6150
3193,87,979195,500,994131,999941,-5810
3193,87,979195,50,993719,987969,5750
3195,83,979425,500,994219,988469,5750
3195,83,979425,500,994631,988069,6562
3195,83,979425,50,994269,988119,6150
3195,83,979425,50,994319,988619,5700
3195,83,979425,500,994819,988969,5850
3195,83,979425,500,995131,989119,6012
3195,83,979425,50,994869,989019,5850
3195,83,979425,50,994919,989819,5100
3195,83,979425,500,995419,990119,5300
3195,83,979425,50,995181,991619,3562
3195,83,979425,500,995681,992841,2840
3195,83,979425,500,995919,994041,1878
3196,82,981028,1550,996181,995769,412
3196,82,981028,2200,996419,996619,-200
3196,82,981028,4700,999933,997919,2014
3196,82,981028,4150,996919,999819,-2900
3196,82,981028,5700,999546,999133,413
3196,82,981028,650,999983,999733,250
