job_id,tasks_num_of_single_job,task_generation_time,total_time,complation_time,complation_time_ordered,shortened_completion_time
0,89,2,23800,1311,1311,0
1,85,95,22250,1414,1377,-37
2,84,895,22200,3510,2224,-1286
3,84,905,19050,3560,2266,-1294
4,80,1003,20200,3821,2816,-1005
5,90,1042,27000,3811,4390,579
6,87,1052,24600,3676,4440,764
8,87,1422,26550,4952,4004,-948
8,87,1422,24100,4901,4951,50
9,89,1809,26500,5066,4978,-88
10,83,2094,22600,5251,5346,95
11,87,2207,26400,5440,5397,-43
12,81,3378,24300,6405,5540,-865
13,86,4155,22300,6466,5763,-703
14,85,4290,25850,6649,7212,563
15,81,4731,20700,7264,7269,5
16,89,4778,26500,7719,8046,327
17,84,4952,20400,7497,6969,-528
18,84,5235,23550,7951,7769,-182
19,84,5679,23100,7763,8603,840
21,82,6377,24700,11259,9262,-1997
21,82,6377,23850,10709,9447,-1262
22,82,6489,23000,10331,10197,-134
23,90,6624,25200,10863,10827,-36
24,89,6641,26050,9953,10596,643
25,86,7386,26350,10805,10306,-499
26,86,7396,20950,10760,10767,7
27,87,7839,25050,11515,11392,-123
28,84,8229,25350,11750,12442,692
29,85,8533,24050,12925,11906,-1019
30,84,8716,23100,13201,12406,-795
32,87,9313,21700,12979,12967,-12
32,87,9313,24100,13479,12831,-648
33,89,9555,21550,13409,13077,-332
34,80,9917,21550,14915,14575,-340
35,90,10482,24750,15965,14073,-1892
36,85,10635,24050,14438,14589,151
37,90,10685,23850,14408,14855,447
38,87,11141,24600,15008,15117,109
39,89,11542,22450,15141,15052,-89
40,89,11891,23800,16962,16277,-685
41,85,11983,21800,16679,15716,-963
42,80,12521,24250,15955,16275,320
43,88,14322,26900,16414,16516,102
44,83,14371,20350,16804,16870,66
45,81,14624,22050,18304,17875,-429
46,90,14649,19350,17765,18875,1110
47,83,15500,21700,17768,19075,1307
48,87,15640,17850,18207,17420,-787
49,84,15840,23100,18514,18073,-441
50,81,15870,24750,18804,18860,56
51,87,16654,26400,20409,19360,-1049
52,87,16835,26400,20520,19535,-985
53,82,17071,23000,20235,19786,-449
54,87,17190,21450,20712,20397,-315
55,86,17629,24100,20566,21175,609
56,89,17637,27850,20558,22510,1952
57,80,17924,23350,21154,22325,1171
58,89,18197,21550,21509,22022,513
59,89,18520,26500,22659,22106,-553
60,88,18591,30050,22681,23880,1199
61,80,18608,24250,22741,24106,1365
62,80,18998,22450,23421,23125,-296
63,83,19650,19450,23512,24092,580
64,86,19862,22300,24183,24274,91
65,85,19898,26750,24341,24723,382
66,87,20090,24600,24900,24010,-890
67,87,20475,21000,25453,25483,30
68,89,20506,26500,25256,26421,1165
69,83,21040,23500,26321,26875,554
70,89,21633,24250,27871,27375,-496
71,88,21757,25100,27520,28256,736
72,80,22125,23350,25542,26024,482
73,84,22598,23100,26142,27945,1803
74,83,23188,23500,27037,27674,637
75,85,23322,18200,26864,26996,132
76,80,23735,21100,27659,27574,-85
77,84,24369,22650,28454,27925,-529
78,83,24427,22600,28159,28905,746
79,89,24669,22000,28641,29675,1034
80,87,25221,24600,28661,30073,1412
81,81,25570,19800,28714,29210,496
82,89,26325,24700,29824,30236,412
83,86,26386,24100,30104,31736,1632
84,84,26447,22650,30154,32106,1952
85,90,26579,26100,31361,30725,-636
86,80,27102,22000,32504,31623,-881
87,85,27625,23150,30725,32123,1398
88,80,27789,22000,32428,32275,-153
89,84,27902,20400,33071,32228,-843
90,88,27997,22850,32624,32806,182
91,81,28167,22500,32808,33356,548
92,82,28523,22100,32435,35389,2954
93,87,29483,22800,32517,36406,3889
94,88,29639,19700,32914,37956,5042
95,90,30358,24300,33617,38839,5222
96,84,30620,21300,33964,34339,375
97,89,30754,24250,34594,34138,-456
98,80,31034,20650,35144,34528,-616
99,81,31259,23400,34080,35273,1193
100,84,32556,21750,35276,35975,699
101,88,32723,25100,35224,35548,324
102,82,32987,21650,37156,37148,-8
103,84,33025,24900,37164,36823,-341
104,84,33477,24450,37398,37323,-75
105,80,33641,21550,36679,37862,1183
106,88,34117,23300,36344,37873,1529
107,80,35010,20200,38427,38225,-202
108,85,35014,25400,38594,39076,482
109,83,35413,22600,38861,39721,860
110,84,35506,21750,37877,40123,2246
111,88,35952,23300,38178,40898,2720
112,83,36273,19000,38927,40859,1932
113,83,36279,22600,38764,41959,3195
115,86,36963,21600,39430,43109,3679
115,86,36963,21350,39669,40227,558
116,81,37354,25200,39868,40912,1044
117,81,38019,21600,39972,41323,1351
118,82,39091,22550,40496,41727,1231
119,84,39239,23550,40583,42176,1593
120,90,40276,27900,41572,42562,990
121,83,40600,23050,41755,43062,1307
122,83,40922,25300,43062,43973,911
123,82,41016,23450,42672,44473,1801
124,81,41483,23400,43767,44727,960
125,87,41572,22800,44404,44742,338
126,84,41629,24000,44735,46309,1574
127,85,41943,25400,46212,44596,-1616
128,90,42007,25200,45404,45517,113
129,82,42357,22550,45587,46017,430
130,83,42624,22150,45803,45827,24
131,85,42978,21800,46335,45976,-359
132,81,43023,22950,45993,46666,673
133,86,43456,25900,46202,47123,921
134,86,44141,23650,46975,47576,601
135,81,44673,24300,47567,47623,56
136,90,45183,19800,48585,48028,-557
137,84,45566,24450,48412,48126,-286
138,81,45602,21150,48303,48051,-252
139,82,45954,23000,48669,48967,298
140,90,46274,27000,49219,49467,248
141,88,46541,25550,49719,49579,-140
142,83,46921,20350,50562,49626,-936
143,84,47582,27600,51285,49776,-1509
145,87,47620,20200,50919,50626,-293
145,87,47620,25450,51261,51467,206
146,82,48223,21650,51307,51970,663
147,85,48446,20900,52107,52470,363
148,89,48703,17500,52727,52467,-260
149,83,48757,24850,52712,52090,-622
150,82,49185,25250,53364,52590,-774
151,85,49325,24500,53764,53071,-693
152,83,49418,23950,54335,53267,-1068
153,84,49780,20850,53857,53497,-360
154,84,50029,18150,54159,53670,-489
155,83,51199,21250,54907,53628,-1279
156,87,51237,26400,55177,54028,-1149
157,83,52149,22150,55407,54735,-672
158,82,53195,18500,55517,54702,-815
159,86,53429,21400,56035,55083,-952
160,83,53579,23500,57835,55778,-2057
161,83,53607,24850,57185,56280,-905
162,86,53725,26350,58119,56580,-1539
163,81,53732,22500,57521,56398,-1123
164,80,53805,23350,57616,56530,-1086
165,85,56164,24050,57359,57145,-214
166,87,56594,25500,58979,57961,-1018
167,89,56803,23350,59637,58937,-700
168,88,56855,24650,59619,58921,-698
169,83,56918,22150,59353,59766,413
170,88,57006,24200,59759,60123,364
171,86,57071,23650,60044,59735,-309
172,85,57924,29000,61144,60343,-801
173,89,58240,22450,61744,61343,-401
174,84,58336,25350,62294,61263,-1031
175,87,58673,22350,62237,62636,399
176,89,59265,28300,62465,65186,2721
177,83,59497,26200,63074,61996,-1078
178,88,59673,20150,63271,62754,-517
180,88,60135,23700,64065,63354,-711
180,88,60135,24150,64116,63807,-309
181,82,60378,17150,64274,64124,-150
182,85,60456,23150,64743,64385,-358
183,83,60616,22150,65555,64896,-659
184,87,61014,21000,65605,65233,-372
185,81,61311,19350,65166,64782,-384
186,87,61319,23250,65381,65396,15
187,89,61632,22900,65766,66124,358
188,89,62816,24700,66173,66654,481
189,84,63448,24450,67100,66735,-365
190,80,63584,23350,67797,67304,-493
191,90,63776,24750,69505,67746,-1759
193,81,64062,23050,72747,67176,-5571
193,81,64062,22900,72055,68236,-3819
194,88,64119,26450,72555,68246,-4309
195,84,64248,25800,72247,68798,-3449
196,87,64695,25500,68475,68404,-71
197,84,65006,24000,68980,70810,1830
198,82,65394,23900,69480,71966,2486
199,89,65806,22000,70450,72860,2410
200,83,65816,21700,70840,73466,2626
201,86,66056,28150,73650,74510,860
202,86,66302,24550,74133,75260,1127
203,84,66523,23550,74300,75560,1260
204,82,66544,21200,74324,71804,-2520
206,81,66608,28850,74073,73013,-1060
206,81,66608,22900,74380,75922,1542
207,88,67100,25550,74123,76263,2140
208,88,67108,26450,73213,73211,-2
209,81,67364,20250,74897,73991,-906
210,87,67380,24600,74207,73815,-392
211,82,67569,22100,75907,74746,-1161
212,86,67773,22750,78147,74903,-3244
213,81,68018,24300,79747,74067,-5680
214,80,68022,26050,80207,75117,-5090
215,84,68471,24450,81807,78059,-3748
216,89,68999,21100,83534,79467,-4067
217,90,69041,25650,83957,77451,-6506
219,84,69190,24050,83247,79601,-3646
219,84,69190,23500,83797,81762,-2035
220,88,70077,23300,76963,82076,5113
221,83,70301,23500,77711,82576,4865
222,82,70579,22550,77996,80699,2703
223,89,70672,22000,77908,77699,-209
224,85,71513,24050,79577,80203,626
225,89,72749,25150,81177,81303,126
226,87,72768,25050,80177,79006,-1171
227,85,73448,24950,80105,79380,-725
228,81,73743,24300,79992,79060,-932
229,84,73794,24900,80210,80033,-177
230,85,74857,24050,81393,81136,-257
231,87,74973,20100,81221,81186,-35
232,90,75119,22950,81790,81200,-590
233,87,75562,25500,82493,81310,-1183
234,81,76210,22950,83341,81750,-1591
235,81,76545,25650,83510,82222,-1288
237,80,76584,25100,83990,83872,-118
237,80,76584,18800,83541,84656,1115
238,84,76761,26250,85020,83250,-1770
239,87,77020,28200,87720,84961,-2759
240,80,77032,17950,88320,84967,-3353
241,88,77052,31400,87905,86011,-1894
242,81,77914,21150,85039,85918,879
243,80,78240,22000,86472,86662,190
244,90,78362,23850,86711,86979,268
245,82,78466,22100,86779,88310,1531
246,87,79700,21900,87324,88662,1338
247,88,79900,26000,88117,86835,-1282
248,86,80081,24550,89177,88351,-826
249,87,80244,22800,89837,85922,-3915
251,90,80317,27900,89988,86981,-3007
251,90,80317,24250,90062,87726,-2336
252,89,80426,24250,90562,89276,-1286
253,86,80552,27250,91103,89054,-2049
254,82,80593,21200,91038,88489,-2549
255,85,80701,23600,91853,89265,-2588
256,88,81085,26000,90607,89532,-1075
257,90,81536,22950,89529,90925,1396
258,90,82274,23400,91573,92458,885
260,83,82419,27300,91910,91534,-376
260,83,82419,19400,92410,91758,-652
261,83,82618,23500,92843,92985,142
262,82,83669,23000,93008,93985,977
263,88,84067,25100,94308,95085,777
264,80,84163,20200,94570,92679,-1891
265,80,84281,24250,93890,92920,-970
266,86,84380,26800,94656,92264,-2392
267,85,84661,23150,95390,92714,-2676
268,82,85346,21200,95906,93500,-2406
269,88,85507,25550,96390,93762,-2628
270,82,87159,23000,95127,94376,-751
271,89,87886,25600,94624,93416,-1208
272,82,87904,21650,94915,94872,-43
273,84,88553,23550,96515,95422,-1093
274,87,88579,25050,96674,97522,848
275,85,88972,22250,96539,98266,1727
276,88,89052,24650,97090,98272,1182
277,86,89182,23650,97383,96466,-917
278,83,89633,22150,98433,96966,-1467
279,80,90169,23350,100033,97966,-2067
280,86,90329,20050,96870,98212,1342
281,90,91284,25200,98611,98195,-416
282,82,91637,21650,99711,99161,-550
283,86,91915,22750,101870,98983,-2887
284,86,92186,24100,102661,100510,-2151
285,83,92314,22150,102140,102560,420
287,88,92703,23900,100090,103026,2936
287,88,92703,23250,99859,100153,294
288,90,93032,24750,100907,100536,-371
290,88,93152,22250,101155,101292,137
290,88,93152,22800,101655,99229,-2426
291,82,93193,20750,101407,99729,-1678
292,90,94423,21600,101339,100362,-977
293,89,95563,27400,102315,100064,-2251
294,89,96520,23800,102729,100716,-2013
295,90,96900,24300,103712,101620,-2092
296,88,97939,28700,103926,101916,-2010
297,80,98390,20650,104276,103724,-552
299,82,98958,22950,104533,104388,-145
299,82,98958,21150,104750,104424,-326
300,80,99055,22000,104648,103802,-846
301,85,99250,22700,103471,103566,95
302,80,99543,20650,103965,104570,605
303,86,99974,24550,104424,104616,192
304,87,101012,21000,105021,105312,291
305,89,101194,24250,105381,104515,-866
306,82,101726,23900,105526,105565,39
307,80,102494,22450,106305,106038,-267
308,85,103063,23600,106073,106566,493
309,83,103829,22600,106347,106452,105
310,81,104641,21150,107231,106862,-369
311,90,104762,21600,107228,107066,-162
313,87,105417,22850,108539,108316,-223
313,87,105417,25900,109214,109466,252
314,90,105541,24300,109105,109717,612
315,83,105585,26200,108785,110053,1268
316,81,105606,23850,108900,109552,652
317,88,105733,24200,108831,109512,681
318,81,105993,21600,109431,109588,157
319,83,106090,22600,109917,110052,135
320,85,106568,24950,110417,110733,316
321,85,107201,24050,111168,111369,201
322,89,107669,22450,111408,111802,394
323,89,107758,25600,111958,111312,-646
324,81,108330,22950,112748,111812,-936
325,88,108552,24650,112264,112462,198
326,84,108782,21750,112223,112121,-102
327,84,108975,23550,112968,113195,227
328,82,109154,21650,113243,112802,-441
329,85,109612,23600,115058,113469,-1589
330,84,109808,24000,115899,113852,-2047
331,84,110091,23550,116167,114371,-1796
332,88,110117,23750,116667,114662,-2005
333,86,110690,22300,114998,115785,787
334,81,111056,21600,116548,116121,-427
335,83,111259,23050,116681,116949,268
336,87,111447,25050,116643,118045,1402
337,89,111627,25150,116743,117620,877
338,90,111785,23400,116364,117565,1201
339,89,112224,24700,116630,116016,-614
340,89,112578,28750,117145,117472,327
341,86,113128,27250,117768,117972,204
342,84,113546,27150,117572,119075,1503
343,89,113877,26950,119129,119835,706
344,88,114304,24650,119406,120125,719
345,81,114395,18450,119514,119515,1
346,83,114656,21250,118956,120715,1759
347,85,115402,24500,120318,120765,447
348,80,116066,22900,121548,120044,-1504
349,82,116438,21650,122468,120324,-2144
351,82,116525,23950,122968,120521,-2447
351,82,116525,20700,121968,121404,-564
352,82,117040,18050,120894,121691,797
353,87,117077,20550,120589,121771,1182
354,83,117083,21250,120961,121437,476
355,80,118545,20200,121433,122865,1432
356,86,118734,24100,121757,123615,1858
357,89,119170,23350,122984,124237,1253
358,87,120140,21900,123161,124523,1362
359,83,120143,23050,123968,122924,-1044
360,90,120527,25200,125216,123479,-1737
361,81,121433,24300,125750,124304,-1446
362,86,121512,20050,126618,124971,-1647
363,89,121733,22900,125250,125179,-71
364,83,121746,24400,126300,125168,-1132
365,87,121904,23250,125473,126179,706
366,81,122146,24300,125426,126679,1253
367,87,122412,23700,125846,127168,1322
368,85,123098,22700,126427,125806,-621
369,81,123300,20250,126966,126044,-922
370,89,124518,23800,129352,127221,-2131
371,89,124718,23800,129768,127679,-2089
372,82,125196,23450,129403,127726,-1677
373,80,125698,23350,127966,128179,213
374,81,126995,22050,128800,128385,-415
375,87,126995,25050,129107,128697,-410
376,86,127121,27250,129618,128769,-849
377,85,127992,24050,130352,129251,-1101
378,86,128210,26800,130842,129853,-989
379,90,128230,18900,130861,129977,-884
380,84,128483,23550,132542,130381,-2161
381,86,128653,28150,132518,131217,-1301
382,88,128705,21950,132456,131503,-953
383,87,129306,21900,132736,131883,-853
385,87,129544,24400,132679,132191,-488
385,87,129544,23650,132768,132560,-208
386,81,129883,20250,133504,133377,-127
388,81,130350,21150,135468,133128,-2340
388,81,130350,22000,135579,133778,-1801
389,89,130619,22900,136465,134743,-1722
390,86,130736,25450,137565,135633,-1932
391,88,130959,21500,137754,136160,-1594
393,81,130997,21700,137163,136479,-684
393,81,130997,24700,137986,136833,-1153
394,82,131524,22100,139192,137672,-1520
395,82,131562,23900,138692,139003,311
396,89,131602,23800,138863,140322,1459
398,88,131790,24450,139153,140853,1700
398,88,131790,24150,140287,138910,-1377
399,90,131908,23850,140700,138896,-1804
400,80,132076,22900,143887,141062,-2825
401,90,132198,27900,143553,143662,109
402,88,132246,26450,142887,145362,2475
403,90,132346,29700,145403,146296,893
405,83,132366,25250,145383,143089,-2294
405,83,132366,20750,144820,145168,348
406,86,132519,23200,145420,141445,-3975
407,80,132625,21100,143065,142197,-868
408,87,132635,22350,145370,142644,-2726
409,85,133723,24500,144470,142962,-1508
410,87,133767,21450,144654,143244,-1410
411,81,133962,20250,145840,143558,-2282
412,89,134117,24250,146070,143744,-2326
413,87,134128,25500,146579,144410,-2169
414,80,134186,22900,146840,145495,-1345
416,88,134678,24050,148229,146095,-2134
416,88,134678,22350,147729,146695,-1034
417,81,134884,23850,148220,147195,-1025
418,90,135411,27450,150142,147745,-2397
419,88,135642,23300,150216,147910,-2306
420,82,136096,27500,153442,147968,-5474
421,83,136166,22600,153166,148411,-4755
423,85,136630,17100,155192,148598,-6594
423,85,136630,20850,155142,149397,-5745
424,86,136735,25900,155366,149997,-5369
425,88,136854,24650,155692,150168,-5524
426,88,136901,18800,154866,150781,-4085
428,89,137044,24950,154333,151606,-2727
428,89,137044,17900,155883,152631,-3252
429,88,137150,25100,158533,153856,-4677
430,88,137241,23750,158798,154731,-4067
431,85,137289,24950,158583,150853,-7730
432,83,137397,23050,159133,152224,-6909
433,83,137829,21700,160383,153553,-6830
434,86,138195,24550,160548,155174,-5374
435,86,138196,29500,161148,156224,-4924
436,84,138279,20850,160648,156453,-4195
438,85,138683,23350,152070,154265,2195
438,85,138683,23100,151931,156546,4615
439,82,138891,24800,153315,158146,4831
440,83,139013,25300,153433,159515,6082
441,80,139521,22000,154983,160665,5682
442,84,139590,20850,154802,161446,6644
443,82,139780,22100,155117,161815,6698
444,88,140059,26900,156690,164346,7656
445,90,140080,25200,156479,167046,10567
446,84,140369,22650,157267,167815,10548
447,86,140512,23650,157817,168296,10479
448,89,140554,25150,158154,161241,3087
449,84,140671,23550,159055,162791,3736
450,83,140911,22600,159155,163267,4112
451,84,141389,25350,160067,156685,-3382
452,82,141691,24350,160754,157558,-3196
453,84,141978,20850,160879,158074,-2805
454,80,142115,22450,161090,159158,-1932
455,86,142186,24550,156912,160024,3112
456,87,142546,24150,157521,161508,3987
457,88,142848,24650,158519,159730,1211
458,88,143181,23750,158781,160812,2031
459,82,143961,20750,159819,161531,1712
460,89,144572,22450,161169,162012,843
461,80,145019,22900,161590,162935,1345
462,90,145352,25200,162420,163485,1065
463,83,145517,22150,162740,163985,1245
465,81,146115,21200,163920,160112,-3808
465,81,146115,24700,164270,160696,-3574
467,82,146237,24150,163890,161545,-2345
467,82,146237,25200,164865,161852,-3013
468,85,146298,24500,164418,162595,-1823
469,88,146541,28700,164365,163326,-1039
470,82,147059,23900,162112,163826,1714
471,83,147131,25750,162580,164481,1901
472,86,147606,21850,162712,165759,3047
473,90,147843,24300,163817,168051,4234
474,87,148557,24600,166033,169829,3796
475,83,148781,22600,168333,171479,3146
476,88,148950,21950,170383,173001,2618
477,90,148978,25200,170367,170597,230
478,90,149102,24300,170933,170968,35
479,86,149527,23200,172117,170581,-1536
480,80,149659,22000,173167,169314,-3853
481,81,150028,22050,174833,170065,-4768
482,83,150118,21250,174767,170649,-4118
483,88,150230,26000,174817,172474,-2343
484,82,150634,20300,168870,174310,5440
485,90,151623,24750,170090,176224,6134
486,83,151714,21250,170219,177274,7055
487,90,151944,24300,170769,178424,7655
488,90,152267,19800,171756,180260,8504
489,86,152275,24100,171620,180860,9240
490,87,152431,24600,171990,182274,10284
491,90,153900,27900,172519,182960,10441
492,88,153984,22400,173879,169905,-3974
493,87,154059,24150,173970,170405,-3565
494,83,154204,26200,174970,171344,-3626
495,89,154256,27400,174529,172463,-2066
496,85,154678,20450,179340,172844,-6496
497,86,154810,24100,181255,173344,-7911
498,90,154848,27450,180890,173513,-7377
499,85,154928,25400,180840,174113,-6727
500,82,155080,20300,178140,174613,-3527
501,90,155262,29250,178740,175044,-3696
502,87,155343,22350,179069,175580,-3489
503,81,155688,22500,179529,176644,-2885
504,88,155806,24200,179970,177029,-2941
505,85,156005,23150,180129,177588,-2541
506,87,156131,20100,180248,178179,-2069
507,80,156336,23350,181798,178705,-3093
508,83,156698,23500,176498,179205,2707
510,88,157228,24100,178482,176294,-2188
510,88,157228,25500,178393,178394,1
511,85,157353,20000,178048,178617,569
512,87,157799,23700,178898,174018,-4880
513,82,158003,20300,179082,174518,-4564
514,86,158377,25000,179191,175882,-3309
515,86,158814,24550,181465,177482,-3983
516,85,158989,22700,182321,179782,-2539
517,86,159377,23200,183515,181201,-2314
518,86,159918,20050,184621,182851,-1770
519,85,159990,22250,185121,185282,161
520,83,160198,19900,186265,187551,1286
521,83,160563,21700,187005,188651,1646
523,87,161119,23950,188005,190651,2646
524,84,161131,25950,187789,191701,3912
524,84,161131,24400,187739,193782,6043
525,88,161310,26450,181331,195382,14051
526,80,161750,21100,181819,196582,14763
527,86,162234,24550,182723,197551,14828
528,85,162258,22250,182748,199082,16334
529,80,162374,21100,183231,200301,17070
530,82,162783,24350,184419,201301,16882
531,86,162957,23200,185323,202351,17028
532,86,163965,21850,185448,203651,18203
533,87,164441,25050,186548,204632,18084
534,90,164777,27000,187931,184214,-3717
535,85,165005,21800,188431,183802,-4629
536,86,165388,24100,188981,184748,-4233
537,90,165800,26100,189123,185895,-3228
538,81,166382,23400,189431,186352,-3079
539,85,167049,18200,188127,186902,-1225
540,90,167359,28800,188778,187445,-1333
541,89,167419,25150,188659,187912,-747
542,81,167505,22950,188762,188052,-710
543,90,167820,27450,188271,188912,641
544,80,168073,21100,188771,189498,727
545,83,168536,21700,189408,189962,554
546,89,168707,22900,189908,189978,70
547,84,169070,23550,191388,188231,-3157
548,89,169254,23350,192083,188963,-3120
549,86,169949,22750,196288,189005,-7283
550,83,170085,24850,196638,189331,-7307
551,89,170171,21100,197298,189694,-7604
552,89,170237,25150,196798,190294,-6504
553,89,170802,22000,198938,191617,-7321
554,85,170868,21350,198498,191605,-6893
555,85,171673,24500,200798,192131,-8667
556,82,172020,26150,202038,192544,-9494
558,85,172403,24250,203577,192460,-11117
558,85,172403,21750,204022,193376,-10646
559,86,174107,22300,204439,195026,-9413
561,85,174438,23100,204769,198560,-6209
561,85,174438,22650,204998,199476,-5522
562,80,174633,23800,205138,200976,-4162
563,88,174715,23750,196052,202076,6024
564,90,175132,24300,197043,203760,6717
565,84,177071,22650,199415,204810,5395
566,86,177145,24550,200465,205876,5411
567,86,177280,25450,200774,207860,7086
568,83,177725,24850,201974,200046,-1928
569,83,178502,21700,204715,201096,-3619
570,82,178684,23450,205731,203296,-2435
571,87,178895,27300,206273,204219,-2054
572,83,179013,23500,206990,205490,-1500
574,90,179280,21900,209570,205815,-3755
574,90,179280,28300,209023,206481,-2542
575,90,179394,27000,209640,206981,-2659
576,89,179531,26500,209981,207481,-2500
577,85,179855,27650,208865,208081,-784
578,90,180638,25200,210223,208244,-1979
579,81,180799,24300,210640,208169,-2471
580,88,181366,21500,211424,209046,-2378
581,80,181527,22000,211515,210969,-546
582,89,181867,23350,213024,212796,-228
584,82,182383,27000,204825,203183,-1642
584,82,182383,24300,205405,204233,-1172
585,80,182616,25150,206555,205653,-902
586,89,182871,23800,208495,207083,-1412
587,81,182925,19350,208995,208553,-442
588,86,183213,25450,209630,209983,353
589,82,183322,22550,209495,212203,2708
591,86,183577,23600,209741,213183,3442
591,86,183577,22250,209957,212853,2896
592,82,183837,19400,210241,203500,-6741
593,80,184019,19300,209682,204352,-5330
594,84,184086,24450,210155,204050,-6105
595,82,184281,22100,200702,203837,3135
596,83,184506,20350,203085,204166,1081
597,86,184615,26800,205135,205131,-4
598,85,184803,22250,207235,206045,-1190
599,87,184866,22350,209335,206887,-2448
600,80,185018,20200,210935,207016,-3919
602,82,185102,22350,211669,207482,-4187
602,82,185102,25650,211485,208032,-3453
603,81,185256,21600,212185,208295,-3890
604,86,185612,23650,214969,208895,-6074
605,83,185685,26200,215519,209337,-6182
606,80,185904,23800,218069,210166,-7903
607,84,185972,20400,218198,210532,-7666
608,87,186128,21450,218585,210887,-7698
609,90,186600,23400,218719,211316,-7403
610,80,186952,23350,220969,212081,-8888
611,89,187292,22900,221485,212366,-9119
612,82,187517,20750,209939,212832,2893
613,89,187656,20200,209911,213195,3284
615,81,188098,21650,210489,213832,3343
615,81,188098,22900,210411,214566,4155
616,84,188454,21750,210595,215566,4971
617,82,189124,25250,211433,216032,4599
618,83,189378,21700,211645,216187,4542
619,84,189994,22650,212145,216445,4300
620,87,190232,21900,212904,213785,881
621,85,190386,25400,213275,214811,1536
622,85,190879,18650,218894,214968,-3926
623,84,190941,27150,221175,215845,-5330
625,89,190960,19350,220175,216150,-4025
625,89,190960,27800,221225,217345,-3880
626,83,191010,26200,222594,218752,-3842
627,87,191116,23700,223575,219252,-4323
628,83,191180,20350,224194,219562,-4632
629,84,191437,21300,224944,219895,-5049
630,88,191982,22400,224675,220395,-4280
631,85,192396,22700,218233,217762,-471
632,85,192552,21350,218783,218737,-46
633,89,193234,24250,219820,219487,-333
634,88,193318,22850,220073,221162,1089
635,84,193761,19050,221073,222637,1564
636,83,193906,24850,221370,223704,2334
639,86,195850,24350,222923,225232,2309
639,86,195850,23850,223140,226504,3364
639,86,195850,18600,223160,227482,4322
640,82,196428,25250,223982,228651,4669
641,90,197064,27450,224733,229404,4671
642,87,197395,23700,225291,230382,5091
643,88,197776,22400,225733,221944,-3789
644,81,198434,23400,225920,222544,-3376
645,81,199583,27000,227020,223044,-3976
646,85,199790,22250,228178,223644,-4534
648,85,199955,24100,229120,223857,-5263
648,85,199955,21300,228790,221578,-7212
649,84,200091,23100,229483,222678,-6805
650,84,200241,21750,229473,223310,-6163
651,90,200316,22500,229170,224717,-4453
652,88,200578,24200,227374,225728,-1646
653,89,200606,27850,229424,221072,-8352
654,90,200729,22950,230716,222096,-8620
655,82,200974,22100,231525,223796,-7729
657,81,201131,26650,231580,224622,-6958
657,81,201131,22450,231862,226946,-4916
658,87,201971,22350,232362,227822,-4540
659,87,203450,25050,232809,229372,-3437
660,83,203877,24400,233859,230372,-3487
661,83,203997,24400,233366,231972,-1394
662,82,204018,19850,233675,233372,-303
663,90,204590,24300,234074,235522,1448
664,80,205847,17500,232567,236244,3677
665,81,205917,24750,233067,236515,3448
666,86,206270,20950,233117,236992,3875
667,80,206725,21100,235474,236796,1322
668,86,206861,20500,237674,238122,448
669,86,206957,20050,237724,238496,772
670,89,207136,24250,238224,233033,-5191
671,84,207175,21750,237967,229437,-8530
672,81,207566,24300,229835,230016,181
673,81,207705,19350,231033,230645,-388
674,83,207875,22150,231819,228632,-3187
676,81,207919,25650,232085,229454,-2631
676,81,207919,18400,232183,229662,-2521
678,82,208098,22950,233450,230495,-2955
678,82,208098,22950,233196,231200,-1996
679,82,208627,22100,234846,231700,-3146
680,80,209145,23350,235858,232200,-3658
681,86,209307,26800,237196,232812,-4384
682,88,209761,27800,239746,233912,-5834
683,88,209910,22850,239458,234145,-5313
684,90,210080,28800,234124,235032,908
685,82,210228,23900,230159,235412,5253
686,81,210620,21600,231135,235282,4147
687,87,210642,25950,231185,236412,5227
688,89,210795,24250,232671,238004,5333
689,80,210950,23350,233485,238468,4983
690,83,211355,23500,234271,239518,5247
691,82,212420,20300,235321,241118,5797
692,81,212852,20250,236552,242204,5652
693,80,213204,19300,238102,244354,6252
694,88,213402,23300,241135,245554,4419
695,83,213436,21250,241371,246918,5547
696,80,213609,21100,241471,247304,5833
697,85,214502,22250,242235,248854,6619
698,89,214924,26500,243738,250504,6766
701,86,215828,25400,246488,251818,5330
700,82,215719,23900,246988,253468,6480
701,86,215828,20900,247488,254904,7416
702,83,216122,26200,247993,255904,7911
703,85,216235,21350,248529,257468,8939
704,88,216814,27800,249574,258968,9394
705,85,217149,24500,250152,260468,10316
706,86,217862,22300,250738,261618,10880
707,82,218012,20750,251652,263168,11516
708,82,218047,23450,251838,264304,12466
709,84,219253,22200,252988,265968,12980
710,83,220351,21700,254888,268268,13380
711,84,220405,23100,255352,269368,14016
712,88,220694,21500,255538,270468,14930
713,82,220964,25250,244772,252378,7606
714,86,221458,22300,245223,253963,8740
715,87,221672,28200,246033,253982,7949
716,84,221925,21750,247694,248108,414
717,87,221974,23250,248761,249383,622
718,86,222007,23650,248797,250358,1561
719,87,222104,22800,249306,250958,1652
720,90,222690,26100,249806,251958,2152
721,84,223522,28050,251561,253533,1972
722,85,223720,23150,253061,255108,2047
723,83,223775,23950,252728,256133,3405
724,88,223980,24200,253228,257458,4230
726,90,224339,24250,251159,259958,8799
726,90,224339,24700,251581,262558,10977
727,89,224421,26500,251880,264133,12253
728,86,224485,20950,251659,264858,13199
729,87,224818,23700,251475,266233,14758
730,85,225081,22250,249072,266708,17636
731,84,225199,23100,249183,248315,-868
732,89,225581,26950,250935,249033,-1902
733,81,225687,21600,251083,249533,-1550
734,86,225739,22750,251112,250161,-951
735,85,226125,25850,252390,250661,-1729
736,81,226255,19350,252212,250942,-1270
737,85,226609,19100,252583,251665,-918
738,81,226840,22950,249265,252233,2968
739,84,227235,22650,251970,252715,745
740,83,227288,21700,252470,252333,-137
741,82,227847,20300,252890,251954,-936
742,87,228048,26400,253633,252435,-1198
743,83,228279,23950,254183,253366,-817
745,87,229251,23100,255820,254084,-1736
745,87,229251,19600,255774,254784,-990
746,89,229272,23800,256824,255095,-1729
747,90,229505,23400,253674,255885,2211
748,85,229783,20450,254724,256016,1292
749,82,229832,20300,255724,256487,763
750,89,230529,21100,256874,256985,111
751,90,230654,21600,257235,257434,199
753,86,231414,25450,259985,254668,-5317
753,86,231414,24950,260585,255715,-4870
754,80,231522,20200,261085,256539,-4546
755,84,231985,24900,262974,257625,-5349
756,82,232230,21650,265035,258375,-6660
757,86,232270,22750,264924,259339,-5585
758,88,233066,28250,269174,256231,-12943
760,89,233260,22600,270374,257097,-13277
760,89,233260,25100,270874,257593,-13281
761,85,233561,23150,273124,257213,-15911
762,90,233603,21600,273685,258813,-14872
763,85,233664,25850,273624,260130,-13494
764,86,234025,20500,259973,262213,2240
765,88,235106,21050,260574,263363,2789
766,86,235971,24100,262074,264513,2439
767,89,236098,27850,262502,266880,4378
768,87,236137,23700,262674,267880,5206
769,84,237170,24000,263293,268580,5287
770,90,237473,22950,265279,269363,4084
771,89,237593,25150,265602,270980,5378
772,89,237964,27400,265879,272680,6801
773,90,238165,22950,266852,274663,7811
774,84,238368,24450,266973,276930,9957
775,88,238755,24650,268452,278080,9628
776,88,238819,24650,268074,279713,11639
777,89,239039,23800,269114,280830,11716
778,86,239172,27250,269578,281980,12402
780,81,240000,23000,271414,283230,11816
780,81,240000,19750,271428,284763,13335
781,80,240314,19300,273214,285430,12216
782,90,240514,22050,273914,286930,13016
783,90,240934,26100,276578,287363,10785
784,86,241299,24550,279228,289463,10235
785,88,241548,24650,280564,290680,10116
786,88,242335,26000,283114,291680,8566
788,89,242602,21300,286428,292730,6302
788,89,242602,25100,286264,294330,8066
789,81,242701,23850,286364,296413,10049
790,87,243506,21450,290128,297380,7252
791,89,243670,23800,290764,297880,7116
792,87,243918,23250,290814,268895,-21919
793,87,244474,25050,274888,269395,-5493
794,89,245254,24250,278505,270219,-8286
795,89,245332,25150,279038,271249,-7789
796,86,245428,26350,279505,272281,-7224
797,84,245979,25800,282655,272988,-9667
798,80,246186,22000,284405,273538,-10867
799,87,246213,25950,284388,274399,-9989
800,86,246459,20500,286638,274899,-11739
801,80,246609,21550,287205,275399,-11806
802,85,246944,24050,287805,276188,-11617
803,81,247609,22050,277118,276295,-823
804,80,247722,22000,277077,276795,-282
805,88,247972,20600,276118,277681,1563
806,81,249331,21600,273723,277795,4072
807,87,249837,26850,275266,278199,2933
808,88,249954,22850,275283,278675,3392
809,84,250610,22200,275274,279825,4551
810,85,250637,25400,275727,281948,6221
811,80,250896,21100,275923,284425,8502
812,89,251027,29650,273585,285648,12063
813,86,251613,25000,274135,286625,12490
814,80,251706,19750,274219,288175,13956
816,89,252417,23150,275004,289225,14221
816,89,252417,20600,275135,291548,16413
817,80,252984,22450,275823,291975,16152
818,87,253320,21000,276385,277720,1335
819,90,253521,23400,276885,278484,1599
820,80,253763,22000,277935,279237,1302
821,84,254345,25350,279569,279918,349
822,83,254353,28000,279185,281270,2085
823,90,254413,24300,279923,282458,2535
824,83,254504,21700,280185,283920,3735
825,89,254932,25150,281454,285986,4532
826,88,255048,25550,281335,287966,6631
827,86,255502,24550,281573,289886,8313
828,81,255639,25650,280418,291886,11468
829,81,255785,17100,280918,292168,11250
830,88,255844,25100,281024,292737,11713
831,81,256652,22950,281877,293444,11567
832,86,257000,25450,283640,293944,10304
834,86,257043,26550,284235,294218,9983
834,86,257043,24500,284290,294689,10399
835,87,257100,23250,284718,295239,10521
836,86,257288,24550,285290,295487,10197
837,85,257358,25400,285385,295987,10602
838,88,257793,24650,286768,296289,9521
839,89,258163,25600,287435,293916,6481
840,87,258524,25500,287935,295686,7751
841,86,259066,20500,288585,296666,8081
842,81,259183,20700,289827,297336,7509
843,82,259256,23900,290985,298836,7851
844,84,259304,22200,292377,300366,7989
845,86,259536,21850,293735,301386,7651
846,83,259695,22600,294235,302116,7881
847,87,260215,19200,296485,303816,7331
848,84,260289,23100,296985,304536,7551
849,90,260859,23850,299085,303357,4272
850,80,261186,21550,300635,305218,4583
851,82,261554,23900,302677,307057,4380
852,85,262057,28100,305827,308207,2380
853,84,262354,22200,307235,309407,2172
854,83,262409,21250,308077,302410,-5667
855,83,262723,21250,310385,303560,-6825
856,87,262730,18750,310585,305335,-5250
857,82,262973,18950,311635,305835,-5800
858,84,263903,23100,314689,307510,-7179
859,84,264029,24000,315173,308985,-6188
860,86,264096,25000,314985,311260,-3725
861,82,264335,23000,315221,313585,-1636
862,84,264579,21300,315377,315210,-167
863,84,264626,21300,315289,316860,1571
864,84,264978,18150,290781,317960,27179
866,80,266047,26550,292473,319610,27137
866,80,266047,18350,292452,320110,27658
867,87,266241,26400,293473,322985,29512
868,81,266271,24750,293881,324535,30654
869,85,266410,21800,293973,293988,15
870,88,266996,22400,294345,294351,6
872,87,267851,25600,295995,294681,-1314
872,87,267851,21400,296324,295281,-1043
873,89,268026,26050,297277,295901,-1376
874,82,268144,23450,297927,296319,-1608
875,80,268346,17050,299073,294154,-4919
876,86,268585,23200,300477,294696,-5781
877,88,269498,23750,301127,295635,-5492
878,81,270331,22950,299923,296135,-3788
879,88,270548,24650,300174,296896,-3278
880,87,270753,25500,301431,297896,-3535
881,85,270804,23600,301774,298715,-3059
882,82,271069,23900,302723,299215,-3508
883,86,271150,23650,302845,299835,-3010
884,89,271695,22900,303574,300046,-3528
885,84,272122,25350,304074,300944,-3130
886,89,272419,26050,305223,301335,-3888
887,85,272506,21800,305445,301646,-3799
888,83,272904,22150,306852,302146,-4706
889,82,273072,25250,307674,302711,-4963
890,85,273154,25850,307902,299801,-8101
891,84,273505,24000,308224,299919,-8305
892,90,274507,27450,308724,300638,-8086
893,90,274517,22500,308581,301069,-7512
894,86,274538,22300,299859,303039,3180
895,88,274772,26000,300409,304771,4362
896,85,275669,23600,301203,305821,4618
897,84,275958,22200,307031,307471,440
898,82,276076,18050,308464,308589,125
899,82,276124,22100,309181,309921,740
900,80,276155,21100,310181,311489,1308
901,86,276210,24100,311514,313221,1707
902,85,276508,23150,313381,314771,1390
903,90,276753,25200,315564,316289,725
904,82,277523,18500,318131,316671,-1460
905,90,277678,25200,318964,318321,-643
906,81,277721,22950,319464,319039,-425
907,85,278067,20000,322731,320671,-2060
908,88,278271,22400,323464,321321,-2143
909,85,278308,25850,324064,322321,-1743
911,88,279504,19100,326814,323589,-3225
911,88,279504,24150,327914,324071,-3843
912,86,279930,23650,330214,309544,-20670
913,82,279999,23450,330731,309965,-20766
914,82,280300,24800,333414,310584,-22830
915,85,280531,24500,333689,311184,-22505
916,85,280669,24950,334189,311734,-22455
917,89,281458,16600,335064,311954,-23110
920,81,281552,24450,334514,312514,-22000
919,89,281544,22900,335481,313301,-22180
921,82,281577,21150,334886,313664,-21222
921,82,281577,18450,335164,313884,-21280
922,81,281773,25650,315290,314854,-436
923,88,281817,22400,315432,315404,-28
924,88,281913,21500,316068,315864,-204
925,80,281987,23350,316290,316504,214
926,87,283223,24150,316887,317550,663
927,85,283673,23150,317568,318201,633
929,90,283996,24950,319040,318614,-426
929,90,283996,24250,318987,315059,-3928
930,80,284402,19750,319537,315261,-4276
931,82,285177,29750,320127,316167,-3960
932,85,285642,23150,321074,316639,-4435
933,85,286618,23600,321627,317209,-4418
934,80,286971,19300,322627,317267,-5360
936,88,287274,21000,322874,315087,-7787
936,88,287274,18750,323127,315737,-7390
937,84,287561,22650,323340,316086,-7254
938,80,287676,18850,323568,316768,-6800
939,83,287889,26200,314154,317636,3482
940,81,288184,20700,315395,318047,2652
942,87,288434,27800,318366,318736,370
942,87,288434,21850,318316,319197,881
943,88,288452,22850,318698,319968,1270
944,82,288993,22550,320916,320468,-448
945,83,289382,23500,323316,321018,-2298
946,80,289531,24700,324848,321518,-3330
947,89,289686,21100,326166,322018,-4148
948,85,289762,24050,325616,322518,-3098
950,81,290026,25050,329766,322786,-6980
950,81,290026,19750,329848,323287,-6561
951,86,290085,24550,330266,323897,-6369
952,83,290414,22600,333060,324737,-8323
953,89,290494,26050,332643,325397,-7246
954,86,290520,25900,332666,326666,-6000
955,80,290918,20200,332268,326937,-5331
956,84,290933,21300,332782,328221,-4561
957,90,290970,25200,332368,329221,-3147
958,82,291220,23000,328277,331215,2938
959,83,291529,22600,328976,331715,2739
960,86,291911,24100,330876,332215,1339
961,89,292310,24700,333976,332320,-1656
962,81,292410,23850,334727,333039,-1688
963,80,292873,25150,336827,333539,-3288
964,80,293148,20650,338676,334441,-4235
965,90,293625,22950,340326,335572,-4754
966,86,293782,28600,340376,336072,-4304
967,85,293804,25400,340727,336565,-4162
968,87,294056,23250,330995,337317,6322
969,88,294373,26900,331624,338409,6785
970,84,294551,22200,333095,338867,5772
971,86,294762,21850,333704,335986,2282
972,80,294772,26500,334231,337086,2855
973,88,294947,21950,334754,337796,3042
974,84,294962,26250,334374,339207,4833
976,83,295451,22450,335881,339757,3876
976,83,295451,19850,336095,341821,5726
977,86,295480,26350,335825,342321,6496
979,86,295662,24800,336325,343707,7382
979,86,295662,24500,336404,344521,8117
980,90,296184,27450,333723,346121,12398
981,82,296364,22550,333937,347671,13734
983,80,296966,24300,334373,348807,14434
983,80,296966,19700,334437,349571,15134
984,82,297792,22550,334506,341710,7204
985,83,298371,24400,335006,343260,8254
988,85,298978,24050,337056,345173,8117
988,85,298978,22850,336689,346060,9371
988,85,298978,27100,337073,348923,11850
989,90,299564,25200,337987,350323,12336
990,87,299929,22350,339156,351623,12467
991,82,299934,21650,339339,353223,13884
992,88,300057,25550,339771,353410,13639
993,89,300276,24700,340321,338337,-1984
994,82,300301,18950,340223,338968,-1255
995,80,300331,22900,339889,339037,-852
996,88,301340,26000,339350,336100,-3250
997,87,301800,20550,341186,336364,-4822
998,83,301961,23950,341736,336864,-4872
999,84,302636,23550,343736,337650,-6086
1000,89,303347,22450,346436,337914,-8522
1001,85,303394,22700,346700,338504,-8196
1002,88,303940,26450,350786,338713,-12073
1003,89,304035,22000,350836,339671,-11165
1004,80,304043,22900,351386,340871,-10515
1005,81,304531,23400,353600,342471,-11129
1006,85,305016,20900,355700,343121,-12579
1007,81,305035,22500,355886,343792,-12094
1008,84,305319,21750,359236,344792,-14444
1009,90,305337,24300,358900,345671,-13229
1010,81,305517,23400,358850,346292,-12558
1011,85,305961,23600,341388,347942,6554
1012,90,306007,27000,341277,349471,8194
1013,90,306731,24750,342510,351242,8732
1014,87,307554,20550,346603,351921,5318
1015,85,307689,22250,347653,352971,5318
1016,85,307696,25400,348153,353671,5518
1017,81,308757,21150,350938,354171,3233
1019,84,308844,22400,350964,354505,3541
1019,84,308844,23050,351291,354974,3683
1020,81,309765,24300,351501,355474,3973
1021,88,310041,25550,352001,354692,2691
1022,88,311292,21050,352088,355807,3719
1023,90,311444,22500,351160,356271,5111
1024,86,311966,20500,352382,356392,4010
1025,89,312193,24250,354420,342594,-11826
1026,88,313005,24650,356170,344239,-11931
1027,88,313279,26900,360870,345139,-15731
1028,86,313338,21850,361482,346016,-15466
1029,89,313347,19750,361532,346349,-15183
1030,81,313549,20250,362182,348433,-13749
1031,83,313555,20800,362070,349133,-12937
1032,84,314268,21750,363932,350333,-13599
1033,86,315140,22300,366420,351883,-14537
1034,86,315254,24100,367520,352766,-14754
1036,82,316291,20700,368720,354183,-14537
1036,82,316291,22050,369982,355683,-14299
1037,82,316512,22100,371420,357166,-14254
1038,80,316594,19300,372420,357716,-14704
1039,84,316975,25800,374520,358716,-15804
1040,80,317399,19300,375570,359366,-16204
1041,80,318790,26500,377720,359983,-17737
1042,88,318829,22850,378516,353789,-24727
1043,89,319142,23350,379637,354040,-25597
1044,85,319163,25400,379427,356010,-23417
1045,81,319339,24750,379767,358541,-21226
1046,80,319525,25600,380287,359910,-20377
1047,81,319634,22950,380684,360960,-19724
1048,81,319744,24750,380627,362841,-17786
1049,81,320994,24300,381820,364310,-17510
1050,87,321277,26400,383332,365591,-17741
1051,81,322043,19350,384832,367060,-17772
1052,82,322170,20300,385020,368610,-16410
1053,82,322329,20300,359486,359418,-68
1054,85,322589,24950,359986,359890,-96
1055,83,322736,23500,360008,360289,281
1056,86,323400,23650,360425,361018,593
1057,83,323943,22600,362276,361390,-886
1058,80,323968,21550,362345,361890,-455
1059,90,324041,28350,362475,362939,464
1060,87,324141,26400,362833,363489,656
1061,83,324704,23950,363383,364139,756
1062,81,325338,21600,364025,365089,1064
1063,90,325718,22950,365026,365589,563
1064,84,325955,23100,365575,366140,565
1066,89,326123,19800,366833,366749,-84
1066,89,326123,21500,366876,367439,563
1067,87,326237,25500,367333,367968,635
1068,80,326705,23800,367883,368568,685
1069,81,326790,23850,367926,369168,1242
1070,84,326885,24450,364289,369849,5560
1071,83,327143,21700,364889,370340,5451
1072,80,327433,23350,366306,371168,4862
1073,83,327571,23050,366571,371718,5147
1074,90,327870,28800,367121,372218,5097
1075,86,328598,25450,369777,372999,3222
1076,89,328797,26050,368171,373499,5328
1077,86,328870,28150,371377,374590,3213
1078,81,328972,26550,372377,375268,2891
1079,82,330051,21200,373377,363269,-10108
1080,85,330650,24500,367267,364292,-2975
1081,80,330884,23350,366503,364683,-1820
1082,87,331120,25050,371353,365183,-6170
1083,84,331152,24000,372013,365869,-6144
1084,81,331289,21150,374653,366047,-8606
1085,83,331294,19450,375113,366986,-8127
1086,80,331324,25600,374603,368536,-6067
1087,83,331424,21700,376113,370372,-5741
1088,83,331546,22150,377453,370972,-6481
1089,80,331628,22000,377703,373236,-4467
1090,89,331646,23800,377763,373522,-4241
1091,87,331879,24150,379413,368786,-10627
1092,85,332134,23600,380013,369354,-10659
1093,90,333344,22050,385653,369550,-16103
1094,90,333370,26100,386663,370160,-16503
1095,89,333421,25150,387303,371260,-16043
1096,87,333474,24600,388363,372921,-15442
1097,81,333531,21150,386713,374510,-12203
1098,81,333631,22500,389613,375721,-13892
1099,90,333802,24300,390553,377971,-12582
1100,90,333938,23400,390313,378571,-11742
1102,87,334301,21650,394853,380160,-14693
1102,87,334301,20950,395013,380921,-14092
1103,80,335186,21550,398163,382560,-15603
1104,89,335256,26500,398053,384671,-13382
1105,80,336008,19300,399213,386171,-13042
1106,83,336237,22150,402413,387221,-15192
1107,80,336261,22000,402913,388771,-14142
1108,89,336481,26050,403253,391471,-11782
1109,82,337132,22550,406663,392760,-13903
1110,83,337164,23950,406853,393821,-13032
1111,89,337469,26500,407903,395571,-12332
1112,88,337615,26900,408216,397610,-10606
1113,87,337716,25950,408490,398821,-9669
1114,88,338413,27800,407503,400460,-7043
1115,80,338490,22000,409103,401910,-7193
1117,85,338754,26150,411863,403410,-8453
1117,85,338754,24000,411653,389069,-22584
1118,81,338912,21600,376629,389883,13254
1119,81,339081,22950,377179,390519,13340
1120,87,339291,20100,377536,391619,14083
1121,80,339534,19750,378503,392619,14116
1122,85,340004,26300,379836,393333,13497
1123,87,340686,25500,382436,396883,14447
1124,87,340732,27750,382936,398419,15483
1126,89,341040,23450,384703,399919,15216
1126,89,341040,23300,385286,402019,16733
1127,88,341220,22850,385903,403119,17216
1129,85,341586,22100,388953,405083,16130
1129,85,341586,26700,388453,406733,18280
1130,90,342454,24300,390436,408333,17897
1131,80,343400,20650,392036,409833,17797
1132,82,344119,23900,393786,411069,17283
1133,90,344402,24300,396436,412719,16283
1134,80,344613,23350,397703,414483,16780
1135,88,344649,22400,397536,415769,18233
1136,88,344891,26900,400603,417883,17280
1137,83,344992,28000,400053,419919,19866
1138,87,345119,24150,402103,420733,18630
1139,83,345481,21700,404186,421833,17647
1140,81,345987,26100,407553,423969,16416
1141,84,346056,23100,408336,425933,17597
1142,81,346190,25650,407053,428533,21480
1143,81,346484,24750,410403,429783,19380
1144,82,346529,23450,410386,431333,20947
1145,80,347183,18400,414203,431883,17680
1147,87,347416,27450,415453,433533,18080
1147,87,347416,24100,417653,436133,18480
1148,89,347420,25150,416586,438469,21883
1149,89,347511,24250,417153,440069,22916
1150,86,347517,22300,417103,441319,24216
1151,80,347738,21100,417236,390394,-26842
1152,87,348434,21450,390727,390894,167
1153,82,348985,17150,392582,391465,-1117
1154,81,349015,18900,392977,391944,-1033
1155,90,349453,22050,395032,392165,-2867
1156,82,349618,23900,397332,392665,-4667
1157,86,349686,27700,399432,393298,-6134
1158,83,349787,22150,400582,393869,-6713
1159,87,349916,23250,402132,394189,-7943
1160,88,350130,28250,403277,394794,-8483
1161,81,350978,20250,404182,395648,-8534
1163,85,351442,25600,407377,396148,-11229
1163,85,351442,23550,407632,396494,-11138
1164,81,351730,23850,410832,397148,-13684
1165,80,351858,22900,411577,397544,-14033
1166,84,352044,26250,411882,398589,-13293
1167,87,352376,23700,412932,399244,-13688
1168,82,352933,21650,414627,399589,-15038
1169,88,352996,24200,414932,400015,-14917
1170,90,353258,22050,416277,400869,-15408
1171,85,353804,21350,417327,401289,-16038
1172,86,354066,26350,420832,401990,-18842
1174,80,354437,26600,423727,402449,-21278
1174,80,354437,24650,423582,403089,-20493
1175,80,354484,21100,424132,403639,-20493
1176,86,355016,22300,426782,404099,-22683
1177,87,355173,26850,428882,405149,-23733
1178,80,355348,24700,429777,405941,-23836
1179,88,355594,24200,431082,406541,-24541
1180,87,356120,24600,431522,406718,-24804
1181,86,356385,24100,432072,406440,-25632
1182,90,356659,22950,432042,408360,-23682
1183,89,356716,29650,432431,410344,-22087
1184,86,356931,25450,436577,413044,-23533
1185,89,357096,25150,436582,414810,-21772
1186,88,357121,27350,436627,416860,-19767
1187,81,357393,18450,401969,408122,6153
1188,87,357447,23250,401684,408789,7105
1189,80,357702,20650,402637,408889,6252
1190,85,357909,23600,403477,411439,7962
1191,85,358046,28100,403761,412989,9228
1192,89,358477,25150,404861,414272,9411
1193,83,358921,22150,409093,415422,6329
1194,85,359033,25850,410688,416443,5755
1196,87,359113,23850,411543,416622,5079
1196,87,359113,24550,412061,403769,-8292
1197,88,359116,29600,411511,404791,-6720
1198,86,359169,26800,412093,406941,-5152
1199,85,360006,22250,413611,407941,-5670
1200,81,360249,21600,416288,409963,-6325
1201,86,360345,23200,417283,411591,-5692
1202,89,360550,20650,417488,413213,-4275
1203,84,360992,21300,419933,414363,-5570
1204,82,361906,23000,420983,415913,-5070
1205,81,362380,23850,424233,417191,-7042
1206,85,362451,27650,425838,419291,-6547
1207,87,362754,25050,428438,420313,-8125
1208,83,362811,26200,429133,421841,-7292
1209,88,363779,25550,430883,423313,-7570
1210,80,364277,21550,432138,424413,-7725
1211,85,364733,20900,433638,426063,-7575
1212,81,364820,22500,434333,426591,-7742
1213,87,365697,22800,437133,427063,-10070
1214,90,365729,23400,437588,428941,-8647
1215,88,366550,24650,439838,430213,-9625
1217,88,366712,20400,442383,431191,-11192
1217,88,366712,25500,442838,432841,-9997
1218,80,367062,21100,444983,434541,-10442
1219,84,367216,25800,446583,436591,-9992
1220,87,367243,23250,446438,437763,-8675
1221,82,367778,25700,447438,440341,-7097
1222,86,368584,26350,448488,442913,-5575
1223,81,369931,21600,450488,443463,-7025
1224,80,370114,22000,451483,412265,-39218
1225,87,370167,25500,450983,412691,-38292
1226,89,371008,25150,412079,413111,1032
1228,82,371493,21700,413434,413291,-143
1228,82,371493,22500,413519,413661,142
1229,87,373199,24600,414116,414515,399
1230,80,373405,21100,414329,415015,686
1231,86,373807,20950,414737,415041,304
1232,85,373994,21350,414520,411252,-3268
1233,89,374175,26500,415435,411862,-3573
1234,89,374666,24250,419985,413725,-6260
1235,86,374705,25450,420120,415612,-4508
1236,80,375008,21100,421820,416662,-5158
1237,86,375230,23650,422470,419162,-3308
1239,88,375398,22850,422135,421125,-1010
1239,88,375398,21900,422185,423412,1227
1240,83,375502,23500,413943,424875,10932
1241,87,375915,25050,415293,426212,10919
1242,82,376028,22100,415508,423873,8365
1243,90,376173,27450,415843,425695,9852
1244,80,376611,23350,416608,426545,9937
1245,86,376794,26350,416943,427545,10602
1246,87,377308,23700,417401,428095,10694
1247,83,378814,27100,410449,429345,18896
1248,88,379379,24200,411012,430545,19533
1249,90,379680,24300,412062,431073,19011
1250,83,379887,22600,412471,422344,9873
1251,83,380119,26200,413949,422894,8945
1252,85,380307,26750,414771,423489,8718
1253,86,380384,29050,414810,424819,10009
1254,82,380448,23000,415410,425452,10042
1255,81,380574,24750,415634,425589,9955
1256,80,380738,22450,416149,426002,9853
1257,89,380811,21550,416184,426519,10335
1258,85,381110,21800,416919,426602,9683
1259,88,381407,25100,417862,428023,10161
1260,80,381519,25600,418281,430623,12342
1261,83,381743,21250,418503,432223,13720
1262,85,382615,23150,420187,434473,14286
1264,86,382736,22500,420737,435810,15073
1264,86,382736,20900,420831,438023,17192
1265,87,382904,22350,420934,440073,19139
1266,88,383281,26900,422034,441673,19639
1267,84,383448,22200,422133,443360,21227
1268,84,383661,24450,422916,444773,21857
1269,81,383974,21150,423619,447023,23404
1270,90,384068,22500,423431,447573,24142
1271,82,384928,24350,424199,449410,25211
1272,85,385034,27650,425181,451673,26492
1273,89,385281,25600,426299,453823,27524
1274,84,385307,22650,426071,455473,29402
1275,80,385531,21100,426637,457073,30436
1276,88,385762,21950,427171,458673,31502
1277,90,386032,23850,427866,460710,32844
1278,86,386231,23200,428369,461423,33054
1280,85,387327,24350,429910,463023,33113
1280,85,387327,22650,429734,463610,33876
1281,83,387460,23950,430910,464573,33663
1282,85,387567,25400,431149,466260,35111
1283,86,388501,20500,432821,467360,34539
1284,81,388521,20250,433371,468460,35089
1285,84,388619,21300,433799,470010,36211
1286,81,388761,22050,434299,471443,37144
1287,86,388871,25000,435110,471943,36833
1288,88,388964,27350,435921,472861,36940
1289,90,389114,22950,436210,473361,37151
1290,83,389249,23050,436421,473543,37122
1291,82,389610,25250,439731,472323,32592
1292,81,389611,22500,439312,474673,35361
1293,87,389617,25500,439231,476660,37429
1294,83,389695,23500,440312,476873,36561
1295,83,389728,25300,440360,441090,730
1296,90,390106,22950,440860,442491,1631
1298,81,390234,25800,441460,443140,1680
1298,81,390234,16600,441149,443751,2602
1299,83,390359,24850,442362,443491,1129
1300,83,390515,20800,442749,437853,-4896
1301,90,390833,21150,443299,438638,-4661
1302,87,390941,24600,443912,438900,-5012
1303,82,390973,25250,443899,439900,-3999
1304,81,391624,22050,443968,440854,-3114
1305,87,391750,30000,444468,441854,-2614
1307,86,391788,24350,444521,442388,-2133
1307,86,391788,24950,444731,442938,-1793
1308,85,391862,20900,444916,443488,-1428
1309,90,392066,22950,445281,443700,-1581
1310,86,392357,27250,445916,444470,-1446
1311,85,392492,21800,446337,444903,-1434
1312,82,392818,19400,447466,445453,-2013
1313,86,392896,21850,447881,446120,-1761
1314,87,393053,21000,448037,446788,-1249
1315,80,393229,22000,448466,447670,-796
1317,84,393592,25650,449687,448153,-1534
1317,84,393592,23950,449734,448820,-914
1318,82,393929,23450,451016,449370,-1646
1319,80,394020,18850,451734,449938,-1796
1320,87,394041,22800,451819,450904,-915
1321,90,394588,24750,452787,451538,-1249
1322,90,394694,21600,453234,451903,-1331
1323,87,395363,23700,454181,452620,-1561
1324,85,395664,24050,454934,453588,-1346
1325,89,396072,26950,455616,454604,-1012
1326,87,396170,24600,455137,455604,467
1327,88,396825,24200,453201,456103,2902
1328,82,397982,25700,453943,456304,2361
1329,87,398162,26400,454493,454043,-450
1330,85,398948,28550,455638,456254,616
1331,80,398960,22450,454993,458504,3511
1332,86,399300,21850,455351,459332,3981
1333,86,399363,26350,452527,448301,-4226
1334,86,399600,25450,452808,448590,-4218
1335,88,400227,22850,453635,449318,-4317
1336,81,400394,26100,454495,450139,-4356
1337,83,400525,25300,454685,450793,-3892
1338,83,400573,21700,454977,451751,-3226
1339,80,401580,20200,456095,452751,-3344
1340,84,401597,24450,456335,453343,-2992
1341,83,402139,23050,457708,453439,-4269
1342,87,402325,25500,458335,453939,-4396
1343,83,402375,25300,458795,454393,-4402
1344,81,402812,23400,460945,455018,-5927
1345,86,402813,25450,460877,455651,-5226
1346,90,403081,24300,460995,456190,-4805
1347,80,403129,23800,461635,458362,-3273
1348,81,403498,22500,462177,459778,-2399
1349,81,404025,22500,462978,461928,-1050
1350,82,404186,18950,463285,462262,-1023
1351,89,404323,26500,463945,464678,733
1352,80,404406,17950,464358,465662,1304
1353,84,404541,19950,464995,467028,2033
1354,81,404674,23850,465595,469028,3433
1355,83,404890,23500,466027,470912,4885
1356,84,405306,21300,466878,471412,4534
1357,85,405311,20450,467208,472412,5204
1358,82,405552,21200,467428,474162,6734
1359,88,405874,26450,468270,474728,6458
1360,85,406056,23600,469570,477362,7792
1361,89,406103,26050,470588,479512,8924
1362,86,406304,26800,472788,481078,8290
1363,87,406431,19200,473838,482762,8924
1364,80,406610,22450,475588,483328,7740
1365,87,406681,22350,476320,484528,8208
1366,86,407029,25900,479088,486578,7490
1367,89,407264,23800,481138,488812,7674
1368,89,407270,24700,481620,491212,9592
1369,88,407281,22400,481070,492212,11142
1370,87,407751,22800,482838,493678,10840
1371,90,408321,23850,484670,494828,10158
1372,81,408634,21150,486720,495878,9158
1373,87,409278,24600,487138,497062,9924
1374,83,409440,23950,471372,498128,26756
1376,80,409465,26700,470944,499928,28984
1376,80,409465,22400,471274,501928,30654
1377,82,409987,23900,464242,502062,37820
1378,82,410733,21650,465292,485702,20410
1379,84,411260,23100,465621,485938,20317
1380,86,411539,23200,466618,486752,20134
1382,85,411677,22800,466993,486938,19945
1382,85,411677,22200,467171,487454,20283
1383,85,412178,18650,467718,488038,20320
1384,84,412730,20400,468442,488302,19860
1385,84,412764,24450,468942,489154,20212
1386,87,412809,22350,468843,489788,20945
1387,87,413798,29100,470218,490754,20536
1388,87,413914,24600,471303,491338,20035
1389,86,413926,24100,471142,491920,20778
1390,87,414177,24150,471621,491538,19917
1391,80,414221,22900,472093,484243,12150
1392,89,414973,24250,472593,485463,12870
1393,86,415608,22300,473342,486719,13377
1394,86,415705,24100,473518,489036,15518
1395,81,416232,19350,475021,489586,14565
1396,86,416318,25000,474668,490913,16245
1397,80,416670,22000,475718,492019,16301
1398,88,417053,27800,477053,493063,16010
1399,80,417074,21550,477521,495843,18322
1400,80,417161,24250,477592,497213,19621
1401,88,417249,25100,478418,498813,20395
1403,87,417499,22750,479518,500093,20575
1403,87,417499,23650,479671,498486,18815
1404,88,417778,25100,480542,501069,20527
1405,81,417831,18450,480243,502586,22343
1406,90,418461,27900,482313,503636,21323
1407,80,418639,22900,483642,505286,21644
1408,80,418732,22450,483918,506319,22401
1410,82,418864,21650,484142,477919,-6223
1410,82,418864,22950,484303,478589,-5714
1411,84,418940,22650,484671,479144,-5527
1412,84,419916,19050,485171,479644,-5527
1413,83,420185,20350,485443,480089,-5354
1414,87,420773,26850,486418,480589,-5829
1415,89,420844,24250,486543,481169,-5374
1416,87,421055,24150,486842,481669,-5173
1417,82,421688,22550,488093,482444,-5649
1418,85,421720,22700,488018,483102,-4916
1419,85,422274,22250,488643,483219,-5424
1420,88,423179,26450,489442,483794,-5648
1421,83,423683,23050,489568,483469,-6099
1422,90,423702,21150,489643,483519,-6124
1423,81,423785,21600,478672,476746,-1926
1424,81,424605,22500,479390,477746,-1644
1425,80,425540,18850,479890,478037,-1853
1426,88,426162,26450,481407,479195,-2212
1427,89,426314,26500,482122,479674,-2448
1428,85,426367,24500,481957,480674,-1283
1429,81,427831,22050,482513,481046,-1467
1430,88,428267,24650,483288,481297,-1991
1431,88,428753,29150,484422,482295,-2127
1432,86,429135,20950,485763,482624,-3139
1433,83,429167,22600,486107,482897,-3210
1434,88,429172,22400,486072,483947,-2125
1436,86,430043,22050,486888,484746,-2142
1436,86,430043,24500,486990,485474,-1516
1437,86,430316,25000,487307,486296,-1011
1438,88,430851,24200,488413,487674,-739
1439,90,431117,23850,488913,488195,-718
1440,87,431636,20550,489140,488837,-303
1441,86,432374,20050,489438,489224,-214
1442,84,432378,24900,489007,489774,767
1443,87,432516,22350,486601,490496,3895
1444,87,433227,25050,487588,491037,3449
1445,80,433965,17050,487695,491496,3801
1446,90,434243,23400,488251,491995,3744
1447,85,434339,20000,488210,484706,-3504
1448,85,434371,26300,488688,486256,-2432
1449,89,435940,22000,486287,487356,1069
1450,80,436144,22900,486431,488132,1701
1451,82,436406,20300,486187,489782,3595
1452,90,436636,21150,486595,490306,3711
1453,85,437265,21350,487095,492132,5037
1454,86,437663,26800,487837,493682,5845
1455,88,437889,22850,488145,495306,7161
1456,89,438451,22450,489058,496782,7724
1457,86,439045,25450,490827,497982,7155
1458,85,439121,20000,490877,498582,7705
1459,80,439306,21100,491930,499656,7726
1460,81,439325,20700,491408,500706,9298
1461,84,439333,27600,491937,502906,10969
1462,80,439409,21100,492058,504382,12324
1463,87,439484,21000,492430,505156,12726
1464,89,439746,23350,493080,506632,13552
1465,87,439896,23250,493095,508106,15011
1466,90,440160,27450,494095,509532,15437
1467,82,441115,23450,494727,510906,16179
1468,81,441250,22500,494958,513732,18774
1469,87,441486,21000,495277,515206,19929
1470,83,441617,20800,496203,517232,21029
1471,90,441815,24300,497753,519056,21303
1473,80,442212,23600,502492,520982,18490
1473,80,442212,23300,502992,499241,-3751
1474,89,442423,29650,506153,500142,-6011
1475,89,442551,23800,507253,502292,-4961
1476,82,442613,23450,507542,503925,-3617
1477,87,443309,23700,508703,505542,-3161
1478,80,443496,24250,509642,507625,-2017
1479,89,444200,24700,513892,508642,-5250
1480,87,444356,23700,516353,510225,-6128
1482,83,444424,20750,518842,501293,-17549
1482,83,444424,22100,518453,501026,-17427
1483,88,444497,26000,518892,502415,-16477
1484,89,444862,22900,520042,502893,-17149
1485,87,446363,24150,521053,503393,-17660
1486,83,446588,23500,509787,503726,-6061
1487,84,446886,23100,510069,504226,-5843
1488,89,448024,22450,512319,505565,-6754
1489,83,448053,22150,512087,506269,-5818
1490,89,448785,22900,513569,507193,-6376
1491,86,449455,25900,517087,508115,-8972
1492,85,449619,19550,520287,508411,-11876
1493,86,449619,22300,520369,508919,-11450
1494,80,449708,24700,520237,509693,-10544
1495,87,451026,25500,523019,510126,-12893
1496,85,451118,23600,524037,510865,-13172
1497,90,451480,26550,526887,511776,-15111
1498,82,451597,20300,526787,511943,-14844
1499,80,451676,22000,527937,499205,-28732
1500,80,452385,22450,529869,499755,-30114
1501,82,452953,23900,531087,501004,-30083
1502,88,453334,25100,532969,502455,-30514
1503,84,453725,22650,534637,523618,-11019
1504,83,455242,18550,536069,523993,-12076
1506,83,455563,24100,538469,524668,-13801
1506,83,455563,20750,538969,525168,-13801
1507,82,455613,23900,539187,525592,-13595
1508,81,456729,22050,540687,526142,-14545
1509,83,457171,20800,509956,526643,16687
1510,88,457407,20150,510341,527351,17010
1512,86,458064,22750,511606,527851,16245
1512,86,458064,21350,511927,528443,16516
1513,90,459844,25650,512818,529242,16424
1514,89,460006,22900,513706,529593,15887
1516,82,460150,20750,515037,530093,15056
1516,82,460150,24300,514773,530543,15770
1517,82,460286,22550,515273,531143,15870
1518,89,460358,31000,515734,531718,15984
1519,83,460680,19000,517137,531951,14814
1520,82,460762,21650,518137,532793,14656
1521,90,460868,23400,518737,533343,14606
1522,88,460982,21050,519173,533868,14695
1523,88,461083,26000,519837,534443,14606
1524,81,461139,21600,519434,534742,15308
1525,82,461323,22550,520273,535593,15320
1526,89,462153,23350,521968,536568,14600
1527,82,462195,22100,521881,536843,14962
1528,89,462253,24250,522073,537193,15120
1529,85,462416,26300,522931,537992,15061
1530,82,462858,24800,523587,538443,14856
1531,86,463138,22750,524137,539542,15405
1532,88,463405,26900,525281,540142,14861
1533,87,463518,25950,525781,540993,15212
1534,81,463739,24300,526687,541968,15281
1535,87,463963,21900,527318,542201,14883
1536,90,464088,24750,527873,542701,14828
1537,81,464618,21600,529923,542868,12945
1538,80,464774,22450,531181,543242,12061
1539,84,464790,24000,531337,544301,12964
1540,85,464908,24500,531534,544792,13258
1541,85,465384,25850,522545,545451,22906
1542,86,465961,22750,524263,545843,21580
1543,83,466209,23950,525363,546542,21179
1544,90,466514,21150,527663,547243,19580
1545,83,466630,23050,529045,548192,19147
1546,88,467260,26900,530245,548918,18673
1547,80,467598,22450,532345,549418,17073
1548,90,467934,27450,533845,550643,16798
1549,90,468366,25200,535763,551392,15629
1550,87,468478,21450,536263,551992,15729
1551,90,469174,20700,539013,552101,13088
1552,86,469368,24550,539513,552893,13380
1553,89,469583,23350,541113,553293,12180
1554,85,470131,23150,543295,553651,10356
1555,81,470424,19800,545395,554092,8697
1556,84,470462,22200,546045,554901,8856
1557,80,470580,20200,548113,555142,7029
1559,90,470724,28300,548613,555943,7330
1559,90,470724,23350,548713,556493,7780
1560,88,470784,24200,548663,557151,8488
1561,85,470814,25400,548695,557651,8956
1562,83,470866,23050,549195,558368,9173
1563,81,471393,20250,525735,558918,33183
1564,80,471686,23350,526541,559543,33002
1565,88,471762,21500,527485,560401,32916
1566,90,472963,23850,529085,560901,31816
1567,82,473377,17600,531485,561192,29707
1568,81,473632,21150,533591,561692,28101
1569,81,473696,24750,534635,562443,27808
1570,90,473698,25200,534741,563043,28302
1571,83,474331,21700,536485,563842,27357
1572,85,474404,22700,537241,564643,27402
1573,85,475168,20900,538891,565343,26452
1574,81,475325,24300,540585,566343,25758
1576,81,475538,21650,541841,566893,25052
1576,81,475538,21100,543341,567493,24152
1577,82,475742,19850,547041,567993,20952
1580,88,475952,20450,547641,568668,21027
1580,88,475952,21850,547541,569218,21677
1580,88,475952,26350,547735,569551,21816
1581,80,476134,21100,545638,536744,-8894
1582,89,476460,26500,522124,537237,15113
1583,88,476692,24200,524324,537549,13225
1584,85,476739,25850,524441,538055,13614
1585,83,476745,23500,524535,538171,13636
1586,89,477536,23800,525035,537682,12647
1587,82,477810,22550,525685,538008,12323
1588,87,478016,18300,525774,539532,13758
1589,90,478794,22950,527341,542632,15291
1590,90,478911,28800,527841,544782,16941
1591,89,479132,23800,528341,545319,16978
1592,82,479480,23450,528885,545696,16811
1593,83,479922,23500,529585,546204,16619
1594,87,480061,20100,529774,546704,16930
1595,89,480847,23800,531674,547569,15895
1596,89,480960,25150,532474,548369,15895
1597,89,481096,25150,532994,548691,15697
1598,84,481126,23550,533185,549569,16384
1599,81,481536,22500,533735,551139,17404
1601,83,481829,25150,534891,553269,18378
1601,83,481829,22550,534644,553989,19345
1602,85,482220,26750,536141,556489,20348
1603,87,482309,21000,536374,557469,21095
1604,80,482364,20200,536894,559769,22875
1605,82,482533,22100,537444,560919,23475
1606,90,482654,24750,537924,562719,24795
1607,86,482760,20050,538335,563319,24984
1608,87,483006,24150,538824,565019,26195
1609,85,483260,22700,539074,567119,28045
1610,84,483459,20400,539344,568969,29625
1611,84,484756,21300,539791,571189,31398
1612,90,484914,24300,539674,571739,32065
1613,80,485336,24700,540724,573769,33045
1614,82,485384,21650,541144,575189,34045
1615,90,485563,24300,541135,576469,35334
1616,81,485658,27900,541785,578839,37054
1617,80,485884,23800,542794,579439,36645
1618,87,485895,23250,542324,580369,38045
1619,80,486296,19300,543074,581419,38345
1620,80,487864,21550,543794,581839,38045
1621,82,488814,23450,544587,562741,18154
1622,80,488834,18850,545345,562369,17024
1623,87,488939,23250,545587,550662,5075
1624,90,489147,27450,545808,552362,6554
1625,83,489493,23500,547641,554512,6871
1626,85,489497,26300,547824,555131,7307
1627,83,489682,25300,548324,556881,8557
1628,89,490568,24700,548741,558431,9690
1629,82,490981,21650,549974,560481,10507
1630,85,491088,24950,550124,561481,11357
1631,83,491563,24400,550985,562531,11546
1632,86,491716,29500,551594,560808,9214
1633,81,492004,25200,552485,562232,9747
1634,84,492267,22200,553244,562858,9614
1635,80,492434,20200,553774,564358,10584
1636,80,492447,24700,553741,565858,12117
1637,88,493495,26000,554474,567082,12608
1638,84,493788,21750,555024,568182,13158
1639,88,494128,24650,555994,569282,13288
1640,81,494166,23400,556258,570382,14124
1641,90,495205,31050,556929,572558,15629
1642,81,495504,19350,557445,573558,16113
1643,84,495809,20400,558429,574932,16503
1644,80,495837,24700,558437,578032,19595
1645,84,496141,22650,560145,580058,19913
1646,89,496315,26500,560953,581608,20655
1647,84,496785,21300,563753,583182,19429
1650,81,497039,26500,564545,585958,21413
1649,87,497038,21000,566553,586932,20379
1650,81,497039,22450,566845,588858,22013
1651,87,497098,24150,567603,590408,22805
1652,89,497311,25600,569195,591608,22413
1654,88,497404,21900,569703,593332,23629
1654,88,497404,24600,569795,544476,-25319
1655,85,497719,24500,572303,545526,-26777
1656,82,497755,23450,572645,547012,-25633
1657,88,498081,23300,575445,547826,-27619
1658,81,498215,22500,576703,549812,-26891
1659,84,498295,23550,576445,550371,-26074
1660,84,498305,22200,576995,551365,-25630
1661,89,499989,23350,563373,552413,-10960
1662,90,500150,22950,563781,552926,-10855
1663,81,500463,22500,564137,553613,-10524
1664,88,500676,25550,565520,554121,-11399
1665,82,500784,23000,566237,554593,-11644
1666,90,500957,29250,566670,555093,-11577
1667,86,501139,21400,567681,555626,-12055
1668,82,501157,24800,567634,555913,-11721
1669,87,501694,21450,568223,556413,-11810
1670,84,501717,19500,568520,556921,-11599
1671,84,502761,24450,569273,557413,-11860
1672,86,503541,29500,570587,557913,-12674
1673,80,503601,21550,570931,558343,-12588
1674,84,503799,24450,571323,558976,-12347
1675,89,503964,26050,571834,559715,-12119
1676,83,504143,22150,572323,560215,-12108
1677,86,504400,21850,572384,560993,-11391
1678,81,506229,24300,573384,562063,-11321
1679,88,506329,22850,573131,562613,-10518
1680,82,506380,18050,573320,563065,-10255
1681,90,506634,25200,573984,565243,-8741
1682,82,506892,24350,575431,567293,-8138
1683,89,506911,26500,575634,568843,-6791
1684,88,506980,19700,576134,570093,-6041
1685,88,507232,23750,576923,570492,-6431
1686,86,507233,24550,577370,570818,-6552
1687,89,507551,26950,578473,571318,-7155
1688,86,507623,19600,578534,572242,-6292
1689,85,507893,21350,578470,572943,-5527
1690,89,507961,24700,578973,573401,-5572
1691,90,508240,27000,580645,574545,-6100
1692,88,508419,25100,581315,575551,-5764
1693,83,508953,20350,582495,576051,-6444
1694,81,509636,17550,584465,576551,-7914
1695,87,509689,26850,584965,577318,-7647
1696,85,510598,22700,587145,577651,-9494
1697,81,510883,23850,589215,577745,-11470
1698,81,510897,22050,589245,573493,-15752
1700,81,511593,26500,593165,575093,-18072
1700,81,511593,23800,593065,575768,-17297
1701,87,511729,22800,593495,576868,-16627
1703,81,512250,25700,597565,578201,-19364
1703,81,512250,22900,596795,578642,-18153
1704,84,512539,21300,598295,579301,-18994
1705,87,513036,23250,600545,580192,-20353
1707,88,513540,24450,605395,580643,-24752
1707,88,513540,25500,605265,579993,-25272
1708,80,513719,24250,606945,581118,-25827
1709,90,514144,23850,608145,582318,-25827
1710,86,514431,24550,611615,583568,-28047
1711,89,514482,24700,612165,584743,-27422
1712,80,514632,22000,612765,582276,-30489
1713,86,514793,19600,613865,583062,-30803
1714,85,514970,21350,616665,583576,-33089
1715,86,515027,26350,617315,584312,-33003
1716,82,515080,23450,617865,586326,-31539
1717,82,515608,23900,619565,578005,-41560
1718,89,515859,25150,621195,578794,-42401
1719,80,516022,22450,622245,579171,-43074
1720,88,516523,22850,624445,579555,-44890
1721,83,516668,22150,625165,580171,-44994
1722,85,517139,24500,627095,580605,-46490
1723,88,517367,26450,628095,576148,-51947
1724,80,517779,23800,631065,576624,-54441
1725,87,518093,21900,635395,577348,-58047
1726,83,518153,23050,635715,578189,-57526
1727,80,519051,20200,637765,578549,-59216
1728,83,519407,22600,640615,579049,-61566
1729,86,519461,23200,641615,579599,-62016
1730,89,519571,23800,642045,579889,-62156
1731,87,519805,25050,643165,580374,-62791
1732,86,521005,26800,644945,581439,-63506
1733,82,521276,23450,647365,582195,-65170
1734,89,521337,22900,647695,583039,-64656
1735,86,521430,20950,648365,583395,-64970
1736,82,521730,24350,650045,583799,-66246
1737,89,522015,23350,652915,584395,-68520
1738,88,522088,25100,653565,585074,-68491
1739,80,522155,19750,653645,585145,-68500
1740,83,522318,20350,655295,585639,-69656
1741,90,522381,22950,655795,586295,-69500
1742,85,522802,26750,656345,587139,-69206
1743,89,523431,23800,659495,588139,-71356
1744,87,523537,19200,660465,588574,-71891
1745,82,524009,19850,661595,589199,-72396
1746,80,524473,24700,665215,589598,-75617
1747,84,524607,25350,666365,590198,-76167
1748,85,524762,20450,666395,590624,-75771
1749,90,525350,27450,671395,590895,-80500
1750,87,525397,21900,670965,591599,-79366
1751,87,525497,24150,672245,592045,-80200
1752,82,525675,23000,672745,592595,-80150
1753,84,525970,21750,634535,593145,-41390
1754,86,526317,24550,638094,593645,-44449
1755,86,526339,24550,637494,594374,-43120
1756,87,526692,25950,639835,589079,-50756
1757,82,526916,25250,641244,589835,-51409
1758,89,527301,26950,645435,590885,-54550
1759,84,527359,20850,646585,591248,-55337
1761,88,527481,23200,645194,591748,-53446
1761,88,527481,23250,647694,592329,-55365
1762,88,527661,23750,647194,592798,-54396
1763,83,527794,21700,647735,590893,-56842
1764,83,527967,25300,584874,591495,6621
1765,90,528024,24750,584941,591941,7000
1766,85,528101,22250,584924,592396,7472
1767,82,528515,20750,585424,592601,7177
1768,80,529024,18850,586424,593520,7096
1769,90,529110,22950,586435,593943,7508
1770,83,530434,23500,587485,594443,6958
1771,87,530508,21900,587724,594894,7170
1772,88,531264,24200,588224,595451,7227
1773,85,531941,23150,588891,595951,7060
1774,80,532260,23800,590541,596970,6429
1775,90,532346,25200,590835,597551,6716
1776,84,532445,22200,590374,598051,7677
1777,83,532706,26650,594495,598545,4050
1778,86,532808,23650,595595,599344,3749
1779,89,532892,23350,596645,600120,3475
1780,81,533024,21150,597105,601095,3990
1781,82,533352,21650,598995,601595,2600
1782,88,533579,23300,602795,602444,-351
1783,88,533629,21500,603605,603345,-260
1784,86,533772,20950,604645,603620,-1025
1785,88,533901,21050,605105,604545,-560
1787,87,534542,21650,611395,605051,-6344
1787,87,534542,25000,611805,605294,-6511
1788,81,534630,21150,612495,605794,-6701
1789,82,534886,23000,616045,606344,-9701
1790,80,534944,22000,616595,607151,-9444
1791,85,535840,19550,618295,607993,-10302
1792,82,536159,24350,619395,608394,-11001
1793,86,536632,24100,621555,608894,-12661
1794,90,537491,25650,624305,609395,-14910
1795,90,537750,24300,625505,610193,-15312
1796,82,538627,26150,631005,610995,-20010
1798,86,538799,22200,632755,611545,-21210
1798,86,538799,24950,633145,611943,-21202
1799,90,538806,24750,631595,612670,-18925
1800,85,538829,25400,634145,613220,-20925
1801,90,539023,26100,634455,613344,-21111
1802,88,539322,23750,635555,614195,-21360
1803,85,539563,27200,638155,614695,-23460
1804,89,539625,27400,639205,615320,-23885
1805,86,539799,20950,640905,616143,-24762
1806,84,540061,23100,643895,616970,-26925
1807,81,540063,27450,643705,617470,-26235
1808,88,540700,27800,645455,617801,-27654
1809,87,540713,24150,646495,618344,-28151
1810,84,540964,25350,648255,618345,-29910
1811,89,541155,22000,650295,619343,-30952
1812,80,541277,22450,650955,619551,-31404
1813,84,541644,19950,652105,620294,-31811
1814,83,542354,22600,653195,620701,-32494
1816,80,542570,31700,654676,621870,-32806
1816,80,542570,23300,654938,621994,-32944
1817,83,542864,22150,655519,622801,-32718
1818,90,543317,22950,656638,623245,-33393
1819,90,544000,22500,657119,623851,-33268
1820,81,545270,22500,657619,624543,-33076
1821,90,545362,27900,658690,625070,-33620
1822,88,545454,26450,658859,626294,-32565
1823,89,545750,26950,660290,626994,-33296
1824,82,545852,22100,660788,627170,-33618
1825,80,546007,22900,660969,628143,-32826
1826,85,546012,25400,661476,628720,-32756
1827,86,546295,26350,661390,629251,-32139
1828,81,546311,21150,661409,629951,-31458
1829,87,546417,26400,658745,630795,-27950
1830,90,546748,23400,659705,631743,-27962
1831,85,547295,26300,660945,632295,-28650
1832,87,547720,25500,663005,632894,-30111
1833,85,549331,24500,664145,633395,-30750
1834,90,549689,23850,665355,634001,-31354
1835,84,550334,22650,667745,634445,-33300
1836,81,550535,25650,668795,634051,-34744
1837,87,550756,25050,671055,631595,-39460
1838,81,550844,20700,671695,633195,-38500
1839,82,550851,23000,672055,634778,-37277
1840,81,551100,25650,671555,636328,-35227
1841,87,551714,22350,619531,633332,13801
1842,87,552132,25500,620581,634882,14301
1843,85,552367,23150,622181,636460,14279
1844,86,552462,22300,622731,637160,14429
1845,88,552637,21500,623638,639260,15622
1847,82,553058,26050,625931,640382,14451
1847,82,553058,24300,625981,641460,15479
1848,89,554691,26500,627781,642982,15201
1849,84,554882,17700,628931,643982,15051
1850,80,555080,19300,630288,645632,15344
1851,87,555303,25050,632681,647960,15279
1853,83,555378,24900,633888,649932,16044
1853,83,555378,23000,634281,651632,17351
1854,81,556050,23400,635588,653110,17522
1855,86,556274,24550,636088,654382,18294
1856,82,556422,21650,637188,654932,17744
1857,88,556843,28250,640981,657060,16079
1858,85,556859,22700,640988,657660,16672
1859,89,557258,22450,642531,659182,16651
1860,87,557456,25500,644088,660232,16144
1861,86,558231,21850,646881,660932,14051
1862,88,558428,21950,647381,662460,15079
1863,82,558783,21650,649031,663560,14529
1864,81,559213,25200,652981,666060,13079
1865,88,559311,26450,653738,667260,13522
1866,90,559354,27000,653981,669260,15279
1867,90,559984,23400,656081,670032,13951
1868,81,560415,22950,658688,671032,12344
1869,84,560793,22650,662631,672082,9451
1870,90,560916,24300,663681,673282,9601
1871,90,561046,25200,664688,674010,9322
1872,83,561315,23500,666481,675932,9451
1873,87,561865,24600,669131,677160,8029
1874,83,561949,20800,671331,678582,7251
1875,86,562008,21850,671438,680632,9194
1876,81,562129,23850,672381,681810,9429
1877,90,562476,25200,674788,682860,8072
1878,83,562522,19000,675181,684232,9051
1879,84,563076,19950,676681,685382,8701
1880,87,563463,24600,679381,686710,7329
1881,90,563786,24750,681288,688082,6794
1882,82,563902,26600,681581,690232,8651
1883,81,564375,21600,683281,691282,8001
1884,88,564845,21500,685181,691971,6790
1885,84,565069,23550,685731,692571,6840
1886,82,565483,22100,686938,693650,6712
1887,83,565873,24400,692838,694750,1912
1888,83,566009,25750,694488,695300,812
1889,85,566019,20450,693888,692882,-1006
1890,82,566067,22100,694781,694082,-699
1891,89,566575,22450,696481,694760,-1721
1892,80,566851,22000,697198,696432,-766
1893,84,567159,22200,698124,698010,-114
1894,87,568236,25050,698939,699182,243
1895,85,568485,23600,698691,699260,569
1896,86,568750,23650,698888,637259,-61629
1897,82,568954,20750,699439,637973,-61466
1898,90,569608,24750,699741,638473,-61268
1899,85,570104,27650,700538,639573,-60965
1900,86,570180,24100,657643,640073,-17570
1901,84,570445,23100,658064,640294,-17770
1902,89,570955,26500,659103,641449,-17654
1903,90,571098,27900,659064,642073,-16991
1904,87,572008,24150,660614,642573,-18041
1905,88,572114,26000,660497,643173,-17324
1906,89,572234,27400,660392,644249,-16143
1907,82,572324,21200,660353,644689,-15664
1908,82,572722,23000,656771,645749,-11022
1909,83,573126,22600,658589,645839,-12750
1910,90,573170,24300,659121,646044,-13077
1911,83,574337,27100,662871,647094,-15777
1912,82,574420,23000,663439,647594,-15845
1913,87,574596,18750,663971,648094,-15877
1914,83,574934,20800,665571,648599,-16972
1917,87,575364,20350,670021,648173,-21848
1917,87,575364,22100,670089,639291,-30798
1917,87,575364,20450,670671,639797,-30874
1918,83,575640,24400,670639,640347,-30292
1919,88,576516,23750,642620,640599,-2021
1920,88,577875,24650,643837,641291,-2546
1921,84,578012,24900,644025,641897,-2128
1922,85,578141,21800,644720,642447,-2273
1923,83,578389,22600,644836,643399,-1437
1924,88,578992,26450,645720,644198,-1522
1925,80,579477,22000,646283,644549,-1734
1927,89,580037,22750,647375,645191,-2184
1927,89,580037,27350,647986,646247,-1739
1928,87,580112,25950,648433,646791,-1642
1929,81,580144,22050,648486,647291,-1195
1930,86,580416,21850,649470,647549,-1921
1931,81,580621,26550,650036,648303,-1733
1932,90,580729,25650,650183,649453,-730
1933,87,581008,18750,651186,649979,-1207
1934,84,581049,20400,651883,651603,-280
1935,89,581134,26950,652186,653579,1393
1936,82,581303,21200,652375,654103,1728
1937,89,581400,25150,652170,655603,3433
1938,89,581840,23800,652875,657329,4454
1939,83,582697,21700,653836,658903,5067
1940,80,582713,21550,653875,660453,6578
1941,89,583172,26500,655087,661003,5916
1942,88,583342,21500,655536,662029,6493
1943,90,583452,27000,655975,664079,8104
1944,88,583596,24200,655587,664779,9192
1945,87,584049,19650,656583,665303,8720
1946,80,584187,22900,657686,655649,-2037
1948,83,584371,25350,657920,656748,-1172
1948,83,584371,25250,658075,656997,-1078
1949,90,584687,27000,658783,658241,-542
1950,80,584945,20200,659470,658741,-729
1951,84,585585,24900,660625,658949,-1676
1952,84,586539,21300,660970,659841,-1129
1954,86,587656,21250,662120,660049,-2071
1954,86,587656,26750,661725,656784,-4941
1955,84,588487,18600,663536,657284,-6252
1956,89,588521,25150,663620,658834,-4786
1957,89,589205,26950,664586,659764,-4822
1958,88,589223,23750,664433,661364,-3069
1959,87,589329,22800,664625,663164,-1461
1960,90,589815,25650,665220,664214,-1006
1961,90,590178,24300,665675,664634,-1041
1962,84,590631,22650,667183,665184,-1999
1963,86,590739,20500,667470,666514,-956
1964,84,590786,24000,667686,668584,898
1965,80,590997,18850,668037,669784,1747
1966,88,591153,25100,668775,670434,1659
1967,81,591419,18450,669825,671564,1739
1968,83,591433,21700,669670,673314,3644
1969,82,591845,23900,670170,674384,4214
1970,87,591850,25950,670670,675214,4544
1971,84,592344,21750,671425,675634,4209
1972,81,592436,23850,671683,677684,6001
1973,84,593482,24000,673237,679684,6447
1974,81,593548,22050,673175,680914,7739
1975,87,593649,27750,673786,681984,8198
1976,89,593729,26050,674287,683014,8727
1977,81,593783,26550,674325,666504,-7821
1979,80,594465,24550,675433,667054,-8379
1979,80,594465,20150,675537,667604,-7933
1980,82,594703,20300,676087,668654,-7433
1981,90,594794,25650,676220,669204,-7016
1982,81,594932,21150,676483,669505,-6978
1983,82,595400,24350,663579,669922,6343
1984,86,595450,24550,663187,670522,7335
1985,89,595503,23800,664360,671105,6745
1986,90,595552,26550,664079,672155,8076
1987,88,595672,25100,664499,672908,8409
1988,87,596166,24600,665460,673954,8494
1989,81,596670,24300,666149,674405,8256
1990,85,597622,24050,666799,674955,8156
1992,82,597948,22500,667799,675208,7409
1992,82,597948,19350,667480,675690,8210
1993,81,598192,22050,668999,676272,7273
1994,84,598355,18600,669480,676758,7278
1996,85,598450,18950,669737,677154,7417
1996,85,598450,19050,669829,677458,7629
1997,83,598478,20350,669960,678140,8180
1998,87,598934,25500,671372,678955,7583
1999,83,599197,19900,672961,679304,6343
2000,90,599807,22050,675011,679858,4847
2001,87,599866,22800,675372,680558,5186
2002,81,600174,20700,676118,681058,4940
2003,80,600203,21550,676555,681708,5153
2004,90,600897,25200,677129,682355,5226
2005,83,601599,24400,677768,683005,5237
2006,82,601952,27050,679301,683604,4303
2007,88,602054,26900,679901,684140,4239
2008,80,602093,25600,680401,684754,4353
2009,85,602229,22250,680805,685690,4885
2010,89,602582,24250,681529,686454,4925
2011,85,603358,23600,683101,687008,3907
2012,90,603403,28800,683405,688008,4603
2013,85,603984,22250,683668,688322,4654
2014,83,604388,22600,684379,688155,3776
2015,88,604591,19700,685905,686095,190
2016,80,604693,25150,686429,686693,264
2017,84,604766,23550,687405,687070,-335
2018,82,604854,23450,687651,666098,-21553
2019,86,605129,24100,688342,667328,-21014
2021,85,605262,26300,688505,667978,-20527
2021,85,605262,21750,689029,669678,-19351
2022,88,605472,24200,690129,670298,-19831
2023,83,605593,25750,690679,672328,-18351
2024,90,605682,22950,691001,674148,-16853
2025,90,605846,24750,691468,674898,-16570
2026,85,606312,22700,692229,676998,-15231
2027,80,606883,21550,692942,678298,-14644
2028,87,607070,19650,693868,679398,-14470
2029,83,607301,22150,693629,681078,-12551
2030,88,607519,27800,690678,683178,-7500
2031,83,607799,25750,691488,684698,-6790
2032,86,607803,25900,691728,685478,-6250
2033,89,608136,26950,692728,687078,-5650
2034,87,608779,22350,694378,689228,-5150
2036,81,608981,21700,696028,690698,-5330
2036,81,608981,22450,696038,692778,-3260
2037,86,609487,25000,696588,694898,-1690
2038,88,609511,23300,697028,696728,-300
2039,86,609611,22750,695655,698428,2773
2041,82,609665,20550,695368,698978,3610
2041,82,609665,27450,695729,699528,3799
2042,81,610430,22950,696205,701228,5023
2043,81,610718,23400,697001,702228,5227
2044,80,610846,19750,697044,702398,5354
2045,86,611798,25000,697855,697815,-40
2046,90,611922,24750,698029,699915,1886
2047,83,612201,23950,698905,703065,4160
2048,85,612475,25400,699901,704665,4764
2049,87,612530,22800,700005,706215,6210
2050,81,612911,21600,696577,707815,11238
2051,89,613147,19750,697077,709229,12152
2052,85,613870,22700,698711,710879,12168
2053,85,614083,19100,700401,711965,11564
2055,90,614261,23150,700679,713579,12900
2055,90,614261,22450,700901,715229,14328
2056,87,614666,27750,701820,717365,15545
2057,80,614955,22450,701472,718515,17043
2058,84,615836,24900,702111,720615,18504
2059,80,615982,26500,702522,722529,20007
2060,87,616394,21900,687398,724415,37017
2061,87,616588,23250,687891,725279,37388
2062,85,616962,22700,688391,725829,37438
2063,81,617039,22500,688648,727829,39181
2064,90,618562,22950,689749,728565,38816
2065,90,618684,25650,690037,730215,40178
2066,85,618815,22700,691349,731315,39966
2068,90,618859,20850,690930,732479,41549
2068,90,618859,23800,691237,733579,42342
2069,86,620183,23650,692137,734629,42492
2070,80,620321,22450,692324,738165,45841
2071,86,620792,21400,693330,738829,45499
2072,86,620909,26350,693549,739915,46366
2073,88,621109,24200,694049,741429,47380
2074,84,622234,22200,695437,742979,47542
2075,84,622402,24900,696480,744729,48249
2076,85,622436,27650,696487,746279,49792
2077,86,622478,23200,696712,748365,51653
2078,82,623229,23450,697199,749365,52166
2079,86,624418,23200,697680,751465,53785
2081,83,624758,27800,698740,752979,54239
2081,83,624758,24350,698609,753479,54870
2082,90,625166,23400,699026,754415,55389
2083,80,625812,22000,700290,756229,55939
2084,81,625963,22500,700440,757729,57289
2085,82,626611,18500,700990,758165,57175
2086,89,626908,25150,701619,759265,57646
2087,86,628291,21850,703130,761365,58235
2088,87,628346,26400,703212,762565,59353
2089,87,628413,21450,702929,763615,60686
2090,89,628903,20650,704535,714381,9846
2091,87,629183,21450,705347,715803,10456
2092,90,629510,23400,707035,717403,10368
2093,86,629661,25450,708085,718103,10018
2094,82,630010,21650,710047,719653,9606
2095,85,630037,24950,710885,720681,9796
2096,82,630291,23450,713685,721731,8046
2097,80,630350,21100,713747,723903,10156
2098,88,630482,27350,714785,726131,11346
2100,83,631047,21700,717047,727553,10506
2100,83,631047,22550,716547,728353,11806
2101,83,631676,24850,719535,729953,10418
2102,81,632415,20250,722835,730981,8146
2103,90,632509,27900,722947,732253,9306
2104,86,632728,26350,724385,733953,9568
2105,88,633612,24650,724935,736231,11296
2106,80,633853,21100,713369,737753,24384
2107,89,633861,26050,725097,740281,15184
2108,85,633984,20000,713869,740903,27034
2109,81,634264,22950,714369,743381,29012
2110,89,634265,23350,714659,744003,29344
2111,85,634548,29900,716126,747053,30927
2112,90,634638,24750,716340,749331,32991
2113,80,634657,21550,715859,751303,35444
2114,86,634741,22300,715990,752631,36641
2115,84,634878,24450,715840,753703,37863
2116,82,634891,21200,712755,754681,41926
2117,86,634994,21400,712705,754603,41898
2118,82,635054,24350,710879,756481,45602
2119,81,635337,19350,711080,757503,46423
2120,89,635438,22450,711537,758703,47166
2122,83,636122,27100,712051,760753,48702
2122,83,636122,18950,712137,762303,50166
2124,90,636304,25600,713287,762853,49566
2124,90,636304,26950,713401,764503,51102
2125,83,636538,20350,713887,766131,52244
2126,85,636655,24950,714079,767831,53752
2127,83,636968,21250,715179,769681,54502
2128,90,637004,24750,714912,771231,56319
2129,83,637100,25750,715980,772553,56573
2130,83,637541,18100,716412,773931,57519
2131,85,638768,21350,717462,775131,57669
2132,84,638854,23550,717551,776403,58852
2133,86,639201,23650,717130,776931,59801
2135,84,639683,24350,714468,779053,64585
2135,84,639683,23500,714245,779553,65308
2136,81,640300,22050,716368,781203,64835
2137,87,640303,22800,716868,783031,66163
2138,80,640331,22900,718045,784453,66408
2139,82,640421,22550,718545,786203,67658
2140,81,641155,22050,720645,787331,66686
2141,81,641279,22050,721845,718250,-3595
2142,85,641449,20450,722218,718541,-3677
2143,90,642070,22950,723468,719056,-4412
2144,83,642663,23050,726318,719621,-6697
2145,88,642773,26450,727618,720350,-7268
2146,88,643052,21950,728618,720806,-7812
2147,82,643518,20300,729418,721191,-8227
2148,80,644528,23350,730468,721771,-8697
2149,88,645244,24650,723175,722450,-725
2150,90,645807,22050,725120,723050,-2070
2151,81,645824,23400,725088,723521,-1567
2153,87,646097,22650,726587,723906,-2681
2153,87,646097,22300,726483,724491,-1992
2155,80,646236,22600,725587,724991,-596
2155,80,646236,21050,727075,725250,-1825
2156,86,647178,21850,727683,726041,-1642
2157,85,647488,21350,728783,726571,-2212
2158,87,647643,24600,728970,727141,-1829
2159,80,647686,25150,729537,727571,-1966
2160,80,647895,22000,729783,728300,-1483
2161,84,648353,26700,731155,728691,-2464
2162,87,648521,27750,733198,729571,-3627
2163,83,648634,22150,733748,730071,-3677
2164,90,649177,25200,735348,730841,-4507
2165,82,649771,23450,737998,731621,-6377
2166,83,649833,23950,738498,732171,-6327
2167,82,649906,23450,739198,732356,-6842
2168,88,650141,23300,739698,733356,-6342
2169,84,650663,24000,741798,734591,-7207
2170,82,650961,23450,744498,735271,-9227
2171,85,651034,27200,745698,735821,-9877
2173,84,651140,23700,745798,736321,-9477
2173,84,651140,20350,746105,736706,-9399
2174,82,651488,24800,749355,737191,-12164
2175,82,651503,23000,748805,737671,-11134
2176,81,651985,22950,750798,738256,-12542
2177,84,652607,20400,752398,739021,-13377
2178,88,652655,25100,752898,739521,-13377
2179,81,653182,22050,753855,740171,-13684
2180,90,653990,26550,758105,740671,-17434
2181,88,654008,27800,758148,741471,-16677
2182,84,654299,23550,758641,742441,-16200
2183,90,654755,25200,761148,743156,-17992
2184,82,654829,23000,761755,743350,-18405
2185,81,654829,24750,761798,743971,-17827
2186,81,655025,21150,761298,744591,-16707
2187,86,655683,23650,743326,745241,1915
2188,85,655822,22250,743989,745550,1561
2189,81,656098,23400,744489,745856,1367
2191,85,656365,22050,745298,746356,1058
2191,85,656365,19500,745176,746550,1374
2192,85,656596,21350,745789,747406,1617
2193,81,656853,22500,746939,747906,967
2194,80,656864,25150,747198,748321,1123
2195,85,657072,20900,747376,749614,2238
2196,90,657446,23400,748798,751164,2366
2197,81,657568,25650,749091,752164,3073
2198,82,657575,25250,748441,753687,5246
2199,83,657828,21250,749476,754237,4761
2200,83,658013,24850,750498,751550,1052
2201,81,658071,23400,750791,751821,1030
2202,80,658232,22450,751089,752150,1061
2203,90,658339,28350,751576,753191,1615
2204,87,658828,23250,752289,753871,1582
2205,83,659014,24400,752526,754371,1845
2206,86,660429,24550,753091,754921,1830
2207,85,660684,24500,753591,755921,2330
2208,89,660742,26500,754091,756441,2350
2209,89,661298,25600,755376,757441,2065
2210,81,661340,24300,755376,758221,2845
2211,87,661794,21900,756376,758521,2145
2212,90,662001,24300,757276,758806,1530
2214,85,662028,21650,757098,759421,2323
2214,85,662028,21750,757389,759121,1732
2215,80,662383,21100,758341,738551,-19790
2216,81,662454,22500,757826,739151,-18675
2217,87,662510,19650,758076,739651,-18425
2218,88,662933,25100,759139,740346,-18793
2219,84,663041,22200,760139,741201,-18938
2220,84,663325,23100,760639,741496,-19143
2221,90,663579,27450,762228,741595,-20633
2222,89,663875,22000,763740,742145,-21595
2223,81,664012,23400,764940,742951,-21989
2224,80,664222,23800,765640,744045,-21595
2225,80,664310,24250,767228,744695,-22533
2226,88,664588,23750,768840,745001,-23839
2227,81,664919,21600,771328,745145,-26183
2229,83,665322,26550,776440,745796,-30644
2229,83,665322,22550,776540,746501,-30039
2230,80,665542,20650,778778,747195,-31583
2231,88,665558,21950,779278,747651,-31627
2232,87,665621,24600,779340,748201,-31139
2233,87,666305,24150,779928,748751,-31177
2234,89,666651,24700,782028,749751,-32277
2235,80,666924,20650,782390,749896,-32494
2236,85,667206,23150,783578,750645,-32933
2237,87,667619,23700,785440,751422,-34018
2238,80,667652,23350,785535,751745,-33790
2239,82,667917,23450,786035,752245,-33790
2240,86,669173,25000,786840,753096,-33744
2241,83,669217,20800,786825,753222,-33603
2242,90,669591,24750,788037,754145,-33892
2243,85,670160,24050,788635,754301,-34334
2244,88,670490,23750,788940,754795,-34145
2245,83,670859,23050,788575,755096,-33479
2246,87,671240,21450,789578,755451,-34127
2247,82,671353,21650,790078,755945,-34133
2248,90,671457,20250,790490,756495,-33995
2249,84,672849,23550,792328,757122,-35206
2250,80,673241,17950,794528,757695,-36833
2251,80,673384,19750,795028,758801,-36227
2252,85,673492,21350,795390,759245,-36145
2253,81,673776,20700,760687,759645,-1042
2254,82,674253,26600,761362,762095,733
2255,86,674495,24100,762229,762695,466
2256,80,674682,19300,762412,762822,410
2258,86,675033,25050,762887,764472,1585
2258,86,675033,22700,763051,765595,2544
2259,85,675380,20000,763779,767272,3493
2260,83,675548,24400,764082,769745,5663
2261,88,676094,23300,764201,771395,7194
2262,86,676258,23200,764687,773022,8335
2263,86,676829,24100,766337,773945,7608
2264,88,676878,24650,766851,775372,8521
2265,87,676920,25050,766479,775672,9193
2266,88,677321,26000,768551,777922,9371
2267,83,677412,25300,768582,779572,10990
2268,89,677466,24700,769051,781272,12221
2269,81,678124,19800,769229,782445,13216
2270,89,678693,25150,770937,784195,13258
2271,83,678889,23050,771288,785872,14584
2272,85,678920,22700,771338,787045,15707
2273,89,679128,18850,773588,787772,14184
2274,82,679303,23000,773434,788922,15488
2275,84,679368,22650,774034,790745,16711
2276,87,679689,17850,776588,791572,14984
2277,88,679770,22400,777434,792722,15288
2278,90,679788,23850,777588,794445,16857
2279,90,679915,23850,778484,797995,19511
2280,82,680280,25250,781184,799645,18461
2281,84,680319,22650,782184,801745,19561
2282,88,680809,27350,784734,804445,19711
2283,86,680822,25450,784588,806095,21507
2284,89,681049,19300,777582,807222,29640
2285,87,681409,25050,779037,808872,29835
2286,82,681464,20750,779451,810022,30571
2287,85,681540,24050,780232,812095,31863
2288,88,681639,26450,780479,813695,33216
2289,81,682791,24750,781551,814422,32871
2290,80,683093,19300,783582,815245,31663
2291,81,683123,27450,783601,816572,32971
2292,86,683210,21850,783887,818072,34185
2293,89,683301,22900,783387,818322,34935
2294,89,683865,24250,768301,819972,51671
2295,80,684214,21100,768991,820795,51804
2296,90,684548,27450,770091,821995,51904
2297,90,684592,25200,770158,824095,53937
2298,88,684786,21950,770627,826245,55618
2299,84,684930,23550,771308,828272,56964
2300,80,685149,19300,771641,828922,57281
2302,86,685903,19250,772277,830145,57868
2302,86,685903,22250,772551,831295,58744
2303,84,686212,20850,773291,832445,59154
2304,84,687194,23100,773701,833495,59794
2305,87,687592,21000,774827,835072,60245
2306,83,687835,23950,774927,836245,61318
2307,87,688393,28650,775451,837872,62421
2309,89,688976,23000,776377,838795,62418
2309,89,688976,29600,776701,840622,63921
2310,80,690087,26050,777427,844045,66618
2311,82,690205,21200,777201,845172,67971
2312,89,690411,27850,760697,847272,86575
2313,90,690621,26550,761187,848772,87585
2314,88,691093,26000,764837,850272,85435
2315,84,691154,24450,765547,851445,85898
2316,82,691675,23900,768197,853322,85125
2317,89,691931,26050,768187,854745,86558
2319,88,693703,24650,773337,856222,82885
2319,88,693703,25500,773287,858922,85635
2320,83,693831,23050,775437,859657,84220
2321,87,693942,22350,775197,860044,84847
2322,86,694858,26350,777537,861044,83507
2323,80,695325,24250,781997,861622,79625
2324,88,695420,25550,781887,862457,80570
2325,84,695470,22200,783597,862644,79047
2326,85,695523,20450,783647,863004,79357
2327,81,696990,23850,785897,863157,77260
2328,87,697126,25950,786337,860672,74335
2329,87,697723,26850,788437,863672,75235
2330,87,697903,22350,789537,864045,74508
2331,86,697934,24100,790537,866272,75735
2332,82,698043,23450,790347,867422,77075
2333,87,698713,26400,793047,870172,77125
2335,81,699289,21650,796187,870345,74158
2336,81,699341,27000,797247,797624,377
2336,81,699341,21100,796837,798874,2037
2337,89,699567,25600,798937,801545,2608
2338,83,699735,23050,799997,803574,3577
2339,81,700129,19350,802487,804895,2408
2340,87,700211,21900,802547,806545,3998
2341,86,700328,20500,802987,807674,4687
2342,88,700650,21050,804037,808545,4508
2343,81,701506,25200,807897,809595,1698
2344,90,701641,24300,809987,811095,1108
2345,80,701832,23800,812097,813674,1577
2346,87,701837,25050,812587,814724,2137
2347,83,702123,25300,812087,816195,4108
2348,89,702600,23350,791187,816924,25737
2349,84,702738,24900,791687,818145,26458
2350,90,703005,26550,792237,820174,27937
2351,84,704385,23100,793631,821324,27693
2352,83,704435,19900,793681,821574,27893
2353,82,704476,24350,794231,823124,28893
2354,81,704593,22500,794984,824595,29611
2355,90,704690,24300,795062,827024,31962
2356,90,705118,25200,797584,828574,30990
2357,84,705188,25800,798134,829124,30990
2358,88,705634,23300,800584,831324,30740
2359,84,705661,24900,801208,832424,31216
2360,84,705810,23100,801634,835524,33890
2361,82,706493,22100,802908,837145,34237
2362,83,706764,23500,805158,839345,34187
2363,84,706830,23550,806784,840524,33740
2364,82,707143,23000,809284,840995,31711
2365,89,707147,26050,807358,842124,34766
2366,86,707327,26350,809508,843395,33887
2367,80,707778,20650,811384,843974,32590
2368,86,708007,23200,813658,845674,32016
2369,80,708052,22000,813984,846645,32661
2370,80,708284,24700,816634,848645,32011
2371,82,708412,22100,817734,849974,32240
2372,82,708697,17600,820184,851245,31061
2373,81,708736,22950,819634,852774,33140
2374,81,708943,23850,822284,853824,31540
2375,86,709028,23200,822308,855795,33487
2376,81,709748,25650,823384,856795,33411
2377,84,710070,24900,815547,858374,42827
2378,89,710253,22900,796689,860095,63406
2379,89,710335,27850,797326,861745,64419
2380,86,710336,20500,797376,862495,65119
2381,81,710464,20250,797339,863674,66335
2382,80,711244,22000,797889,865324,67435
2383,83,711330,21250,798391,866874,68483
2384,87,711367,25950,798926,868524,69598
2385,84,711570,24900,799389,869545,70156
2386,86,712568,24100,800400,870774,70374
2387,87,712709,25950,801000,873374,72374
2388,84,712952,23550,802176,874874,72698
2389,82,712968,23000,802226,876345,74119
2390,84,713065,22650,802776,877474,74698
2391,84,713208,22200,803439,879145,75706
2392,84,713250,22650,803776,880845,77069
2393,89,713289,21550,803939,882395,78456
2394,87,713588,21450,804650,883824,79174
2395,89,713663,23350,804876,885695,80819
2396,85,714237,24500,806091,886745,80654
2397,87,714352,26400,806376,887295,80919
2398,81,714581,24300,807289,889124,81835
2399,89,714784,26050,807800,891274,83474
2400,84,715171,25800,809626,893374,83748
2401,81,715203,19800,809791,894524,84733
2402,83,715566,20800,810376,895524,85148
2403,83,716016,22150,811050,896295,85245
2404,90,716328,23400,811226,898174,86948
2405,88,717053,26000,812200,899245,87045
2406,82,717116,21650,812141,867415,55274
2407,81,717326,24300,812641,868415,55774
2408,85,717501,21800,813191,870281,57090
2409,87,718542,24600,814126,871881,57755
2410,82,718988,18950,814726,873031,58305
2411,80,719577,20200,815450,874015,58565
2414,88,719671,23600,817000,874231,57231
2413,82,719671,24350,817389,875931,58542
2414,88,719671,25950,817476,877765,60289
2415,83,719767,24850,817889,879681,61792
2416,90,719814,27450,817976,881431,63455
2417,89,720164,24250,818476,882615,64139
2418,81,720526,20700,819439,883665,64226
2419,80,720676,19300,819750,884231,64481
2420,83,721010,23500,820026,885231,65205
2421,86,721617,20050,820739,886165,65426
2422,80,721943,20650,820541,887265,66724
2423,85,722186,23600,821541,888515,66974
2424,89,722442,21550,822276,889715,67439
2426,81,722598,26350,823276,891815,68539
2426,81,722598,22900,823291,892981,69690
2427,81,722720,20700,824050,894615,70565
2428,84,722890,24900,825139,895781,70642
2430,88,722899,24300,824926,897315,72389
2430,88,722899,25050,824976,897531,72555
2431,90,722997,26100,824650,900265,75615
2432,84,723557,23550,826441,902415,75974
2433,84,723649,24450,826800,904065,77265
2434,84,723735,23550,826476,905665,79189
2435,90,725002,25200,828026,906931,78905
2436,87,725057,22800,827850,908431,80581
2437,80,725173,25150,828239,910265,82026
2438,86,726075,20500,828739,911065,82326
2439,82,726255,25700,829839,914031,84192
2440,82,726321,23900,829950,915181,85231
2441,89,727281,26500,820558,916681,96123
2442,86,727394,22750,820048,917831,97783
2443,84,727515,24450,820548,919331,98783
2444,82,728235,15800,817227,920915,103688
2445,87,728437,26850,818041,922631,104590
2446,87,728460,22800,818110,924181,106071
2447,87,728994,23250,818727,844528,25801
2448,80,729166,24700,819160,846496,27336
2449,87,730089,25500,820227,848096,27869
2450,82,730293,21650,820360,849096,28736
2451,89,731224,25150,821577,851496,29919
2452,81,731275,22950,822841,854096,31255
2453,83,731345,21250,823227,855728,32501
2454,87,731409,24600,823841,857296,33455
2455,84,731504,23100,824360,858578,34218
2456,88,731623,22850,824277,859178,34901
2457,88,731966,27800,824801,860546,35745
2458,83,732254,20800,825660,861878,36218
2459,86,732395,20050,825910,863046,37136
2460,87,732430,24600,826191,864628,38437
2461,80,732861,25150,827277,866228,38951
2462,88,732890,23750,827510,867396,39886
2463,82,733809,22100,829101,869096,39995
2464,82,733936,24350,829610,871778,42168
2465,84,734015,24000,829827,872496,42669
2466,89,734235,26050,830427,874096,43669
2467,85,734374,21350,830627,875428,44801
2468,85,734672,25850,831291,876428,45137
2469,80,734984,21550,832677,877346,44669
2470,89,735017,27400,832727,878096,45369
2471,81,735228,21150,833401,879628,46227
2472,89,735293,27400,833760,881896,48136
2473,88,735321,21950,833527,882496,48969
2474,86,735750,21850,834501,884078,49577
2475,86,736536,20500,834910,885178,50268
2476,81,736693,21600,835327,886828,51501
2477,83,736838,20350,835601,888896,53295
2478,87,736955,22800,835827,890228,54401
2479,85,737330,25400,836391,891046,54655
2480,86,737768,22300,837301,892628,55327
2481,84,737871,22200,837677,893896,56219
2482,81,737871,22500,837910,895496,57586
2483,85,737921,21350,837941,896578,58637
2484,83,738397,24850,838941,898178,59237
2485,83,738568,26200,839027,900278,61251
2486,87,739222,25950,841377,902046,60669
2487,88,739236,26900,841227,903146,61919
2488,87,739311,26850,841041,877233,36192
2489,87,739628,22350,842377,878783,36406
2490,90,739798,29700,842701,880833,38132
2491,82,739911,23450,842877,881333,38456
2492,85,740021,23150,842210,882898,40688
2493,82,740193,20750,840984,884648,43664
2494,90,740225,26100,841290,885733,44443
2495,81,740659,22500,843541,886948,43407
2496,81,740758,23400,844041,889083,45042
2497,85,740920,26750,845484,890698,45214
2498,89,741314,23350,847534,891848,44314
2499,88,741725,26450,849341,892283,42942
2500,82,742483,25250,853234,854460,1226
2501,86,742567,21400,854234,855060,826
2502,90,742676,29250,855284,857288,2004
2504,80,743230,26550,857841,857888,47
2504,80,743230,22850,858341,858760,419
2505,87,743507,25050,861084,859910,-1174
2506,81,743541,19350,861441,861138,-303
2507,86,743668,26350,863541,863788,247
2508,84,743688,22650,863234,865010,1776
2509,87,744017,23700,865434,867588,2154
2510,84,745010,20850,869191,869910,719
2511,86,745122,24100,870291,871838,1547
2513,81,745169,21350,872184,872838,654
2513,81,745169,19750,873834,874160,326
2514,83,745263,21700,874641,874738,97
2515,86,745338,23650,874834,845281,-29553
2516,88,745364,26900,874791,847706,-27085
2518,82,746008,25850,878484,849431,-29053
2518,82,746008,25200,878841,850224,-28617
2519,81,746430,25650,881591,850831,-30760
2520,83,746495,22150,882134,851614,-30520
2521,90,746672,26100,882634,852774,-29860
2522,87,747462,26850,885191,853824,-31367
2523,85,747973,24500,890184,854226,-35958
2524,90,748017,26100,890491,852056,-38435
2526,82,748083,22350,891584,853631,-37953
2527,85,748186,23000,891191,854524,-36667
2527,85,748186,21300,892134,854814,-37320
2528,87,748406,22800,893991,855756,-38235
2529,90,748496,24300,894641,856881,-37760
2530,87,748764,23250,895934,835572,-60362
2531,83,748948,25300,897341,835905,-61436
2532,84,749050,22200,897841,836572,-61269
2533,87,749385,25500,899391,837454,-61937
2534,88,750635,23750,901034,838005,-63029
2535,82,750963,18950,902691,838760,-63931
2536,82,751789,24800,902784,839260,-63524
2537,84,752141,23100,904341,839944,-64397
2538,85,753120,20000,905934,840494,-65440
2539,81,753221,19350,906134,841194,-64940
2540,90,754281,27900,908691,841755,-66936
2541,81,754996,21600,909384,842272,-67112
2542,89,755639,24700,910934,842755,-68179
2543,84,756525,26250,911434,843322,-68112
2544,90,757061,24750,860000,843460,-16540
2545,87,757678,24600,861550,843822,-17728
2546,89,758902,25150,863137,844604,-18533
2547,82,759513,24800,866687,845060,-21627
2548,89,759554,24250,866950,846204,-20746
2549,80,760352,22000,868637,846704,-21933
2550,80,760372,22000,868650,847204,-21446
2551,85,760583,21350,869187,847854,-21333
2552,81,762079,19800,870487,848244,-22243
2553,86,762099,20500,871487,848844,-22643
2554,90,762602,27900,874750,849504,-25246
2555,88,762765,21500,875250,849810,-25440
2556,86,763132,24550,880050,850810,-29240
2557,86,763270,24550,881887,851194,-30693
2559,85,763313,25250,882387,852194,-30193
2559,85,763313,24900,882937,852955,-29982
2561,88,763764,27350,885637,853510,-32127
2561,88,763764,22800,885800,854055,-31745
2562,85,763861,21800,886187,854544,-31643
2563,87,764692,23250,888887,855160,-33727
2564,90,765003,25650,891250,855705,-35545
2565,89,765080,25150,891187,856660,-34527
2566,87,765671,22350,892687,856805,-35882
2567,88,765864,22400,894387,857072,-37315
2569,89,766056,24550,897187,857444,-39743
2569,89,766056,23300,897200,857810,-39390
2570,85,766147,25850,897850,858605,-39245
2571,81,766410,20250,900437,858994,-41443
2572,88,766477,22850,900450,842471,-57979
2573,89,766840,27400,903037,843323,-59714
2574,80,767666,21550,907487,843973,-63514
2576,84,767701,23100,908537,844306,-64231
2576,84,767701,23050,907600,844926,-62674
2577,86,767867,23650,909637,845313,-64324
2578,82,768241,22100,911050,845564,-65486
2579,81,768812,21150,911550,846064,-65486
2580,80,769736,17950,913300,846863,-66437
2581,80,769795,20200,913787,847329,-66458
2582,83,769875,25300,914887,847929,-66958
2583,86,770105,23650,916987,848624,-68363
2584,81,770298,20250,918037,849123,-68914
2585,83,770776,22600,919787,849624,-70163
2586,84,771272,19500,921437,849823,-71614
2587,90,771283,23400,921400,850371,-71029
2588,88,771896,24650,923050,850456,-72594
2589,85,772561,24050,924150,851445,-72705
2590,86,773383,23650,927450,851706,-75744
2591,87,773389,22800,927987,852471,-75516
2592,90,774422,25650,932350,853256,-79094
2593,89,774571,24250,934637,853571,-81066
2594,81,774649,24300,937837,854071,-83766
2596,83,774700,24300,937150,854571,-82579
2596,83,774700,23000,937800,855350,-82450
2597,89,774950,27400,938850,855973,-82877
2598,81,775415,25650,943400,856973,-86427
2599,80,775433,23350,942850,857345,-85505
2600,88,775557,23300,943900,858156,-85744
2601,81,775989,18000,944700,858656,-86044
2602,83,776566,23950,946300,859171,-87129
2603,85,777220,23600,947900,860550,-87350
2604,81,777794,20250,892697,861100,-31597
2605,89,778121,25150,894471,861795,-32676
2606,82,778576,23000,895397,862023,-33374
2607,90,778914,21150,897971,862506,-35465
2608,80,779085,23800,901347,863821,-37526
2609,85,779227,22700,903397,864495,-38902
2610,89,779298,21100,902397,864995,-37402
2611,88,779499,26000,904497,866023,-38474
2612,83,780195,25300,907471,866995,-40476
2613,80,780413,22450,907697,867471,-40226
2614,90,780692,24300,910271,868045,-42226
2615,84,780956,25800,911421,869006,-42415
2616,84,781354,23550,913097,869200,-43897
2617,89,782629,25150,914097,870106,-43991
2618,83,782647,23950,914321,871145,-43176
2619,85,782846,20900,917021,871673,-45348
2620,85,782917,24500,917347,872173,-45174
2621,80,783246,26500,921921,872806,-49115
2622,84,783293,25350,921097,873306,-47791
2623,90,783365,25200,922021,874071,-47950
2624,90,783650,27450,924521,875071,-49450
2625,83,784179,17200,925947,875373,-50574
2626,81,784557,20250,928597,875745,-52852
2627,80,784557,21100,928371,875923,-52448
2628,84,785319,26250,930371,876650,-53721
2629,90,785539,24300,931747,877706,-54041
2630,82,786081,21200,932671,878495,-54176
2631,84,787184,19500,933521,878850,-54671
2632,89,787532,19750,935321,879350,-55971
2633,84,787611,25800,935597,879900,-55697
2634,85,788801,25850,938621,880950,-57671
2635,82,788975,22100,939621,881623,-57998
2636,80,789457,23800,940671,882245,-58426
2637,84,789587,25800,940247,883556,-56691
2638,88,789907,23300,895976,883850,-12126
2639,89,790266,21100,897091,884656,-12435
2640,90,791135,27000,900191,885400,-14791
2641,83,791164,22150,900076,885900,-14176
2642,89,791680,25600,900341,886521,-13820
2643,80,791914,23800,902376,887121,-15255
2644,84,792156,22650,902876,887645,-15231
2646,80,792718,24750,906291,888245,-18046
2646,80,792718,21500,906791,888450,-18341
2647,86,792959,25000,907891,889023,-18868
2648,88,793718,23750,911091,889871,-21220
2649,84,793789,21750,911376,890550,-20826
2650,86,794012,26350,913191,891371,-21820
2651,82,794282,25250,912926,891806,-21120
2652,81,794344,20250,908858,892223,-16635
2653,83,795410,21700,911501,892856,-18645
2654,86,796472,23200,913808,893200,-20608
2656,80,796564,25150,915501,893545,-21956
2656,80,796564,20600,916358,894321,-22037
2657,82,796773,20750,918251,894821,-23430
2658,86,796852,22750,918658,895300,-23358
2659,86,797136,23650,919351,895321,-24030
2660,87,797185,23700,920951,887910,-33041
2661,86,797267,22750,921501,888607,-32894
2662,86,797595,22300,923751,888910,-34841
2663,85,798167,24500,924751,889794,-34957
2664,89,798690,22000,884239,890454,6215
2665,80,798702,22000,884500,891757,7257
2666,86,799115,28600,887734,892374,4640
2667,82,799166,22100,887561,892810,5249
2668,86,799812,20050,888611,893204,4593
2669,81,800242,19800,889734,893644,3910
2670,88,800890,22850,893411,893410,-1
2671,83,800959,22600,895011,894144,-867
2672,86,801207,26350,897061,894644,-2417
2673,83,801292,20350,897484,895107,-2377
2674,82,801750,19850,899734,895574,-4160
2675,90,802148,23850,902584,896360,-6224
2676,90,802220,22950,902611,897010,-5601
2677,85,803347,24950,903734,898157,-5577
2678,86,804006,23200,907784,898494,-9290
2679,81,804061,21600,907211,899094,-8117
2680,82,804820,18050,910311,899310,-11001
2681,84,804910,23550,912584,899810,-12774
2682,84,804917,24000,912361,900774,-11587
2683,86,805630,21850,913911,901094,-12817
2684,84,805798,18600,913884,901594,-12290
2686,80,805992,23100,914534,901960,-12574
2686,80,805992,18800,914911,902407,-12504
2687,86,806096,22300,895614,902907,7293
2688,80,806236,22900,896664,902674,6010
2689,81,806440,22050,897664,903674,6010
2690,80,806817,21100,900377,903904,3527
2691,84,807095,22200,903314,904457,1143
2692,81,807135,22050,905414,905274,-140
2693,89,807234,23350,905027,905554,527
2694,82,807282,25250,907077,906044,-1033
2695,85,807495,21800,908014,907154,-860
2696,82,807953,21200,909327,907644,-1683
2697,90,808552,22950,910364,908204,-2160
2698,87,808936,22350,912164,908457,-3707
2699,82,808970,23000,912377,908794,-3583
2700,81,810998,23850,915327,909254,-6073
2701,83,811034,23950,915464,909960,-5504
2702,87,811229,22350,916464,910404,-6060
2703,80,811959,24250,919077,911157,-7920
2704,89,812023,27400,919814,912124,-7690
2705,83,812332,20800,921414,912510,-8904
2706,82,812716,19400,923064,913004,-10060
2707,81,812929,19350,926814,913274,-13540
2709,85,813114,25600,928327,913704,-14623
2710,89,813163,21800,928827,914007,-14820
2710,89,813163,24650,929464,914594,-14870
2711,84,813408,22650,931064,915194,-15870
2712,88,813628,22400,932464,915707,-16757
2713,87,813774,25950,933514,916307,-17207
2714,81,814235,22050,935214,916704,-18510
2715,80,814370,25600,935927,917074,-18853
2716,81,814583,20250,938077,917444,-20633
2717,88,814734,26900,940064,918574,-21490
2718,88,814824,24200,940577,919507,-21070
2719,87,816603,24600,943164,920094,-23070
2720,89,816883,26500,944277,920607,-23670
2721,88,817287,24200,945327,920954,-24373
2722,81,818097,23400,946827,921410,-25417
2723,82,818585,22550,950027,921707,-28320
2724,88,818633,25550,949877,922604,-27273
2725,85,818672,19550,951264,923474,-27790
2726,86,818832,21850,953477,923974,-29503
2727,80,818940,22000,954464,925362,-29102
2729,89,820153,24850,957327,926912,-30415
2729,89,820153,24200,957664,928912,-28752
2730,90,820440,24750,958164,929612,-28552
2731,84,820833,22200,961864,931112,-30752
2732,85,820865,23600,962914,932238,-30676
2733,83,820926,19900,963727,933838,-29889
2734,84,821091,20850,963827,935038,-28789
2735,83,821237,25300,964114,937212,-26902
2736,88,821312,21500,965364,938338,-27026
2737,87,821664,20100,968177,939538,-28639
2738,88,821844,23750,970427,941088,-29339
2739,82,821959,25700,972227,943738,-28489
2740,83,821993,22600,972727,945338,-27389
2741,80,822100,19750,973264,945838,-27426
2742,82,822159,22100,973764,947038,-26726
2743,85,822521,24500,976877,948588,-28289
2744,82,822696,23900,977477,949238,-28239
2745,81,822706,23850,978014,950662,-27352
2746,85,823013,23600,979614,951988,-27626
2747,84,823378,23100,981714,953012,-28702
2748,90,823693,23400,983477,955112,-28365
2749,88,823958,18800,985977,956612,-29365
2750,86,824084,23650,989077,959362,-29715
2751,82,824113,23450,989577,961038,-28539
2752,82,824502,20750,991014,962062,-28952
2753,82,825042,23450,993914,964062,-29852
2754,86,825084,23200,994027,965612,-28415
2755,84,825268,22200,996327,967738,-28589
2756,88,825373,25100,997714,969388,-28326
2757,87,825500,24600,997870,970438,-27432
2758,90,825978,23400,998370,971538,-26832
2759,88,826489,24650,999283,973288,-25995
2761,80,826837,20800,999557,974912,-24645
2761,80,826837,17000,999383,975338,-24045
2762,82,827898,22050,999883,977362,-22521
2763,90,827944,26050,999864,978362,-21502
2764,81,828204,19950,999985,980462,-19523
2765,86,828404,22150,999935,981238,-18697
2766,81,829348,20700,920193,982238,62045
2767,83,829611,25750,921278,983162,61884
2768,88,829755,24200,922226,984638,62412
2769,83,829988,19900,922828,985162,62334
2770,85,830025,21800,922493,987238,64745
2771,86,830379,27250,924378,988912,64534
2772,80,830507,19300,924500,989988,65488
2773,81,830560,26100,925193,992162,66969
2775,85,831481,23050,926078,993212,67134
2775,85,831481,25800,926293,994788,68495
2776,85,831715,20900,926550,994912,68362
2777,90,832045,24750,927293,996388,69095
2778,80,832457,21100,928189,998688,70499
2779,87,832608,24150,928676,999862,71186
2780,81,833078,22050,929226,923195,-6031
2781,82,833218,25250,929828,924295,-5533
2782,84,833489,21300,930476,926275,-4201
2783,80,833644,18850,930639,927025,-3614
2784,90,833799,29700,931139,929125,-2014
2785,89,834287,22450,931576,931175,-401
2786,87,834875,22800,932076,932275,199
2787,81,835175,23400,932150,934425,2275
2788,87,835538,23250,933126,935225,2099
2789,82,835590,21650,933626,936195,2569
2790,88,835658,20600,934339,936775,2436
2791,89,835785,25150,934839,939275,4436
2792,82,836162,27050,936028,940495,4467
2793,83,837064,21700,936950,941095,4145
2794,85,837322,22700,937500,941975,4475
2795,82,837736,24350,937728,944575,6847
2796,89,837887,22000,938143,946995,8852
2797,80,838355,22450,939478,947545,8067
2798,85,838395,23600,939150,949645,10495
2799,89,838461,25150,939626,951125,11499
2800,89,839788,22900,940393,952895,12502
2801,80,841462,21100,940943,955445,14502
2802,86,841580,25900,941493,957095,15602
2803,87,841662,25500,941450,959245,17795
2804,83,842254,25750,942043,960625,18582
2805,80,842626,18400,942289,961175,18886
2806,88,842795,26000,943050,962525,19475
2807,87,843356,24600,945550,963575,18025
2808,84,843356,20400,945328,964695,19367
2809,83,843584,19450,945739,966025,20286
2810,82,844919,20750,946293,967345,21052
2811,89,846300,25600,947439,968475,21036
2812,81,846332,18900,947493,970095,22602
2813,85,846579,24050,947939,972245,24306
2814,83,847114,22150,948728,974845,26117
2815,89,847633,25150,949926,976445,26519
2817,90,847792,26050,950039,977625,27586
2817,90,847792,21100,950100,979695,29595
2818,83,848206,23500,950928,958883,7955
2819,84,848514,21300,952250,961983,9733
2821,86,848666,24050,952800,963033,10233
2821,86,848666,23150,952678,964351,11673
2824,85,848811,26800,952343,965833,13490
2823,89,848807,19750,951628,966651,15023
2824,85,848811,19950,952843,967901,15058
2825,87,848907,23700,953178,969833,16655
2826,80,849556,22000,940491,970741,30250
2827,80,850574,20650,941041,971147,30106
2828,85,851232,23150,942181,971728,29547
2829,84,851292,26250,942527,972347,29820
2830,81,851711,22500,943210,972817,29607
2831,81,851926,22500,943551,974367,30816
2832,82,852394,24350,944277,976040,31763
2833,82,852524,23900,944431,976540,32109
2834,84,853049,22650,945101,978017,32916
2835,89,853159,21550,945260,979390,34130
2836,89,853704,23800,945760,981890,36130
2837,82,854272,20300,946227,982867,36640
2839,85,855218,22950,947892,984040,36148
2839,85,855218,20850,947881,985640,37759
2840,89,855680,23350,950081,986767,36686
2841,82,855898,20750,950681,988390,37709
2842,90,855976,26100,952231,989390,37159
2843,81,856315,23400,954631,990990,36359
2844,85,856418,24050,955442,991917,36475
2845,89,856871,25150,957781,994140,36359
2846,85,856982,21800,958742,996667,37925
2847,88,857509,22850,961531,997690,36159
2848,90,858599,27000,963142,999817,36675
2849,85,858850,25400,965281,999867,34586
2850,87,859086,29100,968842,977933,9091
2851,83,859096,24850,968342,980501,12159
2852,86,859462,24550,969731,982033,12302
2853,85,860331,26750,956541,983683,27142
2854,82,860511,24350,956731,985751,29020
2855,81,861329,25650,958710,986401,27691
2856,83,861377,24400,958331,987901,29570
2857,82,861518,21200,958831,988983,30152
2858,81,862012,20700,959041,990901,31860
2859,81,862332,18450,949884,991451,41567
2860,82,862548,22550,950681,994083,43402
2861,80,862675,26050,951731,996233,44502
2862,90,862925,21600,951801,996983,45182
2863,80,863017,26950,952339,997083,44744
2864,87,863070,27300,952801,999551,46750
2865,82,863528,25250,954389,999733,45344
2866,82,863562,20300,954439,999095,44656
2867,82,863796,20300,955089,999426,44337
2868,87,863809,21900,955451,999995,44544
2869,90,864350,25650,956581,988945,32364
2871,84,864551,25700,957734,989630,31896
2872,85,864604,24000,958014,990417,32403
2872,85,864604,23100,958514,991073,32559
2873,86,864768,20050,958884,991717,32833
2874,86,864864,22750,959434,992130,32696
2875,89,865011,25150,959831,992673,32842
2876,81,865412,21600,964437,993173,28736
2877,90,865445,26100,963387,993417,30030
2878,84,865503,24900,964511,994223,29712
2879,82,866002,25700,968187,994773,26586
2881,82,866140,24450,969861,995430,25569
2881,82,866140,23850,970787,995795,25008
2882,88,866282,27350,970861,996430,25569
2883,85,866869,26300,972461,997480,25019
2884,90,867256,24750,974887,998345,23458
2885,82,868593,23900,976937,998973,22036
2886,87,868696,26850,977987,999630,21643
2887,87,869070,23250,979511,999973,20462
2888,80,869165,22450,981072,952564,-28508
2889,90,869329,25200,982189,952878,-29311
2890,90,869457,21150,982003,953315,-28688
2891,82,869457,25250,982122,954126,-27996
2892,89,869798,25150,982739,954764,-27975
2893,82,870212,23000,983272,955233,-28039
2894,87,870511,22800,983672,955733,-27939
2895,90,871423,22500,984389,955964,-28425
2896,81,871760,24750,985944,977367,-8577
2897,82,872060,23450,988034,978967,-9067
2898,85,872226,23150,989544,980081,-9463
2899,89,873173,26050,990684,982381,-8303
2900,89,873748,24700,991834,985017,-6817
2901,87,874087,26850,993534,986831,-6703
2902,90,874294,22950,997044,988267,-8777
2904,81,874535,23350,999694,990281,-9413
2904,81,874535,22450,998044,991817,-6227
2905,81,874589,24700,999034,993681,-5353
2906,86,874663,24800,999594,995181,-4413
2908,87,875308,21050,993053,996881,3828
2908,87,875308,19250,993931,998981,5050
2909,85,875349,12750,994422,999767,5345
2910,86,875500,14750,994522,964665,-29857
2911,90,875657,21250,994931,965264,-29667
2912,83,876171,20450,995931,965814,-30117
2914,85,876377,21000,996503,966276,-30227
2914,85,876377,23150,996522,966978,-29544
2915,81,876518,19750,996531,967233,-29298
2916,86,877691,26450,984251,967733,-16518
2918,82,878007,16950,985037,968128,-16909
2918,82,878007,18350,985461,968628,-16833
2919,84,878594,18900,986561,968924,-17637
2920,83,879407,19800,988111,969654,-18457
2921,87,879826,17050,989600,970254,-19346
2922,84,880022,22200,990100,970546,-19554
2923,90,880629,19400,992750,971146,-21604
2924,81,880715,17550,993987,971574,-22413
2925,80,880900,20850,995190,972124,-23066
2926,86,881104,21100,997890,972804,-25086
2927,85,881166,18550,997990,973246,-24744
2928,81,881310,23500,998800,973765,-25035
2929,84,881535,18350,999840,974664,-25176
2931,80,881954,20150,999950,975276,-24674
2931,80,881954,13400,999900,975664,-24236
2932,87,882388,16500,999772,975928,-23844
2933,86,882475,14600,999931,976428,-23503
2934,87,883020,16100,999981,976978,-23003
2935,87,883160,13950,999991,977376,-22615
2936,84,883437,21300,997537,977983,-19554
2937,90,884311,25550,999337,978864,-20473
2938,89,884406,21050,999861,979483,-20378
2939,87,885983,20800,999861,979983,-19878
2940,81,886190,15350,999911,980583,-19328
2941,82,887001,12100,974092,981215,7123
2942,83,887133,14900,974241,981715,7474
2943,87,887377,19350,974972,982278,7306
2944,81,887556,13750,975335,982883,7548
2945,84,887735,19400,975525,983314,7789
2947,90,888501,16450,976935,982574,5639
2947,90,888501,20050,977391,983074,5683
2948,80,888755,14450,977592,983454,5862
2949,89,888918,18300,977722,984007,6285
2950,81,889201,14500,978142,984860,6718
2951,81,889575,20350,979491,985657,6166
2952,87,889644,21450,979675,986474,6799
2953,85,890147,17550,980091,986960,6869
2955,80,890450,19200,981385,987496,6111
2955,80,890450,18100,981422,987704,6282
2956,87,890745,26950,981891,988596,6705
2957,83,891194,22050,983142,989107,5965
2958,87,891356,17450,983425,989696,6271
2959,81,891739,20400,983922,990254,6332
2960,84,891938,19850,984841,990957,6116
2961,90,892155,21950,985692,991457,5765
2962,82,892219,19850,986025,991804,5779
2963,86,892618,20250,986685,992304,5619
2965,81,892903,22150,987441,993424,5983
2965,81,892903,20400,987622,994210,6588
2966,90,893268,22750,988672,994796,6124
2967,90,893831,21950,989591,995360,5769
2968,86,893891,20850,989625,996360,6735
2969,80,894263,17550,990741,997004,6263
2970,86,894364,22150,991725,997360,5635
2971,89,894482,18750,992241,997910,5669
2972,84,894603,19500,992225,998757,6532
2973,88,895081,19050,994235,999346,5111
2974,87,895107,16400,994322,999454,5132
2975,81,895201,21600,995235,999857,4622
2976,87,895237,18700,995341,999907,4566
2977,82,895531,20850,995891,973595,-22296
2978,80,896041,17650,996672,973971,-22701
2979,90,896290,21050,997722,974658,-23064
2980,81,896371,20200,998435,975345,-23090
2981,90,896641,21850,999041,975873,-23168
2982,87,897133,25600,999875,976395,-23480
2983,81,897523,16250,999822,976752,-23070
2984,82,898752,19500,999972,977373,-22599
2985,87,898995,14700,992171,977902,-14269
2986,88,899135,19650,993649,979531,-14118
2987,87,899578,20450,995299,981731,-13568
2988,86,899768,16300,996349,983331,-13018
2989,83,900108,16650,999053,984761,-14292
2990,86,900129,19950,998714,986311,-12403
2991,82,900535,16100,999314,987081,-12233
2992,85,900804,15450,999914,988731,-11183
2993,83,901478,11950,999834,989231,-10603
3019,89,908500,14350,998649,991311,-7338
3019,89,908500,16100,998521,992361,-6160
3019,89,908500,13450,998571,993781,-4790
3019,89,908500,11650,999071,994161,-4910
3019,89,908500,14750,999149,995331,-3818
3019,89,908500,12600,999121,997981,-1140
3019,89,908500,19050,999171,999681,510
3019,89,908500,14500,999649,999881,232
3019,89,908500,12250,999221,986502,-12719
3020,88,908948,15600,999721,987021,-12700
3020,88,908948,16050,999771,987802,-11969
3048,85,915221,14250,980578,988408,7830
3047,83,915189,13150,981321,989395,8074
3048,85,915221,17300,981821,989945,8124
3046,83,915114,13750,982542,990321,7779
3047,83,915189,17500,983278,990871,7593
3046,83,915114,17800,984242,991371,7129
3048,85,915221,17150,984715,992421,7706
3048,85,915221,18450,985842,992971,7129
3047,83,915189,18500,986365,993295,6930
3046,83,915114,18450,986421,993845,7424
3048,85,915221,15950,987142,994121,6979
3046,83,915114,20450,987642,994508,6866
3047,83,915189,20950,988878,995145,6267
3048,85,915221,14350,989292,995423,6131
3047,83,915189,16550,989478,995821,6343
3047,83,915189,16550,989871,995995,6124
3048,85,915221,20400,990642,996723,6081
3049,82,915733,15100,991192,997208,6016
3050,90,915757,15900,991292,998223,6931
3050,90,915757,19550,992292,998858,6566
3050,90,915757,16800,993621,999021,5400
3049,82,915733,16350,994292,999052,4760
3050,90,915757,20050,993942,999621,5679
3050,90,915757,21650,994021,999695,5674
3049,82,915733,18750,994928,992928,-2000
3050,90,915757,17450,994542,993705,-837
3049,82,915733,18400,995928,994345,-1583
3049,82,915733,19550,996128,995345,-783
3050,90,915757,20600,996565,997445,880
3050,90,915757,19950,997065,998728,1663
3050,90,915757,21600,997092,999828,2736
3049,82,915733,18800,997642,995956,-1686
3050,90,915757,20950,998692,996828,-1864
3050,90,915757,22800,998828,997205,-1623
3049,82,915733,22400,999192,998041,-1151
3049,82,915733,20400,999971,998656,-1315
3049,82,915733,19550,998826,999528,702
3049,82,915733,18250,999692,999891,199
3049,82,915733,21900,999891,999905,14
3049,82,915733,17200,999993,997198,-2795
3050,90,915757,16350,999700,997837,-1863
3050,90,915757,16150,994770,998399,3629
3049,82,915733,14450,995861,999084,3223
3049,82,915733,13150,995848,999634,3786
3049,82,915733,15050,996961,999837,2876
3051,83,916183,15300,997370,999937,2567
3051,83,916183,15550,998098,990397,-7701
3052,82,917208,18400,999011,990851,-8160
3053,90,917213,18750,999720,991451,-8269
3054,80,917768,15900,999981,991878,-8103
3055,84,918401,12500,999997,992201,-7796
3056,83,919480,14050,969241,992751,23510
3058,83,920378,12500,969853,993301,23448
3058,83,920378,16000,970410,993851,23441
3059,88,921094,11950,972817,994398,21581
3060,85,921180,13850,972910,994901,21991
3061,82,921184,13950,974817,995501,20684
3062,83,921216,12850,974910,996151,21241
3063,86,921664,12700,976967,997148,20181
3065,90,922388,12600,981710,997648,15938
3065,90,922388,13850,982167,998198,16031
3066,82,922440,12000,982410,998701,16291
3067,85,922923,11400,985367,999578,14211
3068,88,922993,8800,986717,999898,13181
3069,81,923161,12200,991367,999951,8584
3070,82,923182,10650,986260,995423,9163
3072,82,923315,10050,992110,995800,3690
3072,82,923315,10350,995117,996043,926
3073,90,923331,12850,994760,996073,1313
3074,89,923408,16200,995617,996853,1236
3076,84,923594,17750,997610,997461,-149
3076,84,923594,14200,997217,997961,744
3077,81,924088,14850,999817,998381,-1436
3078,85,924245,12500,999767,998984,-783
3079,88,924349,9950,999867,999981,114
3080,87,924665,10700,996017,998015,1998
3081,84,925733,10900,997824,998515,691
3082,86,925966,8150,997874,999514,1640
3083,85,926032,14900,999717,999933,216
3084,84,926085,11350,999374,999726,352
3085,87,926245,11750,999874,986799,-13075
3086,90,926278,9200,998845,986367,-12478
3087,84,926435,7000,999624,986867,-12757
3088,80,926441,5150,999895,986849,-13046
3129,87,935746,7050,990577,988349,-2228
3130,90,936497,7500,990131,987349,-2782
3130,90,936497,5800,991127,989499,-1628
3130,90,936497,3550,991931,989999,-1932
3130,90,936497,9000,992431,989617,-2814
3130,90,936497,8400,993481,988417,-5064
3130,90,936497,6400,993791,988849,-4942
3130,90,936497,4800,994327,989667,-4660
3130,90,936497,9100,995360,988467,-6893
3130,90,936497,12300,995753,990167,-5586
3130,90,936497,9650,996581,990049,-6532
3130,90,936497,5800,997181,988967,-8214
3130,90,936497,7300,997560,988899,-8661
3130,90,936497,6700,997681,988949,-8732
3131,83,936913,10050,998207,990549,-7658
3131,83,936913,11700,999933,990217,-9716
3131,83,936913,6600,999983,992817,-7166
3131,83,936913,2900,999881,991910,-7971
3131,83,936913,4450,999641,993610,-6031
3131,83,936913,4650,984136,994660,10524
3131,83,936913,3300,984186,996860,12674
3131,83,936913,3250,985486,997624,12138
3132,85,937398,2500,986626,998293,11667
3132,85,937398,3700,988786,998902,10116
3132,85,937398,3300,989376,999452,10076
3133,89,937415,3300,991636,999952,8316
3133,89,937415,1300,993186,999953,6767
3133,89,937415,5050,993686,993867,181
3132,85,937398,2200,996126,994367,-1759
3133,89,937415,4700,997626,995746,-1880
3133,89,937415,2900,999336,996833,-2503
3132,85,937398,7750,999876,999146,-730
3132,85,937398,4350,999376,999983,607
3132,85,937398,5600,999836,995967,-3869
3133,89,937415,3200,974992,991767,16775
3132,85,937398,1600,975492,995099,19607
3132,85,937398,3500,975492,995599,20107
3133,89,937415,4850,975542,996467,20925
3132,85,937398,1150,975542,995417,19875
3132,85,937398,4000,975592,995917,20325
3133,89,937415,2300,975592,991817,16225
3133,89,937415,3700,976577,995649,19072
3132,85,937398,2250,977777,996849,19072
3133,89,937415,3300,980360,996517,16157
3133,89,937415,3800,979977,995699,15722
3134,87,937807,7200,983177,992317,9140
3135,89,938015,7300,983777,992099,8322
3136,85,938777,5900,987560,992599,5039
3137,81,938865,6550,988560,995367,6807
3138,82,938930,6650,988627,995749,7122
3139,86,939443,5550,990210,996817,6607
3140,84,939518,5650,990710,996867,6157
3141,85,939980,5850,993760,996899,3139
3142,83,940105,6650,994260,995799,1539
3143,83,940652,5250,998977,996917,-2060
3145,85,940759,7350,999960,995849,-4111
3145,85,940759,3550,999910,996567,-3343
3146,83,941270,1950,998842,996617,-2225
3147,90,941312,5100,998792,996667,-2125
3148,84,941402,2100,999742,996717,-3025
3149,83,941463,1650,999942,997399,-2543
3150,89,941641,3250,999792,997499,-2293
3151,82,942079,2200,985378,999549,14171
3152,90,942229,3300,986543,999667,13124
3153,88,942462,2900,988743,998310,9567
3154,87,942640,3350,989728,998810,9082
3155,88,943948,3500,991543,999124,7581
3156,88,944191,200,991278,999310,8032
3157,86,944789,1100,992143,999624,7481
3158,90,945160,3850,993893,999772,5879
3159,87,945697,2250,995028,999360,4332
3160,88,946301,2800,996643,999860,3217
3161,88,946538,2550,997728,999674,1946
3162,83,947079,2300,998843,998260,-583
3163,88,947930,2100,999893,998624,-1269
3216,87,963793,50,982617,999724,17107
3216,87,963793,50,982667,999910,17243
3217,88,963908,500,983133,990644,7511
3217,88,963908,500,983167,990416,7249
3216,87,963793,50,983183,989366,6183
3217,88,963908,500,983667,990466,6799
3216,87,963793,500,983683,990966,7283
3217,88,963908,500,984167,991144,6977
3216,87,963793,50,983733,989866,6133
3217,88,963908,50,983783,991466,7683
3216,87,963793,500,984283,991866,7583
3216,87,963793,50,984217,993916,9699
3218,89,964136,500,984717,996066,11349
3216,87,963793,500,984783,996373,11590
3217,88,963908,500,985217,999073,13856
3217,88,963908,50,984833,999623,14790
3217,88,963908,50,984883,999966,15083
3217,88,963908,500,985383,997994,12611
3218,89,964136,500,985717,999094,13377
3217,88,963908,50,985433,999916,14483
3218,89,964136,50,985483,994311,8828
3218,89,964136,50,985533,997511,11978
3219,81,964423,500,986033,999411,13378
3219,81,964423,50,985767,999711,13944
3218,89,964136,500,986267,999961,13694
