job_id,tasks_num_of_single_job,task_generation_time,total_time,complation_time,complation_time_ordered,shortened_completion_time
0,88,389,41300,1391,1394,-3
1,85,939,40250,2942,2439,503
2,87,1396,39900,3438,3493,-55
3,88,1423,41750,3492,3541,-49
4,84,2524,39300,4526,4943,-417
5,87,2572,39900,5443,5543,-100
6,82,2635,36950,5046,6077,-1031
7,80,2851,37750,5944,7046,-1102
8,80,3415,36850,6578,6995,-417
9,80,4744,37750,8127,7946,181
10,85,4944,38900,7942,8946,-1004
11,86,5236,38500,8542,9729,-1187
12,90,5354,42300,9082,11579,-2497
13,85,5682,38450,9543,10698,-1155
14,84,6379,37050,10501,13098,-2597
15,81,6600,36900,11001,10994,7
16,87,7069,39450,11054,12093,-1039
17,90,7373,40500,11582,11630,-48
18,90,8168,43650,12529,12196,333
19,87,9410,39450,12680,14083,-1403
20,83,10437,37000,13594,16583,-2989
21,87,11018,39900,14082,14093,-11
22,89,11283,41800,14582,15594,-1012
23,86,12335,38950,15582,15751,-169
24,81,12776,36900,16692,15729,963
25,89,12917,38650,17100,16232,868
26,85,13011,40700,16785,17054,-269
27,84,15208,37950,18099,17753,346
28,82,16170,36500,18134,18196,-62
29,85,16873,38900,18684,19046,-362
30,83,17399,37000,19342,19198,144
31,88,18137,39500,19455,20159,-704
32,81,18915,37350,19958,20253,-295
33,90,19872,40500,21928,21872,56
34,80,19942,37750,22977,23425,-448
35,90,19976,41850,22925,23925,-1000
36,86,20110,39850,23873,23925,-52
37,80,20113,36850,23424,23946,-522
38,82,20734,37400,25377,24475,902
39,90,20861,41400,25929,26077,-148
40,83,22780,37450,26377,27077,-700
41,84,22985,37500,26877,31947,-5070
42,80,23179,36400,27996,28927,-931
43,84,23416,36600,28496,29426,-930
44,88,23449,40850,29477,29878,-401
45,89,23880,41350,30477,28551,1926
46,83,24375,37450,31531,30551,980
47,84,24782,36600,32131,30426,1705
48,88,24987,39500,30112,36059,-5947
49,86,25065,39400,30079,33027,-2948
50,81,25537,38250,32030,33623,-1593
51,82,25665,34700,32546,34199,-1653
52,87,26304,41700,33546,34698,-1152
53,88,26747,39500,34547,36023,-1476
54,80,27398,37750,36079,35130,949
55,84,27876,38400,37079,39428,-2349
56,83,27890,38800,37547,41148,-3601
57,80,27900,36400,36076,43698,-7622
58,87,28096,39900,37026,45478,-8452
59,87,28288,40800,38098,47298,-9200
60,82,28391,36950,38581,38098,483
61,80,28410,36400,38679,39426,-747
62,90,28504,41400,38729,40485,-1756
63,89,28644,39100,39972,42673,-2701
64,90,28760,41400,40577,47085,-6508
65,81,29089,36000,40646,48823,-8177
66,89,30347,39100,43146,50185,-7039
67,90,30654,40950,49633,51323,-1690
68,82,30660,36950,49696,52077,-2381
69,80,30685,35500,49697,43598,6099
70,83,31216,38350,51400,44120,7280
71,87,31314,40800,51633,47248,4385
72,83,31687,38800,51696,47352,4344
73,80,31743,35050,48537,45475,3062
74,83,32446,37450,51196,46085,5111
75,81,32698,38700,53196,47225,5971
76,85,33408,37550,47135,46027,1108
77,86,33477,38950,47635,46598,1037
78,87,33730,38550,47830,48229,-399
79,90,34614,41400,49191,48999,192
80,85,34729,38900,49226,50026,-800
81,81,34836,37800,47682,48304,-622
82,81,35255,37800,48479,48751,-272
83,81,35397,35550,49080,50148,-1068
84,85,36243,38450,49138,51181,-2043
85,82,39706,39200,50231,51999,-1768
86,84,40159,36600,51231,52499,-1268
87,85,43055,40250,51688,52650,-962
88,85,43311,39800,51583,52137,-554
89,82,43478,36950,53133,53131,2
90,82,45925,38300,53529,54080,-551
91,83,46328,36550,54183,54999,-816
92,81,47191,36900,55183,55499,-316
93,89,47968,41800,56902,56650,252
94,83,48037,36550,57183,57650,-467
95,85,48499,37550,57683,57734,-51
96,84,48906,37950,59739,57577,2162
97,85,48933,35300,58180,58002,178
98,85,48990,39800,59296,56301,2995
99,85,49022,39350,60296,58301,1995
100,85,51823,39800,59630,58683,947
101,90,52616,39600,61680,59630,2050
102,87,53088,40350,63134,60680,2454
103,82,53155,36950,63931,61681,2250
104,85,53336,38000,64433,62680,1753
105,85,53786,36650,62002,64150,-2148
106,84,54271,39750,62346,64181,-1835
107,83,54721,39700,62296,63081,-785
108,90,55606,40950,63551,64174,-623
109,86,55783,38500,63846,65002,-1156
110,86,56862,38950,64291,66056,-1765
111,82,56896,36050,63485,64851,-1366
112,87,57544,40800,64787,64652,135
113,86,57765,38050,65885,65232,653
114,88,60450,38150,66385,66652,-267
115,88,61258,41750,66983,66782,201
116,86,63430,39400,67552,68056,-504
117,82,63688,37850,68552,69152,-600
118,83,64037,37450,69290,69556,-266
119,87,64669,39000,69404,68432,972
120,90,66204,42300,69790,70432,-642
121,80,66873,35050,70404,70704,-300
122,81,68034,37800,70840,70556,284
123,90,69195,40950,71406,71181,225
124,85,69869,39350,72698,73199,-501
125,90,70050,39150,73748,74700,-952
126,81,70141,38250,73456,75474,-2018
127,86,70447,39400,74900,74760,140
128,87,70522,40800,75900,75106,794
129,86,70606,40300,75423,75873,-450
130,88,71037,37700,75703,75927,-224
131,85,71072,40250,75591,76373,-782
132,87,71505,38550,76423,76872,-449
133,89,71983,37750,77875,78752,-877
134,82,72261,36050,78675,79923,-1248
135,89,72632,41350,78254,82923,-4669
136,88,73573,39950,80374,84923,-4549
137,82,73851,37400,80874,80024,850
138,89,74659,39100,79693,80920,-1227
139,83,75078,38350,81350,79421,1929
140,82,75337,37850,82350,80924,1426
141,81,76150,37350,82948,83157,-209
142,88,76466,40400,86072,85873,199
143,84,77174,38850,83023,88157,-5134
144,88,77322,40850,83620,89157,-5537
145,89,77485,39100,84077,83526,551
146,86,77534,39400,84526,85803,-1277
147,85,78548,40250,87024,85979,1045
148,80,79196,35950,85477,87029,-1552
149,87,79635,38100,86031,88070,-2039
150,84,79789,36150,87076,86479,597
151,89,80515,38650,87829,89473,-1644
152,89,81138,40450,88627,92079,-3452
153,90,81346,40950,89308,92579,-3271
154,85,82332,38450,91122,89026,2096
155,81,83704,36900,92308,90353,1955
156,85,84438,38000,93808,91105,2703
157,81,84569,33750,91679,90981,698
158,85,85025,38900,91477,91620,-143
159,81,85363,35100,92233,92124,109
160,87,86300,39450,92733,92657,76
161,88,86506,39950,94177,93476,701
162,88,86647,40850,94580,94579,1
163,80,87839,36400,93726,95623,-1897
164,84,88310,37950,94711,97705,-2994
165,88,89172,40400,96211,99248,-3037
166,88,89691,41300,95628,100127,-4499
167,85,90025,37100,96253,100550,-4297
168,85,90084,38450,97803,98576,-773
169,87,90130,40800,98071,100576,-2505
170,82,90668,36500,98125,101676,-3551
171,89,90753,39100,98934,100024,-1090
172,85,90786,38450,99908,101526,-1618
173,81,91025,35550,100779,99681,1098
174,82,92353,37850,101332,100274,1058
175,84,93001,36600,102859,100826,2033
176,84,93015,37050,102878,101975,903
177,85,93275,39800,106579,102774,3805
178,83,94025,35200,102054,103876,-1822
179,85,94365,38450,102571,104876,-2305
180,86,95867,38050,103277,103130,147
181,90,96564,42750,104282,104052,230
182,86,96761,36700,103736,106384,-2648
183,83,97338,39250,104130,107384,-3254
184,84,97561,35700,105079,106333,-1254
185,83,98538,37450,105859,106726,-867
186,84,99155,37950,107781,105463,2318
187,81,100163,36900,106814,106579,235
188,88,100565,36800,106632,107333,-701
189,90,101267,40500,108832,108333,499
190,87,102330,39450,110234,109273,961
191,85,102743,40700,108827,109833,-1006
192,87,102943,39450,109282,110773,-1491
193,84,104436,38400,111930,111506,424
194,84,104525,38850,111877,112506,-629
195,86,104669,38050,112655,111178,1477
196,81,105025,37800,112932,112426,506
197,86,105099,38500,113281,112784,497
198,81,105819,37350,111742,113315,-1573
199,82,106416,38300,112378,115729,-3351
200,80,106819,34600,113782,117729,-3947
201,85,107499,40700,114534,116084,-1550
202,80,108982,36850,114283,118838,-4555
203,89,109101,41800,115564,120036,-4472
204,85,109122,37550,116875,120561,-3686
205,90,109601,43200,117877,121034,-3157
206,85,110318,39800,119377,117488,1889
207,90,110416,41850,119937,119284,653
208,81,110530,34650,117671,121784,-4113
209,85,110802,39350,118699,117428,1271
210,80,111143,37300,120481,123883,-3402
211,86,112092,39850,119932,124207,-4275
212,86,112272,36250,120036,121932,-1896
213,88,112720,40400,120437,123132,-2695
214,87,113173,39900,122482,124526,-2044
215,80,113195,35050,122927,125428,-2501
216,90,113472,39600,124257,125830,-1573
217,85,113928,37550,125257,126582,-1325
218,82,114660,38750,126027,127076,-1049
219,87,115066,38550,126937,126537,400
220,88,115453,41300,127937,127892,45
221,82,115588,37400,128027,129392,-1365
222,86,116104,38500,124980,132088,-7108
223,89,116211,40000,126719,132588,-5869
224,86,116246,37600,128062,129178,-1116
225,90,116405,37350,129883,130384,-501
226,82,116970,38300,129031,130582,-1551
227,80,117062,34600,129531,129488,43
228,82,118152,34700,129506,129586,-80
229,86,119472,40300,131901,128974,2927
230,80,119935,36400,133223,129474,3749
231,80,120177,36850,133971,130630,3341
232,88,121997,39500,134851,132025,2826
233,87,122233,41250,134006,132529,1477
234,82,122442,37850,136821,133880,2941
235,82,122460,35150,136506,134663,1843
236,86,123969,39850,136487,135663,824
237,86,124319,38950,136179,136228,-49
238,90,125081,41400,133031,134204,-1173
239,88,125758,40400,136588,135025,1563
240,83,126863,37000,145884,135680,10204
241,84,126958,38850,138588,136488,2100
242,82,127515,38300,136681,137988,-1307
243,90,127607,41400,136957,139138,-2181
244,85,128894,39350,137731,141136,-3405
245,80,129815,35050,138231,141716,-3485
246,82,130074,37850,139231,141888,-2657
247,87,130404,38100,140681,140186,495
248,81,131273,36000,141731,141380,351
249,80,132299,38200,144057,142728,1329
250,85,132321,38900,144181,143880,301
251,84,133087,35700,144731,144844,-113
252,82,133456,37400,145181,140212,4969
253,86,133831,38950,143273,142367,906
254,90,134021,41400,143873,144367,-494
255,89,134851,39100,147283,146136,1147
256,87,134927,40350,147688,148942,-1254
257,83,135184,37900,148283,151942,-3659
258,85,135484,37550,150383,153588,-3205
259,87,135658,41250,153238,157588,-4350
260,90,136098,41400,155207,158088,-2881
261,82,136204,36950,155331,146388,8943
262,85,136376,37550,149401,146728,2673
263,80,136425,35050,149793,146391,3402
264,87,136569,39450,149002,149673,-671
265,84,136991,37050,149923,151941,-2018
266,81,137115,36000,151101,151138,-37
267,80,137542,37750,152502,152138,364
268,87,138222,40350,153014,151186,1828
269,80,138256,35050,152923,151686,1237
270,89,139055,39550,153105,152494,611
271,84,139685,39300,153054,152813,241
272,88,139961,39050,153981,152906,1075
273,90,140107,40950,155101,154234,867
274,85,140423,39350,155660,153313,2347
275,87,140854,40800,156601,154132,2469
276,90,140952,43650,157101,157464,-363
277,87,141031,38550,158332,159340,-1008
278,85,144181,39800,160832,160067,765
279,90,144605,43200,163573,161991,1582
280,90,144754,40500,160735,163991,-3256
281,87,145215,40800,160453,165991,-5538
282,80,145980,34150,161453,168091,-6638
283,81,146019,37350,162553,171476,-8923
284,81,146174,37350,163553,174476,-10923
285,82,146700,37400,164000,177641,-13641
286,90,146832,42300,163438,181191,-17753
287,81,147096,35100,167086,183191,-16105
288,83,147202,37900,168136,185576,-17440
289,87,147477,39450,170088,165384,4704
290,80,147577,36850,163999,165783,-1784
291,83,148745,36550,164762,166529,-1767
292,81,149101,36900,165762,166774,-1012
293,88,149367,39500,166812,168238,-1426
294,84,149532,37950,167999,167930,69
295,87,149857,38550,168549,169430,-881
296,87,150368,39450,166593,168188,-1595
297,86,150549,38500,167431,169188,-1757
298,80,150690,35950,168431,170332,-1901
299,82,151083,36500,169284,170463,-1179
300,80,151305,37300,170693,172095,-1402
301,81,154320,35550,171835,166316,5519
302,82,155457,36050,172931,167716,5215
303,90,156389,42750,176334,170420,5914
304,85,156477,37550,175335,173266,2069
305,81,156487,38700,176407,176766,-359
306,89,156589,39100,176834,179540,-2706
307,88,156954,40850,173173,173430,-257
308,81,157567,36000,176414,174284,2130
309,83,157586,37000,176551,175284,1267
310,83,157603,36100,176199,176090,109
311,80,158250,36850,178088,177030,1058
312,84,158391,38850,179588,178382,1206
313,80,158591,35950,182389,179088,3301
314,83,158626,37900,185439,180198,5241
315,80,159771,36850,188088,181030,7058
316,80,159985,38650,190588,183488,7100
317,85,160269,36650,192607,184002,8605
318,83,160478,38800,193984,184138,9846
319,90,161635,40050,194637,185382,9255
320,81,161892,36900,195138,186432,8706
321,86,161971,39400,195659,187663,7996
322,88,162069,39050,196138,188432,7706
323,83,162136,37900,181731,189298,-7567
324,85,162216,38900,183914,189932,-6018
325,87,162230,39900,183731,184988,-1257
326,84,162597,37050,186414,185041,1373
327,89,162686,40000,186260,182037,4223
328,83,163672,39250,188464,182537,5927
329,87,163702,38550,188231,185941,2290
330,87,164910,40350,189231,188795,436
331,90,165271,39600,190014,190730,-716
332,90,166042,39600,190652,191240,-588
333,89,166946,40900,191514,192313,-799
334,80,168117,37300,192651,194345,-1694
335,81,168746,38250,194360,196345,-1985
336,85,168795,39350,194564,189247,5317
337,86,169217,39400,195614,190345,5269
338,83,169265,37900,196152,191297,4855
339,84,169856,36150,196164,192218,3946
340,81,169877,37350,192485,192943,-458
341,86,170144,41200,193640,193861,-221
342,87,170857,38100,194098,194861,-763
343,90,170857,42300,194457,195004,-547
344,86,170885,37150,194327,195230,-903
345,88,171354,40850,195729,195900,-171
346,82,171538,37400,196457,196840,-383
347,83,172584,37000,196652,197532,-880
348,87,172937,41250,197652,198340,-688
349,84,173668,40650,198233,198863,-630
350,84,173708,36600,198495,199632,-1137
351,83,175293,37000,199495,201287,-1792
352,86,175729,39400,201161,203287,-2126
353,84,175780,38850,202084,205287,-3203
354,89,176032,40450,203054,207837,-4783
355,83,176242,39700,204403,210132,-5729
356,84,176413,37500,205305,210837,-5532
357,85,176580,39350,206305,207692,-1387
358,83,176758,36550,206804,208234,-1430
359,83,179206,38350,207305,208390,-1085
360,86,180433,40750,208285,209413,-1128
361,81,181943,36900,213328,210413,2915
362,88,182025,39950,213828,211390,2438
363,85,182561,37550,215835,212282,3553
364,81,182683,33750,217378,212890,4488
365,83,182696,38350,219378,214832,4546
366,83,182854,38350,222564,215563,7001
367,80,183279,34150,224464,205567,18897
368,81,183321,35100,224637,204270,20367
369,90,183485,40500,225637,205145,20492
370,89,183518,40900,226214,205897,20317
371,88,183684,42650,227214,206845,20369
372,83,184844,39700,227637,208543,19094
373,82,185194,35600,226528,209593,16935
374,89,185709,40900,228216,212093,16123
375,86,185926,39850,229253,214143,15110
376,80,186077,37750,230528,216152,14376
377,89,186469,39100,232028,216940,15088
378,88,186564,39500,213316,217880,-4564
379,80,187340,35500,213829,218430,-4601
380,81,187911,36450,212743,218693,-5950
381,90,188718,40050,213243,221693,-8450
382,89,189189,38650,215195,223345,-8150
383,90,190132,41400,217383,217054,329
384,89,190168,38200,217343,218318,-975
385,87,190443,38550,219734,220318,-584
386,82,190449,37400,219883,222642,-2759
387,84,190549,38850,221195,224642,-3447
388,83,190994,37450,222433,226684,-4251
389,90,191072,42300,222415,227184,-4769
390,88,191179,40850,223195,228142,-4947
391,90,192315,40050,224915,220238,4677
392,87,193727,38550,225933,221360,4573
393,80,194438,35950,226784,223694,3090
394,81,194926,36900,227245,225979,1266
395,83,195452,35650,228993,228244,749
396,82,195542,37850,228915,230979,-2064
397,86,196325,38950,229965,234344,-4379
398,82,197241,33800,231965,235979,-4014
399,88,197289,40850,232033,237994,-5961
400,83,197869,37900,232965,239494,-6529
401,81,199131,37350,235493,241994,-6501
402,85,199164,40250,235534,244994,-9460
403,82,199514,37400,236533,247994,-11461
404,86,199614,38950,237083,251029,-13946
405,86,199926,38500,237295,251529,-14234
406,81,200030,36000,228590,232630,-4040
407,87,200147,39900,231154,233554,-2400
408,81,200242,34200,231448,233790,-2342
409,83,201206,40150,231590,235432,-3842
410,80,201954,36850,227692,236432,-8740
411,84,202013,37500,228742,237432,-8690
412,84,202132,36150,231342,238180,-6838
413,90,202358,41850,233392,239290,-5898
414,90,202934,39600,237795,240263,-2468
415,85,203002,38450,238017,240982,-2965
416,82,203141,37850,238517,242180,-3663
417,83,203587,38350,239440,243340,-3900
418,88,204439,39050,240602,243982,-3380
419,87,204944,41700,242935,244263,-1328
420,85,205299,38450,246535,235376,11159
421,82,205462,38300,249152,236433,12719
422,87,205874,40350,251535,236933,14602
423,84,207433,39300,254035,237833,16202
424,87,207977,39900,257652,238433,19219
425,88,208176,39950,257635,237896,19739
426,82,209666,37400,238154,238496,-342
427,88,211110,39500,239545,240996,-1451
428,80,211365,35950,240666,242996,-2330
429,84,211619,38850,241704,245546,-3842
430,80,212455,38650,242953,249595,-6642
431,83,212712,37450,245254,251046,-5792
432,89,212734,40450,246053,253595,-7542
433,82,212833,39650,245916,256095,-10179
434,81,213766,36900,247366,258596,-11230
435,87,213902,40350,248525,260096,-11571
436,80,213932,36850,250216,244883,5333
437,88,214178,40400,249804,245983,3821
438,88,214288,40850,250466,246483,3983
439,85,214400,38900,251416,243884,7532
440,90,214575,41400,252416,245234,7182
441,81,215784,36900,252283,246784,5499
442,83,216189,38350,253195,250741,2454
443,83,217353,36100,253784,252597,1187
444,83,218554,38350,255167,254636,531
445,86,219071,38950,256333,257741,-1408
446,89,220339,41800,258333,257697,636
447,80,220415,37750,258597,249204,9393
448,83,222073,37900,258834,250742,8092
449,83,222876,37450,259745,251520,8225
450,81,223545,39150,260738,252389,8349
451,89,223725,36850,263878,253207,10671
452,82,224466,38750,266738,256134,10604
453,84,224729,39300,268428,258707,9721
454,87,225256,39450,269428,262140,7288
455,87,225737,41250,263767,263307,460
456,90,226298,38700,250929,257942,-7013
457,80,226709,35500,252112,258442,-6330
458,85,226983,38900,253207,259363,-6156
459,86,227288,38500,254207,260254,-6047
460,84,227444,39750,255673,261580,-5907
461,82,227447,37400,255662,262092,-6430
462,84,228999,37500,258840,263130,-4290
463,84,229045,37500,259544,263904,-4360
464,85,229157,39350,262544,265596,-3052
465,87,229234,41250,263044,268146,-5102
466,81,230076,32850,264936,270646,-5710
467,85,230260,36650,265885,272879,-6994
468,85,230466,37100,265390,275246,-9856
469,85,231284,39800,260106,278796,-18690
470,90,232727,40950,264766,280796,-16030
471,80,232766,35500,264678,282846,-18168
472,84,233757,36600,266316,285629,-19313
473,88,235292,40850,268316,287465,-19149
474,86,235371,40300,270728,288089,-17361
475,87,235690,39900,272029,288893,-16864
476,86,236157,37150,273307,288995,-15688
477,86,236643,38950,275329,289589,-14260
478,80,236734,37750,275364,289943,-14579
479,80,236970,35950,275829,292346,-16517
480,89,237263,39100,274828,294396,-19568
481,89,238630,40900,275970,271242,4728
482,84,239043,35700,276529,271832,4697
483,84,239366,37950,276970,272332,4638
484,82,241123,37850,278828,273363,5465
485,87,241365,39450,280590,274913,5677
486,86,241616,38500,282485,276150,6335
487,82,241775,38300,283485,277891,5594
488,88,242526,40400,284345,280891,3454
489,86,242749,35800,285395,282441,2954
490,83,243394,37000,285895,284441,1454
491,89,244013,42700,287917,288441,-524
492,87,244092,42150,288588,291700,-3112
493,83,244157,38350,288917,292991,-4074
494,83,244336,39250,289895,295541,-5646
495,83,245020,37450,290549,296041,-5492
496,86,247958,39400,291985,299041,-7056
497,83,248002,35650,292049,301450,-9401
498,86,248171,38950,293188,303450,-10262
499,90,248667,41850,293995,285198,8797
500,83,249576,39700,294495,282186,12309
501,83,249605,37900,285590,283686,1904
502,88,250808,38600,289090,283836,5254
503,82,252127,38750,291096,284484,6612
504,84,252696,40650,292646,285492,7154
505,87,253013,39450,295188,287992,7196
506,82,253511,37850,295995,282323,13672
507,81,253554,38250,297485,283596,13889
508,86,253853,37600,298051,283934,14117
509,87,254456,42150,298188,282030,16158
510,81,255471,34650,298487,283258,15229
511,85,255531,35750,299117,283808,15309
512,80,255793,35950,299646,284484,15162
513,83,255813,37450,299690,285513,14177
514,84,256190,38850,286339,286130,209
515,80,257089,38650,286256,286984,-728
516,83,257380,39700,287341,287984,-643
517,81,257821,37350,289078,288858,220
518,83,258354,38800,292078,289534,2544
519,82,258537,36950,292341,290730,1611
520,86,258673,38050,291290,291792,-502
521,86,259111,38950,292550,292730,-180
522,90,259267,39600,294790,293842,948
523,89,259315,39550,294806,294563,243
524,80,259681,34600,297597,295780,1817
525,90,259700,42750,297190,298824,-1634
526,83,259717,37900,297690,300175,-2485
527,84,260796,37500,299597,302225,-2628
528,84,260832,37950,299740,304225,-4485
529,88,260914,40400,300240,305424,-5184
530,85,261552,38450,296220,306325,-10105
531,83,262712,38800,297079,302234,-5155
532,90,263134,41400,298906,303342,-4436
533,83,263162,38800,298720,304342,-5622
534,81,263634,35550,299307,304842,-5535
535,82,264020,34700,299781,305058,-5277
536,87,264039,41700,300579,306058,-5479
537,82,264394,39200,298639,307713,-9074
538,84,264596,37500,299406,309058,-9652
539,81,264703,36000,300105,309784,-9679
540,88,264978,42200,301555,310342,-8787
541,80,265026,37300,301647,310930,-9283
542,90,265719,42300,303200,311708,-8508
543,81,265778,36000,303342,312384,-9042
544,81,266831,36000,304697,309289,-4592
545,86,267027,38500,305506,310339,-4833
546,87,270226,41250,307619,312836,-5217
547,82,270453,36050,310669,314939,-4270
548,85,270861,37550,313169,316436,-3267
549,83,271565,37000,315769,318936,-3167
550,81,273105,35100,316769,321036,-4267
551,85,273287,41600,310237,323036,-12799
552,90,273725,40950,311890,324639,-12749
553,90,273735,39600,311837,320898,-9061
554,87,274385,39900,312595,321470,-8875
555,86,275671,39400,313269,321898,-8629
556,83,275676,38800,313887,320748,-6861
557,84,276409,37950,314887,322798,-7911
558,88,277529,40400,316145,300696,15449
559,88,277715,40400,316645,302457,14188
560,86,277783,39400,317645,304796,12849
561,88,278114,40850,318201,308296,9905
562,90,278251,38250,319201,310557,8644
563,80,278398,36400,321940,313057,8883
564,80,278418,34600,322201,316046,6155
565,81,278451,35100,321701,315657,6044
566,88,278950,38600,323201,317842,5359
567,81,279121,37350,325201,319842,5359
568,81,279161,37350,325540,318650,6890
569,81,279880,37350,326540,322150,4390
570,84,280447,36150,327487,324150,3337
571,88,280704,38600,328245,327200,1045
572,87,283546,40350,329245,330394,-1149
573,80,284134,37300,330040,333250,-3210
574,83,285363,37000,330745,336750,-6005
575,89,286458,39550,319950,338750,-18800
576,90,286475,40500,320806,340300,-19494
577,87,287072,38100,321592,342800,-21208
578,81,287458,34650,323092,345044,-21952
579,84,287545,38400,323000,348544,-25544
580,83,288458,39250,324306,350850,-26544
581,80,288604,35500,324592,352194,-27602
582,85,289532,38000,325599,354400,-28801
583,89,289634,43150,327099,356400,-29301
584,87,289728,38550,329299,357950,-28651
585,87,289785,38550,329490,360744,-31254
586,87,289823,39450,333299,328042,5257
587,80,289889,35500,333799,329282,4517
588,83,290222,38800,335040,330458,4582
589,81,291129,36450,335799,331234,4565
590,88,292706,41300,338090,332063,6027
591,80,293884,35950,339799,332834,6965
592,84,295008,37050,333599,333613,-14
593,82,295229,36500,333906,334613,-707
594,84,295823,38850,331554,336108,-4554
595,84,296577,37500,330239,336884,-6645
596,82,297016,38300,331268,338163,-6895
597,87,297132,38550,332557,338692,-6135
598,83,297380,38350,333557,339692,-6135
599,85,297510,37550,335716,338625,-2909
600,85,297512,38450,335739,340926,-5187
601,84,297696,38400,336408,342426,-6018
602,82,298137,36950,337239,343125,-5886
603,80,298185,35500,337908,335289,2619
604,81,298321,38250,339757,335789,3968
605,89,298323,41350,340266,336789,3477
606,85,298552,38450,342087,337547,4540
607,88,299103,37700,343857,335340,8517
608,85,300507,38900,344857,336942,7915
609,89,301188,39100,337749,338992,-1243
610,88,301314,39500,338749,342890,-4141
611,80,301861,34600,339749,345940,-6191
612,90,302842,42750,340458,347490,-7032
613,82,303198,36050,341601,350092,-8491
614,81,305203,37800,342625,353592,-10967
615,81,305777,33750,342952,355192,-12240
616,87,306619,38550,342569,357540,-14971
617,89,307104,40450,343690,360590,-16900
618,89,307150,40450,344945,363090,-18145
619,88,307210,39050,344737,365242,-20505
620,83,308912,37000,346203,367742,-21539
621,89,309435,39550,346945,368742,-21797
622,87,309538,40350,347995,368503,-20508
623,83,309805,35200,348753,369648,-20895
624,86,311242,38500,351269,370648,-19379
625,86,311302,37600,350995,372603,-21608
626,84,311557,40650,352253,373698,-21445
627,87,311781,40350,352790,371598,-18808
628,86,311924,39850,353995,367984,-13989
629,87,312128,39450,354995,370346,-15351
630,87,312342,39450,355803,373396,-17593
631,89,313211,40000,356887,375534,-18647
632,90,313666,39150,358319,377034,-18715
633,86,314104,40750,359545,379446,-19901
634,80,315124,35050,360340,380634,-20294
635,86,315471,39850,361319,383996,-22677
636,81,315855,39600,361545,385919,-24374
637,85,316579,41150,357461,387297,-29836
638,82,317763,38750,359506,388419,-28913
639,81,318072,38700,361961,388458,-26497
640,86,319227,38050,357001,390134,-33133
641,83,319319,37450,357354,392184,-34830
642,86,319927,40300,357849,393184,-35335
643,84,320239,39300,358494,353583,4911
644,86,320516,40300,359549,354385,5164
645,87,320621,39900,359132,355435,3697
646,84,320640,37950,359170,356630,2540
647,84,320892,37500,360483,357183,3300
648,81,322171,36900,361063,357544,3519
649,90,322641,39150,362999,358044,4955
650,82,323107,36950,364793,359238,5555
651,90,323215,43200,367793,360077,7716
652,85,323935,35300,370049,360636,9413
653,89,324052,41800,374343,361292,13051
654,86,324226,40750,377149,361984,15165
655,86,324379,38500,378649,362808,15841
656,90,324421,41400,380649,363913,16736
657,81,324669,38700,384649,364534,20115
658,80,324726,35950,384343,365534,18809
659,84,324770,36600,386199,366584,19615
660,90,325614,39600,388840,367084,21756
661,90,326450,40500,389853,369325,20528
662,87,326648,41250,390747,371329,19418
663,90,326980,42300,391371,373325,18046
664,81,327719,37800,390199,375379,14820
665,80,328311,34600,392353,377875,14478
666,89,328457,39550,392392,380425,11967
667,86,328890,38950,392799,382079,10720
668,87,328971,38100,386857,382925,3932
669,88,329357,39950,389407,376448,12959
670,89,331759,41800,391907,378360,13547
671,89,331935,40450,395957,379498,16459
672,83,331964,38800,396089,381860,14229
673,82,333200,36050,397457,383048,14409
674,82,333834,35600,399139,386460,12679
675,84,334052,36150,402107,389548,12559
676,88,334082,41300,369345,392048,-22703
677,85,334121,39350,369845,393060,-23215
678,80,334134,36400,368845,377783,-8938
679,80,334667,36400,371895,378597,-6702
680,89,335469,39100,374495,379647,-5152
681,87,336033,40350,377991,380333,-2342
682,90,336482,39150,379995,381333,-1338
683,84,336634,39300,382491,382333,158
684,86,336794,38500,384495,383330,1165
685,82,336911,38750,374043,384090,-10047
686,90,337037,41850,376543,385090,-8547
687,83,338236,37900,379384,386383,-6999
688,81,338378,37800,382512,387090,-4578
689,88,338849,39050,383557,387947,-4390
690,89,339367,39550,385012,388483,-3471
691,88,339433,38150,384566,389590,-5024
692,86,339666,37600,385557,385058,499
693,90,339968,42750,385384,386691,-1307
694,89,340806,40000,386468,390440,-3972
695,90,341032,40500,387384,392691,-5307
696,89,341486,39550,385453,393691,-8238
697,81,342609,36900,386453,390684,-4231
698,87,344450,40350,387722,392108,-4386
699,83,345402,36550,388453,392813,-4360
700,88,345855,40400,389953,393784,-3831
701,89,346171,40900,390899,395244,-4345
702,84,346204,38400,391860,396284,-4424
703,86,347393,38050,392872,397384,-4512
704,82,347560,36950,393872,398384,-4512
705,87,348725,38100,394872,399334,-4462
706,83,349061,40150,397003,400384,-3381
707,88,349147,39050,397360,400813,-3453
708,87,349730,39900,398003,399053,-1050
709,84,350511,37950,399103,401203,-2100
710,82,351141,37850,399906,401894,-1988
711,81,352318,36900,400603,402703,-2100
712,90,352531,38700,401360,395986,5374
713,89,353307,39550,402406,396453,5953
714,90,353478,41850,403653,395681,7972
715,89,353648,40000,403999,398675,5324
716,83,354218,37900,404499,400681,3818
717,88,354266,39050,405922,404181,1741
718,84,354353,38850,405906,407225,-1319
719,87,354585,39900,406406,409725,-3319
720,83,354600,38800,402772,412725,-9953
721,88,354890,41300,404772,414731,-9959
722,81,355053,38250,408034,417231,-9197
723,84,355579,38850,410534,419731,-9197
724,85,356097,39800,411963,421731,-9768
725,84,356166,37500,412185,424375,-12190
726,89,357488,41350,412463,426781,-14318
727,82,357955,37400,413124,428331,-15207
728,82,358922,36500,413422,430675,-17253
729,80,359771,35050,408670,432675,-24005
730,84,360728,37500,409659,434675,-25016
731,82,362644,36950,410243,436175,-25932
732,88,362764,38150,410720,438581,-27861
733,84,362954,39750,411793,441581,-29788
734,82,363046,35600,412512,442675,-30163
735,90,363158,42300,413720,444131,-30411
736,84,364029,37500,414843,446175,-31332
737,88,365711,40400,416062,447268,-31206
738,90,365891,40950,416893,448618,-31725
739,88,366578,39950,417968,449768,-31800
740,83,366842,37450,418759,450444,-31685
741,90,367416,38700,419662,451262,-31600
742,86,367459,39400,420468,451994,-31526
743,83,368234,38350,421543,449725,-28182
744,90,368301,36900,422320,451825,-29505
745,81,368910,36450,422968,453044,-30076
746,90,369637,40050,423968,455281,-31313
747,85,370208,39800,425273,423043,2230
748,89,370257,40900,425342,423669,1673
749,87,370467,40800,426140,424093,2047
750,86,371715,38950,427690,416887,10803
751,82,371990,37400,428503,417887,10616
752,87,372234,39000,429823,418940,10883
753,88,372332,39950,430392,420080,10312
754,81,372695,34650,431690,420937,10753
755,87,372826,39900,433392,421447,11945
756,87,372884,39000,433740,422080,11660
757,80,373408,35950,423045,422433,612
758,87,373870,39000,423643,415158,8485
759,81,374747,35550,418053,416434,1619
760,87,374892,39000,419012,416934,2078
761,80,375380,36850,421658,417463,4195
762,81,375570,36900,422708,419384,3324
763,82,375817,36050,424191,421884,2307
764,87,377098,39900,427741,423749,3992
765,84,377243,39300,430207,424671,5536
766,85,377328,38900,432741,426058,6683
767,87,377859,39000,434449,428860,5589
768,86,378314,41200,434956,431200,3756
769,86,378502,38500,435456,432910,2546
770,84,378826,36600,436506,436410,96
771,85,379267,38900,437746,438200,-454
772,87,379269,41700,438846,441143,-2297
773,89,379360,41350,439006,443693,-4687
774,80,379735,34150,439896,445041,-5145
775,82,380100,36950,440499,445110,-4611
776,84,380271,37950,442499,437147,5352
777,82,380537,36500,440341,438903,1438
778,88,381488,39950,443341,441503,1838
779,88,381910,41750,446457,444553,1904
780,85,383276,35750,448491,448653,-162
781,81,383569,37350,449491,450347,-856
782,87,383780,41700,438224,452653,-14429
783,90,384087,40050,439224,456847,-17623
784,80,384842,37300,439862,459153,-19291
785,90,385822,40950,441306,460397,-19091
786,84,385887,38850,442953,428426,14527
787,84,385896,39300,442806,430044,12762
788,85,386054,38900,443799,433544,10255
789,90,386727,41400,444503,436848,7655
790,88,387537,39500,444724,439398,5326
791,87,389311,38550,434603,441109,-6506
792,86,389554,39400,435892,442609,-6717
793,89,391019,40450,436740,444498,-7758
794,88,391961,41300,438392,445998,-7606
795,81,393539,37800,439740,449109,-9369
796,85,393789,40700,440399,452609,-12210
797,88,394408,39050,441499,455436,-13937
798,81,394981,37800,442442,456208,-13766
799,90,395275,37800,443290,456758,-13468
800,80,395751,35950,444290,457758,-13468
801,90,396009,38700,445999,458758,-12759
802,86,396101,40750,446123,460436,-14313
803,83,397464,37000,446992,461063,-14071
804,90,397656,40500,447992,461986,-13994
805,85,398676,38900,448853,462936,-14083
806,85,399317,37550,449853,464063,-14210
807,89,399467,40000,450940,465086,-14146
808,88,400202,42650,452042,466586,-14544
809,82,402166,36950,452940,468063,-15123
810,82,402918,37850,453623,468636,-15013
811,85,402939,38450,454542,470036,-15494
812,80,403253,37750,455599,457548,-1949
813,88,403588,36800,456592,460309,-3717
814,87,405443,39900,458099,464048,-5949
815,88,407464,36800,458823,466048,-7225
816,90,408068,41400,459403,469809,-10406
817,83,408418,38800,460640,470663,-10023
818,87,408788,39450,461640,471663,-10023
819,90,408879,41400,462903,473496,-10593
820,84,409201,36600,463523,474060,-10537
821,89,409252,39550,464240,474536,-10296
822,86,410379,37150,466573,471598,-5025
823,84,410458,37950,466903,474359,-7456
824,82,411704,38300,467740,475146,-7406
825,90,412603,41400,468699,475813,-7114
826,85,413040,39800,450068,477959,-27891
827,80,413624,37300,453418,449396,4022
828,86,413739,38050,454376,450896,3480
829,81,413940,35100,456051,451444,4607
830,89,413942,40450,455958,452836,3122
831,87,414124,39450,456553,453599,2954
832,80,414480,35950,458536,456187,2349
833,81,414898,38700,460362,458099,2263
834,85,416244,40250,462061,461237,824
835,88,416248,39050,462493,463649,-1156
836,86,416582,40300,462993,465649,-2656
837,90,416985,41850,462616,467837,-5221
838,84,417431,38400,464699,470337,-5638
839,85,419721,39800,471799,473249,-1450
840,90,419721,41850,469049,475749,-6700
841,83,419755,37900,472099,464312,7787
842,85,421138,39350,474299,465596,8703
843,82,421500,36050,475299,466468,8831
844,85,421754,35300,477799,467096,10703
845,82,421945,37400,479299,467812,11487
846,81,423924,35100,480299,468912,11387
847,87,423939,39450,483799,469912,13887
848,81,424353,38250,484849,471146,13703
849,87,424682,40350,487349,471894,15455
850,88,426026,42200,489349,472720,16629
851,88,426223,39950,492349,473894,18455
852,86,426586,38950,493899,474696,19203
853,89,428713,40900,498049,476196,21853
854,82,428737,36050,497549,477068,20481
855,84,429299,37950,499899,478068,21831
856,83,429843,37900,502649,478912,23737
857,84,430034,35250,504599,479618,24981
858,87,430427,37650,507199,480412,26787
859,83,431337,38800,509249,481118,28131
860,83,431567,37000,512349,482044,30305
861,90,431581,41400,512249,483168,29081
862,85,431981,39800,514399,483860,30539
863,81,432503,35550,516349,485960,30389
864,86,433306,38050,520899,487753,33146
865,86,433324,38500,520499,490253,30246
866,89,433441,38650,482158,494060,-11902
867,81,433447,37350,483301,496253,-12952
868,83,433643,37450,483152,498753,-15601
869,83,433646,37450,482143,501253,-19110
870,82,433669,36050,482872,503810,-20938
871,85,433880,38900,484652,506310,-21658
872,89,434528,41350,487702,508303,-20601
873,80,434683,37300,489422,509310,-19888
874,83,434932,38800,490702,498346,-7644
875,89,434968,40450,492422,486158,6264
876,82,434987,35150,494252,487197,7055
877,87,435016,39000,489408,487597,1811
878,86,435028,37600,490461,488597,1864
879,81,435352,36450,491522,489308,2214
880,88,435573,39950,493022,490747,2275
881,83,435830,39250,494076,491445,2631
882,86,436283,39850,494912,492445,2467
883,85,436987,40250,495561,492597,2964
884,89,438019,40900,496561,493408,3153
885,80,438028,36400,499572,494097,5475
886,89,438101,40450,499611,494908,4703
887,86,438639,40300,500912,496456,4456
888,84,438649,38400,500843,497697,3146
889,86,438863,39400,502412,499697,2715
890,81,439307,37800,503661,502247,1414
891,86,439447,38950,504343,506006,-1663
892,87,439894,40800,505462,509297,-3835
893,88,441311,40400,506462,511797,-5335
894,85,442166,39350,506962,514106,-7144
895,87,442179,39450,507226,516706,-9480
896,83,442807,39250,494097,519797,-25700
897,88,442954,38150,496147,521847,-25700
898,81,443322,36900,500996,524906,-23910
899,89,443330,39550,501697,528406,-26709
900,81,443501,37800,503496,530006,-26510
901,83,444527,38800,495092,531506,-36414
902,88,444817,41300,496642,534056,-37414
903,84,445079,39750,497923,536497,-38574
904,90,445312,41400,499099,513238,-14139
905,88,445614,39950,500473,514713,-14240
906,85,445690,38900,500542,515713,-15171
907,85,446203,36650,501099,516212,-15113
908,87,446482,39450,503042,517146,-14104
909,80,446520,36400,503242,518146,-14904
910,87,446982,41250,505591,519586,-13995
911,83,447102,37900,507862,520712,-12850
912,85,447507,38000,511091,521288,-10197
913,88,448229,37250,513591,522312,-8721
914,81,448313,37350,514798,523312,-8514
915,90,448976,42300,515808,524312,-8504
916,81,449043,37800,516558,525296,-8738
917,82,449383,36950,517558,525686,-8128
918,80,449523,36400,518558,522789,-4231
919,85,449737,36650,519558,524839,-5281
920,88,451381,39950,520446,525949,-5503
921,83,451809,36550,521551,528339,-6788
922,82,451960,36050,522348,530549,-8201
923,81,452017,36450,523046,532889,-9843
924,89,452268,38650,524058,535599,-11541
925,80,452618,35500,524908,537099,-12191
926,83,453140,35650,526348,539039,-12691
927,86,453353,37150,526958,541539,-14581
928,84,454291,37050,528096,544749,-16653
929,90,454665,40050,529101,545749,-16648
930,85,456370,38450,530458,547799,-17341
931,81,457132,37800,531348,550299,-18951
932,84,457272,38400,532101,552299,-20198
933,90,459184,39600,532348,554189,-21841
934,81,459781,38700,525505,556849,-31344
935,81,459895,36900,526508,558899,-32391
936,86,460005,38950,528526,560949,-32423
937,81,460034,37800,528508,524341,4167
938,81,461724,37800,529901,525147,4754
939,84,463058,37500,531401,526383,5018
940,89,463154,37750,531168,528401,2767
941,83,464274,36100,533308,530709,2599
942,84,464311,37950,533348,532709,639
943,87,464453,36750,535751,535809,-58
944,90,464466,42300,535796,538451,-2655
945,86,464850,40300,536808,540951,-4143
946,90,465783,41400,537751,541951,-4200
947,83,465848,35650,537808,533941,3867
948,83,466158,37000,535841,535242,599
949,86,466389,39400,538296,535941,2355
950,80,466632,35950,538850,537347,1503
951,84,466904,37950,539510,538292,1218
952,83,467028,36550,540012,538732,1280
953,87,467806,38550,529260,539533,-10273
954,89,468273,40450,531549,540533,-8984
955,80,468307,37750,531655,541441,-9786
956,80,468535,35950,532358,541782,-9424
957,81,468687,36450,530644,542782,-12138
958,84,468946,37050,532126,535962,-3836
959,82,469080,37400,534792,537320,-2528
960,82,469086,36950,533644,537820,-4176
961,82,469095,37400,535144,538996,-3852
962,81,469944,36900,536203,541491,-5288
963,84,470074,38400,537203,543948,-6745
964,85,471051,38450,537773,546948,-9175
965,83,471510,38350,538203,550191,-11988
966,90,471921,41400,540549,551948,-11399
967,85,472001,39800,540773,545870,-5097
968,80,472759,38200,541703,547022,-5319
969,90,473778,43650,543049,548370,-5321
970,85,474087,39350,544049,549522,-5473
971,85,474639,40250,545049,550746,-5697
972,83,474918,37900,545892,552370,-6478
973,82,475194,36500,546892,553246,-6354
974,84,476167,41550,548099,554246,-6147
975,85,477194,39800,548823,555044,-6221
976,81,477649,36000,551203,555072,-3869
977,80,477709,37300,552149,532686,19463
978,89,477765,40000,552203,533988,18215
979,87,478039,41250,553323,535038,18285
980,87,478434,39900,554203,536496,17707
981,88,478568,38600,555444,537415,18029
982,82,478593,39650,556873,538915,17958
983,84,479727,36150,557803,539415,18388
984,84,480533,38400,558444,539686,18758
985,86,480654,37150,558803,540686,18117
986,84,480944,36150,554826,541736,13090
987,86,481796,38500,555824,543254,12570
988,86,482433,41650,556324,545210,11114
989,83,482614,38350,556826,547760,9066
990,83,482922,37450,558012,552255,5757
991,82,483494,38300,558549,555305,3244
992,85,483689,36650,559874,557410,2464
993,80,483711,35050,562049,559905,2144
994,84,483744,37950,562996,561955,1041
995,86,483799,39400,562026,564560,-2534
996,85,483814,37550,562599,567455,-4856
997,88,484780,39950,553716,569455,-15739
998,89,485288,40000,554715,572210,-17495
999,90,485425,40950,555715,573810,-18095
1000,83,485426,38800,556065,577005,-20940
1001,88,487339,39500,547338,580555,-33217
1002,88,487874,39050,548274,582555,-34281
1003,83,488594,37000,549326,585860,-36534
1004,86,489689,39850,550849,588055,-37206
1005,89,489751,40450,556551,592055,-35504
1006,86,489843,39400,556849,595605,-38756
1007,89,490015,40900,561601,597910,-36309
1008,88,490098,39950,561849,601105,-39256
1009,84,490714,37050,564849,601910,-37061
1010,84,490877,36150,567399,565288,2111
1011,87,491271,41250,570251,566165,4086
1012,87,491392,39450,573449,566962,6487
1013,86,492750,38500,575801,567786,8015
1014,88,492861,42200,577999,568396,9603
1015,90,493315,44100,580801,569786,11015
1016,86,494034,39850,584301,570512,13789
1017,84,494490,36150,587351,571836,15515
1018,88,496341,40400,589549,572562,16987
1019,88,496561,39950,594451,573438,21013
1020,81,496620,36450,596549,574662,21887
1021,89,496669,39100,597001,575496,21505
1022,87,497107,39900,598549,576386,22163
1023,84,497486,37950,601049,564882,36167
1024,85,498621,38900,603049,566183,36866
1025,90,498992,40050,605201,567647,37554
1026,82,499891,37850,607701,561797,45904
1027,87,500094,39000,610099,562349,47750
1028,81,500105,35100,610394,563349,47045
1029,88,500285,40850,611649,564658,46991
1030,82,500424,36950,573903,565658,8245
1031,84,500640,38850,574568,566397,8171
1032,81,502406,35550,575568,567399,8169
1033,80,502843,37750,577108,568247,8861
1034,88,503239,39050,578061,569247,8814
1035,85,503356,41150,579158,570247,8911
1036,84,503513,38400,581158,571208,9950
1037,83,503555,39250,581226,571899,9327
1038,80,504602,35500,582668,572747,9921
1039,88,505330,40400,583668,575847,7821
1040,85,505988,38900,584208,577897,6311
1041,87,506111,38100,586276,579897,6379
1042,89,506145,42250,586161,583059,3102
1043,83,506395,37450,587403,586397,1006
1044,82,506647,38300,588318,589397,-1079
1045,86,508060,40300,589258,592709,-3451
1046,88,508530,39950,590308,594397,-4089
1047,85,508722,39800,591308,597947,-6639
1048,85,509517,38900,592453,600759,-8306
1049,83,509989,39700,592953,604497,-11544
1050,86,509996,38500,593553,606047,-12494
1051,88,510343,39050,594808,597001,-2193
1052,86,510851,40750,596103,600051,-3948
1053,80,511256,36850,597211,601862,-4651
1054,81,511384,37350,598808,604601,-5793
1055,81,511872,37350,599426,607862,-8436
1056,88,512465,39500,599926,609101,-9175
1057,90,513245,40050,601311,611201,-9890
1058,83,513914,37900,602476,613962,-11486
1059,87,514459,40800,604476,616562,-12086
1060,89,514492,40000,604358,618801,-14443
1061,85,515085,37100,605153,620851,-15698
1062,80,515338,37750,606408,622062,-15654
1063,85,515640,37100,606968,624851,-17883
1064,89,517026,40450,607911,628451,-20540
1065,83,517445,36550,608018,630662,-22644
1066,88,517556,42650,595601,632162,-36561
1067,87,517707,36750,596355,633951,-37596
1068,88,518031,39950,598112,636712,-38600
1069,81,518122,36450,597905,638501,-40596
1070,86,519623,39850,598608,640501,-41893
1071,85,519679,39800,589276,642501,-53225
1072,90,520407,40050,590276,644051,-53775
1073,81,521586,38700,591478,645762,-54284
1074,88,522320,39500,592661,647101,-54440
1075,85,523951,37550,593478,645544,-52066
1076,86,524123,39850,594276,647498,-53222
1077,88,524822,42200,595162,650594,-55432
1078,84,525755,38850,596161,654194,-58033
1079,83,525973,40150,597712,656194,-58482
1080,83,526021,38800,598211,657486,-59275
1081,88,526190,41750,599261,658908,-59647
1082,84,526312,37050,599849,659898,-60049
1083,85,526985,38900,600761,661458,-60697
1084,87,527086,39000,604454,661958,-57504
1085,80,527102,34600,603475,659694,-56219
1086,81,528565,36900,606454,662744,-56290
1087,90,528659,38250,610008,666198,-56190
1088,83,528659,35200,610018,668698,-58680
1089,85,529243,42050,611405,618270,-6865
1090,86,529458,41650,612476,618820,-6344
1091,82,529470,38300,613008,620472,-7464
1092,84,530410,38400,610004,621320,-11316
1093,88,530882,40400,611725,621962,-10237
1094,87,530921,37650,614225,608999,5226
1095,85,532404,36200,616225,610999,5226
1096,85,533315,38000,618504,612192,6312
1097,90,533560,40500,620225,615192,5033
1098,85,533795,36650,616616,617099,-483
1099,85,534048,38900,617813,619192,-1379
1100,84,534637,39750,619616,622099,-2483
1101,87,534729,39000,620846,625099,-4253
1102,84,534806,38850,621152,627342,-6190
1103,89,535069,39550,624396,630599,-6203
1104,81,535241,38250,630152,632342,-2190
1105,81,535309,36900,630446,633599,-3153
1106,88,535321,39050,630652,636942,-6290
1107,82,536414,38750,633946,639442,-5496
1108,80,536683,36850,635202,642442,-7240
1109,82,537070,36050,637202,645599,-8397
1110,86,537103,39850,639946,646599,-6653
1111,84,537256,37950,644752,649099,-4347
1112,86,537257,39400,645046,651592,-6546
1113,80,537364,35950,646252,654121,-7869
1114,82,539029,36500,649252,655121,-5869
1115,82,539446,36500,650281,656047,-5766
1116,81,539811,38700,651708,655592,-3884
1117,83,539935,38350,652781,658149,-5368
1118,85,540285,38000,653208,659199,-5991
1119,80,540590,37300,653959,627236,26723
1120,88,541341,39500,654196,629736,24460
1121,88,541490,39500,655196,632077,23119
1122,85,541790,40700,616318,633736,-17418
1123,80,541855,36400,618464,635627,-17163
1124,87,541900,39450,619318,637627,-18309
1125,82,542607,36950,620863,638786,-17923
1126,81,543154,37350,622065,642277,-20212
1127,82,543177,35600,623565,646036,-22471
1128,81,545072,36450,626663,649036,-22373
1129,87,545113,40350,626666,651377,-24711
1130,87,545119,35400,626913,653036,-26123
1131,80,545169,37750,627115,655536,-28421
1132,90,545815,40050,627163,657586,-30423
1133,87,546437,39450,624514,658477,-33963
1134,88,546620,39500,627668,628940,-1272
1135,83,546646,39250,628115,629950,-1835
1136,86,546765,38050,628963,631454,-2491
1137,82,548225,38750,629170,632888,-3718
1138,83,548671,37000,632874,634004,-1130
1139,86,548677,38500,632594,634888,-2294
1140,82,549136,38750,635594,635450,144
1141,82,549384,36950,640474,636450,4024
1142,88,549465,37700,641024,637540,3484
1143,83,549744,38350,643094,637550,5544
1144,87,550883,40350,645594,634797,10797
1145,81,551200,36000,647594,636847,10747
1146,87,552440,39450,650074,638847,11227
1147,85,553352,38900,653174,640562,12612
1148,90,553353,40950,653674,643847,9827
1149,84,554631,38400,655319,645347,9972
1150,88,555175,38150,657174,647347,9827
1151,89,556365,41800,657793,650847,6946
1152,86,557720,39400,657224,653397,3827
1153,84,557897,38850,658293,656662,1631
1154,85,558259,39800,658388,659447,-1059
1155,82,558680,36500,658821,660712,-1891
1156,80,558835,34150,644420,662997,-18577
1157,87,559599,41250,646761,665812,-19051
1158,81,559662,35100,646908,667812,-20904
1159,83,560505,40150,648055,669047,-20992
1160,83,560765,39250,649555,671412,-21857
1161,82,561393,36500,649970,673412,-23442
1162,84,562218,36600,650761,674912,-24151
1163,83,562429,37450,651311,678462,-27151
1164,87,562534,36750,652476,680247,-27771
1165,82,562870,37850,653908,682062,-28154
1166,89,563438,40450,654908,685297,-30389
1167,85,563803,40250,655958,686797,-30839
1168,83,563936,39700,656970,689112,-32142
1169,80,565265,35050,658476,690662,-32186
1170,90,565854,43200,659461,692797,-33336
1171,86,566178,38500,660958,694262,-33304
1172,85,567811,38450,662570,695897,-33327
1173,89,567816,39100,664008,697862,-33854
1174,82,568710,36950,665070,700912,-35842
1175,89,569134,39550,666158,702494,-36336
1176,80,569218,36400,667158,703336,-36178
1177,87,569593,39450,668026,704949,-36923
1178,89,570377,41800,669158,705949,-36791
1179,82,570580,38300,670526,706999,-36473
1180,80,571506,35050,670658,707591,-36933
1181,80,571518,36400,671658,708185,-36527
1182,83,572223,37000,672576,708836,-36260
1183,86,572562,39400,673576,710185,-36609
1184,80,572803,34150,674211,710936,-36725
1185,81,572835,38700,675258,711685,-36427
1186,88,573458,41300,676720,712494,-35774
1187,82,574304,37400,677711,712641,-34930
1188,80,574531,35950,678820,706947,-28127
1189,85,575041,37100,679358,708462,-29104
1190,87,575472,39000,680870,710547,-29677
1191,89,576093,41350,682126,712562,-30436
1192,83,576570,38350,682858,714562,-31704
1193,89,576905,41350,684355,716062,-31707
1194,89,577613,41350,686176,718562,-32386
1195,85,577628,39350,685855,720197,-34342
1196,88,579321,39050,675523,723112,-47589
1197,82,579689,39200,676023,726112,-50089
1198,81,579940,38250,662514,727697,-65183
1199,90,581113,39600,663078,677110,-14032
1200,86,581184,38950,663651,669294,-5643
1201,83,582216,37900,664628,670294,-5666
1202,88,582692,39500,666563,671294,-4731
1203,80,582696,36400,666251,672320,-6069
1204,83,583281,37000,667113,672820,-5707
1205,82,583855,37850,668570,673900,-5330
1206,88,584806,39500,669965,675400,-5435
1207,80,585580,35500,671117,676344,-5227
1208,80,586271,35050,672015,677394,-5379
1209,82,586466,38750,672813,678374,-5561
1210,86,586702,38050,674117,679550,-5433
1211,81,587138,38250,674913,680420,-5507
1212,84,588031,36150,676065,681050,-4985
1213,87,588573,39900,678065,682474,-4409
1214,84,588580,37950,678220,683474,-5254
1215,83,588951,39250,679220,684420,-5200
1216,81,589087,37800,680220,685420,-5200
1217,86,589229,39400,682220,686100,-3880
1218,89,589234,41350,682463,687600,-5137
1219,80,589367,37300,683065,688474,-5409
1220,89,589761,41350,685513,689144,-3631
1221,90,589806,38700,685220,692130,-6910
1222,90,589887,41400,686717,694907,-8190
1223,82,590799,36050,688113,697407,-9294
1224,90,591442,42300,688713,699907,-11194
1225,89,591855,40900,690115,703230,-13115
1226,85,592194,36200,690615,707730,-17115
1227,87,592320,39450,691717,710730,-19013
1228,84,593187,38850,692717,711507,-18790
1229,86,593429,39850,694113,674451,19662
1230,81,593608,38250,695270,675747,19523
1231,89,593784,43600,695713,676801,18912
1232,89,594096,40450,693801,677421,16380
1233,87,594792,40350,694478,677921,16557
1234,80,594833,38200,694978,678851,16127
1235,82,595065,38300,695928,679451,16477
1236,84,595718,38850,697213,680351,16862
1237,87,597129,39450,696256,681451,14805
1238,89,597249,39550,700025,682347,17678
1239,87,597352,39900,704675,682971,21704
1240,85,597390,36200,705175,684001,21174
1241,85,599001,38450,706175,685397,20778
1242,87,599616,39900,705058,686501,18557
1243,85,600226,37550,705412,687708,17704
1244,80,600282,36850,706298,688401,17897
1245,80,601255,35950,706912,689051,17861
1246,86,601312,38950,708058,690321,17737
1247,87,601993,42150,709298,691051,18247
1248,88,602152,39050,709798,692839,16959
1249,90,602580,40050,710912,695339,15573
1250,83,602946,37900,712255,698127,14128
1251,80,603137,37750,713162,700627,12535
1252,89,603514,40900,714298,702627,11671
1253,84,603685,39300,715298,704439,10859
1254,84,603787,36600,715755,707439,8316
1255,83,604634,37900,716662,709327,7335
1256,88,604790,38150,717712,711927,5785
1257,89,605243,40450,718712,714589,4123
1258,83,605511,38350,719405,718477,928
1259,87,606062,39900,720405,721089,-684
1260,90,606299,42750,721612,724477,-2865
1261,82,606556,37850,722812,726977,-4165
1262,82,606741,38750,724112,730639,-6527
1263,83,607791,35650,724455,732577,-8122
1264,85,608555,38450,725455,736189,-10734
1265,81,608807,38700,726612,739189,-12577
1266,90,609806,42300,727455,741727,-14272
1267,89,613067,40450,728112,743789,-15677
1268,81,613510,37350,728808,745289,-16481
1269,88,613515,41300,729555,747777,-18222
1270,85,614256,38900,730362,749839,-19477
1271,82,615603,37400,731548,751827,-20279
1272,85,615791,38450,732662,753927,-21265
1273,81,616236,37350,733362,756427,-23065
1274,85,616281,38000,734662,760977,-26315
1275,85,616821,39350,736362,765889,-29527
1276,88,616899,40400,736212,769127,-32915
1277,81,617085,36900,737212,771127,-33915
1278,82,617797,38750,738362,773489,-35127
1279,84,618006,37500,739762,776039,-36277
1280,90,618178,40500,740155,778039,-37884
1281,87,618544,40350,741198,780677,-39479
1282,86,619020,40300,742462,783727,-41265
1283,89,620003,42250,743698,786227,-42529
1284,85,620517,38000,744408,787777,-43369
1285,82,621061,37400,745655,789777,-44122
1286,83,621335,36550,746312,792777,-46465
1287,88,624417,40400,747012,794777,-47765
1288,87,624786,39900,748198,796277,-48079
1289,80,625118,35050,749562,797639,-48077
1290,83,625747,38800,751155,800639,-49484
1291,82,625806,39200,751362,803277,-51915
1292,90,626152,37800,752198,805277,-53079
1293,86,626706,39850,753698,808189,-54491
1294,81,626905,38250,754698,810277,-55579
1295,87,627354,41700,755698,812239,-56541
1296,89,628186,41800,756762,814739,-57977
1297,89,628742,41800,757762,818777,-61015
1298,81,630375,37800,759312,820277,-60965
1299,85,630805,39350,760198,716659,43539
1300,83,632035,37900,761108,717159,43949
1301,83,632254,35650,762198,717838,44360
1302,83,632870,38800,763412,718709,44703
1303,82,633437,36950,763912,719709,44203
1304,86,634261,37600,764755,720838,43917
1305,80,635085,37300,766012,721676,44336
1306,81,635111,36450,766512,722388,44124
1307,81,635453,37350,767912,723388,44524
1308,86,635604,39850,768412,725749,42663
1309,80,635930,37750,769158,727249,41909
1310,87,635951,40350,770198,729895,40303
1311,82,636214,38750,771062,732895,38167
1312,81,637030,36900,772198,735299,36899
1313,87,637084,38550,772658,738495,34163
1314,80,637367,38200,737315,742299,-4984
1315,84,637564,40200,739508,744299,-4791
1316,88,637576,39500,739670,747799,-8129
1317,80,637699,35950,740670,748799,-8129
1318,82,638410,37400,742496,750799,-8303
1319,83,638450,36100,742996,752145,-9149
1320,86,639349,39400,742376,754645,-12269
1321,90,639977,41850,743876,756645,-12769
1322,85,640005,39350,743865,758195,-14330
1323,89,640635,40450,745376,759999,-14623
1324,88,640955,38600,747405,762745,-15340
1325,87,640981,40350,747415,763549,-16134
1326,83,641537,34750,748405,730444,17961
1327,86,641672,38500,748926,733508,15418
1328,88,641867,40850,750208,737444,12764
1329,81,642209,38250,750915,739944,10971
1330,84,642703,37500,752405,740994,11411
1331,84,643592,40200,753415,743008,10407
1332,82,643745,36050,755465,745044,10421
1333,82,643830,39200,755976,749094,6882
1334,85,643855,38000,756258,752108,4150
1335,89,644629,41350,757455,754608,2847
1336,87,645080,39450,758955,726660,32295
1337,81,645092,36000,758476,729210,29266
1338,90,645503,40500,759258,732260,26998
1339,80,645845,35500,760026,734660,25366
1340,82,645959,38300,761465,738210,23255
1341,82,646098,39200,762470,741310,21160
1342,83,646337,38350,764076,743360,20716
1343,81,646435,36900,764258,746710,17548
1344,86,647168,38500,765176,748210,16966
1345,81,648168,36900,765676,749210,16466
1346,90,648228,40050,767555,752210,15345
1347,82,648315,37400,768470,754560,13910
1348,86,648411,38950,768358,757710,10648
1349,80,649210,34600,769908,759710,10198
1350,90,650457,42750,770726,761110,9616
1351,84,650592,38400,772226,761760,10466
1352,89,651487,43150,773226,763760,9466
1353,88,653208,39950,774276,743276,31000
1354,87,653466,40350,775055,744138,30917
1355,81,653996,37350,775826,745157,30669
1356,80,654527,35950,776170,746207,29963
1357,82,654536,36950,766163,747276,18887
1358,89,655275,40450,766671,749082,17589
1359,86,655659,41200,768320,750082,18238
1360,85,655925,38900,768717,750638,18079
1361,82,656978,36950,769663,751582,18081
1362,88,657196,39500,772267,752638,19629
1363,84,657223,37950,772320,753326,18994
1364,83,657287,38350,772217,754511,17706
1365,84,657845,40200,773217,755757,17460
1366,87,658173,37650,773671,756757,16914
1367,82,658398,36500,774217,758132,16085
1368,85,658888,39800,775217,759061,16156
1369,82,659028,36050,775263,760111,15152
1370,81,659548,38700,774328,761376,12952
1371,88,660143,38150,774953,761611,13342
1372,82,661037,37400,775378,756367,19011
1373,83,661642,37450,755044,757700,-2656
1374,81,661820,36450,756044,758640,-2596
1375,80,663403,35050,757044,759690,-2646
1376,85,663687,36650,757855,760250,-2395
1377,89,664283,40450,758855,761586,-2731
1378,89,664650,40900,759025,762586,-3561
1379,84,664863,38400,759046,763912,-4866
1380,85,665285,40250,760096,764586,-4490
1381,81,665573,34200,760525,765241,-4716
1382,85,665801,39800,763309,766386,-3077
1383,86,667272,38050,765225,766936,-1711
1384,84,667436,39300,768509,768087,422
1385,83,667976,37900,771109,768949,2160
1386,86,669272,39400,774225,770044,4181
1387,85,669574,39800,776825,771087,5738
1388,81,670409,36000,778109,771999,6110
1389,90,670702,41850,779975,772741,7234
1390,86,671063,38050,781475,773936,7539
1391,84,672309,37050,789309,774936,14373
1392,82,672345,36500,787259,775237,12022
1393,85,672358,40250,790309,776436,13873
1394,82,673345,36950,796025,777094,18931
1395,86,673384,39850,795809,777936,17873
1396,85,673633,39800,798809,778791,20018
1397,89,674005,41350,801309,779986,21323
1398,82,674203,36950,804175,781486,22689
1399,81,674310,37800,805859,782194,23665
1400,89,674634,40900,808225,783049,25176
1401,89,675156,39550,810409,783294,27115
1402,88,675256,39950,811909,772597,39312
1403,89,675276,42700,816409,773871,42538
1404,88,675294,39500,816825,775110,41715
1405,90,675398,41850,818409,776301,42108
1406,90,675630,39600,820325,776971,43354
1407,80,675757,35500,822875,777471,45404
1408,87,676066,34950,823375,778471,44904
1409,82,676527,36950,780418,779247,1171
1410,80,677693,36850,780453,779747,706
1411,84,677744,36600,781633,780351,1282
1412,83,678476,40600,782466,781551,915
1413,86,678628,38500,783466,782551,915
1414,82,679132,37850,786149,783521,2628
1415,83,679892,36100,788649,784051,4598
1416,85,680038,38900,793149,784551,8598
1417,89,680069,40900,793514,785747,7767
1418,89,680224,40000,797764,786760,11004
1419,80,680236,36850,798199,787571,10628
1420,89,681670,40900,800314,788551,11763
1421,81,681814,35550,802249,789651,12598
1422,89,682953,39550,803864,790621,13243
1423,88,683348,40850,804914,791651,13263
1424,83,683782,38800,809749,792621,17128
1425,83,683839,36550,809914,793397,16517
1426,81,685782,38700,812749,794001,18748
1427,83,687305,39250,815799,794501,21298
1428,83,688181,35200,817464,783552,33912
1429,82,690081,38750,817849,783500,34349
1430,89,690414,40900,779549,784500,-4951
1431,87,690620,39000,780549,785940,-5391
1432,87,691262,39900,781549,786500,-4951
1433,84,691715,38400,782341,787756,-5415
1434,87,691960,40800,783581,788138,-4557
1435,80,692073,36400,784581,789951,-5370
1436,87,692298,38100,785487,791767,-6280
1437,80,692858,36850,786599,794817,-8218
1438,86,694375,40750,787599,796917,-9318
1439,86,696477,38500,788440,800517,-12077
1440,82,696792,37400,790537,802501,-11964
1441,88,696801,40400,790599,805017,-14418
1442,89,697726,41800,791599,807501,-15902
1443,85,698457,40700,792599,809067,-16468
1444,83,698991,34750,793649,810167,-16518
1445,82,699455,38750,794181,812167,-17986
1446,80,700047,33250,795440,799964,-4524
1447,82,700587,35150,796037,800700,-4663
1448,81,700943,39150,797490,801464,-3974
1449,89,701093,40900,799199,802300,-3101
1450,85,702899,40250,800281,803514,-3233
1451,88,703099,41750,800781,804694,-3913
1452,90,703229,39600,802781,805514,-2733
1453,89,703316,41350,802641,806676,-4035
1454,85,704052,37550,803141,807870,-4729
1455,86,704111,38500,802425,809176,-6751
1456,85,706219,38900,803559,810064,-6505
1457,90,706643,40050,804544,811064,-6520
1458,86,706960,40300,805696,811870,-6174
1459,81,707352,37350,807559,813294,-5735
1460,84,707383,38400,807475,814294,-6819
1461,88,707518,38600,808696,815794,-7098
1462,80,707676,36850,809594,816676,-7082
1463,85,708226,39800,810246,814548,-4302
1464,84,708842,38850,811144,817048,-5904
1465,84,709544,39300,812346,820048,-7702
1466,89,709829,40000,813396,823548,-10152
1467,81,710504,35100,813946,825048,-11102
1468,88,710844,39950,815194,827048,-11854
1469,81,710948,37350,817025,830098,-13073
1470,90,711010,42300,817046,832098,-15052
1471,90,711512,40500,819694,834198,-14504
1472,84,711520,37050,819809,835849,-16040
1473,90,711542,42750,820075,838198,-18123
1474,86,711901,38500,821096,841899,-20803
1475,87,713015,41250,822096,843798,-21702
1476,90,713372,41850,823194,846949,-23755
1477,87,714607,39900,824194,848848,-24654
1478,81,714906,38250,825309,850949,-25640
1479,87,715908,39900,826744,853999,-27255
1480,90,717184,39150,827105,856048,-28943
1481,87,717933,41250,828575,858499,-29924
1482,80,718179,35950,829294,860499,-31205
1483,89,718311,38200,830296,863049,-32753
1484,85,718355,40700,830605,865549,-34944
1485,84,718407,36150,821884,867549,-45665
1486,85,718670,36650,822778,870248,-47470
1487,88,719600,39950,823322,872748,-49426
1488,84,720511,37050,824017,874099,-50082
1489,80,720680,35500,825317,875898,-50581
1490,89,721109,42250,826220,878948,-52728
1491,83,721501,37450,826815,882149,-55334
1492,83,722014,37900,827875,884649,-56774
1493,90,722891,42300,829517,887548,-58031
1494,86,723763,38950,830113,889799,-59686
1495,85,725251,40700,830917,891548,-60631
1496,80,725745,35950,831613,894349,-62736
1497,86,727739,40300,832517,896849,-64332
1498,80,728084,36850,833163,900198,-67035
1499,84,728519,37500,834472,903748,-69276
1500,81,728807,37350,835417,906999,-71582
1501,88,728988,40400,837358,909748,-72390
1502,84,729062,39300,837365,912748,-75383
1503,88,729063,38150,837378,914848,-77470
1504,80,729699,38200,838205,917898,-79693
1505,88,730274,41750,841017,918149,-77132
1506,90,730281,37800,841365,847284,-5919
1507,85,730323,38900,841467,847976,-6509
1508,86,730616,38950,842358,828862,13496
1509,86,730770,37600,843575,830362,13213
1510,87,732676,39000,844905,832560,12345
1511,83,732694,37000,845125,834610,10515
1512,90,733108,42300,845863,835660,10203
1513,90,733146,40500,848955,838160,10795
1514,89,733179,42250,849020,841612,7408
1515,85,733743,40250,849565,844210,5355
1516,87,734331,40350,851028,847212,3816
1517,81,734893,38700,851505,850212,1293
1518,85,735003,38450,852908,838546,14362
1519,86,735677,38050,853520,839596,13924
1520,84,735970,37050,854028,840414,13614
1521,88,736430,41750,854667,841376,13291
1522,85,736707,38900,855667,842096,13571
1523,85,737438,38000,857267,843376,13891
1524,85,737502,37100,857422,843876,13546
1525,81,737976,36450,858267,845096,13171
1526,83,737984,38800,858717,846270,12447
1527,84,739254,36600,914598,847270,67328
1528,88,739376,40850,843241,847926,-4685
1529,89,739919,40900,844241,848926,-4685
1530,89,739987,39550,833911,849976,-16065
1531,83,741419,38350,837411,850820,-13409
1532,90,741473,41850,837535,851820,-14285
1533,86,741506,38950,837130,853450,-16320
1534,81,741512,38250,837603,854450,-16847
1535,82,742598,36500,838612,855296,-16684
1536,84,743705,37050,839961,856420,-16459
1537,84,744037,37950,842316,856970,-14654
1538,87,744080,38100,842235,857970,-15735
1539,85,744937,39800,843316,858500,-15184
1540,86,746330,38950,844112,858970,-14858
1541,80,746838,37300,845612,859676,-14064
1542,88,747365,38600,846303,860996,-14693
1543,90,747481,40500,846866,862064,-15198
1544,88,748014,40400,848011,863176,-15165
1545,80,749494,36400,848735,864100,-15365
1546,83,749923,38800,849630,865676,-16046
1547,83,750997,37000,850540,866564,-16024
1548,90,751594,41400,851561,867983,-16422
1549,80,752363,36850,852561,870033,-17472
1550,83,752550,36550,854866,872083,-17217
1551,85,752554,38000,854903,874610,-19707
1552,81,752836,36000,855866,876733,-20867
1553,82,753794,36950,856416,880660,-24244
1554,90,755218,42300,859299,882283,-22984
1555,90,755224,37800,859667,884710,-25043
1556,84,755744,36150,860849,884383,-23534
1557,83,757369,37000,865167,875776,-10609
1558,90,758304,39600,868217,876300,-8083
1559,82,759322,37850,869217,877614,-8397
1560,87,760115,40800,872217,878614,-6397
1561,82,760283,37850,874717,879614,-4897
1562,84,760465,37950,878267,881170,-2903
1563,87,760716,41700,881317,882170,-853
1564,83,760801,38800,881499,882846,-1347
1565,83,760933,38800,884225,883670,555
1566,84,760983,37500,887111,884114,2997
1567,89,762099,42250,889111,884976,4135
1568,80,762401,33700,891149,885450,5699
1569,80,762748,36850,893661,886450,7211
1570,85,762855,38900,896149,887220,8929
1571,84,763882,36150,898025,887976,10049
1572,88,765432,42200,901161,889096,12065
1573,86,765782,36250,904261,890220,14041
1574,89,765831,41800,904761,891526,13235
1575,82,765933,36500,907675,892526,15149
1576,86,766212,36250,909559,893126,16433
1577,85,766633,40700,911699,894096,17603
1578,87,769054,39000,913217,895596,17621
1579,83,769160,39250,915249,896720,18529
1580,80,769736,36850,918217,897626,20591
1581,87,770051,39450,920267,898814,21453
1582,85,770054,38450,922349,899146,23203
1583,81,770213,36450,924349,900314,24035
1584,86,770247,40300,926349,900370,25979
1585,82,770585,36950,928949,887117,41832
1586,82,770777,36950,930317,890604,39713
1587,87,770903,38100,932867,893117,39750
1588,86,771526,38950,936049,894617,41432
1589,84,771970,38400,938417,897204,41213
1590,85,772054,40700,942967,898617,44350
1591,83,772088,37450,943199,902117,41082
1592,85,772369,37550,946017,903304,42713
1593,83,772425,37000,946299,906717,39582
1594,87,772809,40800,948799,908892,39907
1595,80,774142,35950,951299,909986,41313
1596,90,774216,40500,953912,911767,42145
1597,81,774442,38250,955364,912362,43002
1598,90,774801,43200,956462,912862,43600
1599,80,775071,36850,957050,913486,43564
1600,81,775204,35550,955167,914486,40681
1601,88,775477,39050,957999,911404,46595
1602,85,776592,39350,958667,914954,43713
1603,80,777149,35950,960717,916867,43850
1604,86,778180,39850,961217,919504,41713
1605,84,778533,39750,962049,922504,39545
1606,87,779233,39450,935361,912352,23009
1607,89,779336,41350,939961,913602,26359
1608,88,781448,39500,942475,914460,28015
1609,87,782171,36750,944061,915102,28959
1610,90,782275,39600,947061,915960,31101
1611,83,782633,36550,955225,917102,38123
1612,88,782687,39500,953061,918602,34459
1613,85,782708,40250,955561,920010,35551
1614,84,786272,38850,956061,920890,35171
1615,82,786311,38300,903207,921890,-18683
1616,81,786942,38250,903970,922510,-18540
1617,86,787074,38500,905186,924060,-18874
1618,84,787436,40650,906915,925632,-18717
1619,85,788282,37550,907915,927152,-19237
1620,84,788539,38400,908807,928440,-19633
1621,80,790223,34600,910020,929002,-18982
1622,90,790317,42300,910186,929682,-19496
1623,88,791056,41300,911380,931502,-20122
1624,90,792196,41850,912407,931990,-19583
1625,85,792437,40700,913415,932502,-19087
1626,83,793391,37450,914186,932652,-18466
1627,83,794055,37000,915686,925577,-9891
1628,85,794107,38900,915620,928077,-12457
1629,85,794337,39800,917930,930127,-12197
1630,86,794417,38050,919480,932677,-13197
1631,87,794486,39900,919120,933177,-14057
1632,84,794734,37500,920065,922052,-1987
1633,83,795427,37000,908048,924701,-16653
1634,88,795440,39950,908025,926701,-18676
1635,89,795833,40900,909009,929152,-20143
1636,80,795955,37750,909957,931351,-21394
1637,85,797465,39350,910598,933202,-22604
1638,84,797666,39750,911525,935702,-24177
1639,90,797680,39150,912025,939401,-27376
1640,85,798931,38000,913025,942352,-29327
1641,83,799434,38350,913598,945902,-32304
1642,88,800018,37250,914098,947051,-32953
1643,81,800060,38250,904372,949551,-45179
1644,87,800640,36300,905372,950952,-45580
1645,84,801121,37500,906122,953651,-47529
1646,80,801442,35050,907122,955751,-48629
1647,80,801797,35500,908622,957901,-49279
1648,86,803304,38050,909472,961901,-52429
1649,84,803347,37050,910413,964102,-53689
1650,87,805419,40800,911413,967102,-55689
1651,86,806844,38050,913172,968102,-54930
1652,84,806885,37500,913375,970102,-56727
1653,88,806910,38150,913123,973551,-60428
1654,90,807603,40050,914172,976752,-62580
1655,84,808130,37050,915522,926462,-10940
1656,86,808429,41200,916513,928462,-11949
1657,89,809028,39100,917925,929962,-12037
1658,87,810002,38100,918722,932962,-14240
1659,90,810710,38700,919925,934562,-14637
1660,85,810926,41150,920823,936562,-15739
1661,80,811931,36850,921772,940062,-18290
1662,83,812404,36100,922622,941162,-18540
1663,85,812930,39800,923425,943312,-19887
1664,86,813698,40300,924925,946212,-21287
1665,85,815054,36650,927163,949262,-22099
1666,90,815152,39150,927222,951862,-24640
1667,85,815854,39800,927872,954762,-26890
1668,83,815898,37900,929163,956912,-27749
1669,90,816964,41850,930372,958462,-28090
1670,87,817153,40350,931525,961512,-29987
1671,88,817742,40850,931873,964112,-32239
1672,82,818026,39200,932822,965612,-32790
1673,84,818053,36150,934422,967962,-33540
1674,88,818093,41300,934423,970962,-36539
1675,80,820194,36400,935923,974512,-38589
1676,85,820241,38450,936072,977062,-40990
1677,88,820527,40850,937213,978812,-41599
1678,84,820653,38400,938072,980812,-42740
1679,82,821093,36500,938713,982812,-44099
1680,85,821320,38900,939572,923149,16423
1681,85,822667,37100,940622,925868,14754
1682,85,822683,38900,940872,927368,13504
1683,81,822729,36000,918527,929918,-11391
1684,84,822768,38400,913264,932018,-18754
1685,80,822922,36850,914764,935299,-20535
1686,88,823506,41300,915953,937018,-21065
1687,87,823595,39000,915764,939799,-24035
1688,90,824933,42300,917085,941568,-24483
1689,84,825223,37950,918011,944118,-26107
1690,86,826088,37600,919511,947399,-27888
1691,88,826502,38600,920314,950399,-30085
1692,83,826721,38350,921166,952168,-31002
1693,85,827926,40700,922166,954399,-32233
1694,80,828392,36400,923561,955999,-32438
1695,85,828535,35300,924216,959268,-35052
1696,89,828598,38650,925061,961318,-36257
1697,84,828766,37050,925814,963868,-38054
1698,88,829456,39500,927253,965868,-38615
1699,84,829805,39300,928385,968368,-39983
1700,87,830330,39000,929766,971368,-41602
1701,85,831589,40250,930314,973868,-43554
1702,90,831861,38250,931314,976199,-44885
1703,87,832728,38550,932314,977699,-45385
1704,83,832956,38350,933161,980199,-47038
1705,88,833221,35900,935866,982249,-46383
1706,88,833240,39050,934866,983249,-48383
1707,84,833316,37050,935803,964310,-28507
1708,82,833491,38300,936435,966536,-30101
1709,89,834421,41800,937823,968536,-30713
1710,86,834543,38050,939569,969810,-30241
1711,89,834970,41350,941872,972310,-30438
1712,89,836425,40900,942213,974636,-32423
1713,81,836841,36000,943075,976410,-33335
1714,83,837092,39250,943872,979410,-35538
1715,85,837444,39350,944975,981736,-36761
1716,87,837490,40350,945124,984342,-39218
1717,80,837928,36400,945763,985576,-39813
1718,87,838336,39450,946069,986811,-40742
1719,85,839387,40700,946485,987842,-41357
1720,82,839412,36950,946803,989311,-42508
1721,81,839721,35100,947466,990076,-42610
1722,90,840103,41400,948464,991861,-43397
1723,90,840405,39600,950064,993036,-42972
1724,80,840449,35500,950361,986836,-36475
1725,90,840612,42300,951485,991610,-40125
1726,88,841002,41300,952911,993160,-40249
1727,84,843362,37950,954353,996210,-41857
1728,86,846236,38950,955114,998710,-43596
1729,83,846352,37900,956114,999936,-43822
1730,87,846940,39900,957411,966720,-9309
1731,86,848682,39850,958516,967826,-9310
1732,80,848936,37300,955881,968826,-12945
1733,89,849028,43600,956707,969876,-13169
1734,85,852614,37100,948015,971376,-23361
1735,86,852800,38050,949211,972376,-23165
1736,89,853269,39100,949711,973014,-23303
1737,87,853315,40800,950820,973876,-23056
1738,82,853446,36950,951320,974514,-23194
1739,87,854307,38550,952015,975876,-23861
1740,85,854806,35300,953178,976870,-23692
1741,83,855351,36550,953870,977370,-23500
1742,81,856857,37350,955178,978370,-23192
1743,83,857214,37900,956370,979346,-22976
1744,86,858895,38500,957858,979370,-21512
1745,80,858905,36850,958228,967603,-9375
1746,86,859223,38950,960561,968603,-8042
1747,85,859224,38000,960665,969747,-9082
1748,81,859377,35100,961165,970103,-8938
1749,85,859708,38450,962508,971603,-9095
1750,89,859817,40000,963611,972603,-8992
1751,82,860117,37400,964715,973603,-8888
1752,81,860868,34650,966008,974573,-8565
1753,80,861325,36400,967008,975573,-8565
1754,82,861607,37400,967878,976103,-8225
1755,81,861872,36000,968715,977073,-8358
1756,83,862007,38350,969715,978297,-8582
1757,82,862588,36500,970520,979103,-8583
1758,84,864496,38400,971020,979910,-8890
1759,87,865359,36750,972058,981103,-9045
1760,87,866045,39900,972761,982410,-9649
1761,87,866094,39000,973578,983153,-9575
1762,85,866753,39350,974608,983753,-9145
1763,80,871863,37750,975520,984410,-8890
1764,83,872546,37000,976215,985297,-9082
1765,85,872671,40250,977108,986173,-9065
1766,90,873017,40950,977715,987403,-9688
1767,90,873217,40500,978215,989013,-10798
1768,86,873503,41200,979020,991563,-12543
1769,89,873871,40900,979658,993063,-13405
1770,90,875002,38250,981257,995347,-14090
1771,83,875064,38350,982078,998663,-16585
1772,86,875090,38950,984208,999847,-15639
1773,83,875114,37450,984078,993673,-9595
1774,86,875319,40750,985208,994953,-9745
1775,90,875620,40950,986361,996010,-9649
1776,80,876109,38650,987708,996773,-9065
1777,87,876238,38550,988465,997153,-8688
1778,90,876519,40950,989465,987295,2170
1779,86,877279,40300,991220,988927,2293
1780,86,877376,38500,991308,990927,381
1781,89,877928,40900,992128,992895,-767
1782,87,878145,39450,993308,995627,-2319
1783,88,878301,42200,994128,997627,-3499
1784,86,879849,40300,995015,999945,-4930
1785,85,880451,38000,996015,990562,5453
1786,83,880647,36550,997780,991062,6718
1787,85,880724,40250,998678,976032,22646
1788,80,880744,35950,998808,962902,35906
1789,88,881635,39950,999678,963902,35776
1790,85,881804,36350,999858,964338,35520
1791,81,883515,30450,999908,964890,35018
1792,84,883632,31750,998575,966187,32388
1793,82,884374,26950,999459,967308,32151
1794,81,884478,23250,999959,968002,31957
1795,80,884591,25100,986563,968838,17725
1796,88,885080,32150,988275,969940,18335
1797,86,885704,32150,988527,971237,17290
1798,81,885718,26300,989113,972440,16673
1799,85,886626,30650,990627,973808,16819
1800,85,886767,32850,991775,975052,16723
1801,87,888102,28950,992827,975737,17090
1802,82,889334,26850,994474,978101,16373
1803,80,889630,24900,995327,980601,14726
1804,89,890342,31850,996875,983101,13774
1805,90,890696,30900,997827,986299,11528
1806,84,890821,29200,998663,988701,9962
1807,83,890907,37300,999663,991201,8462
1808,82,890914,37400,999925,993751,6174
1809,80,891506,33750,985164,997251,-12087
1810,81,891584,33250,985312,998003,-12691
1811,80,892396,33200,986312,998825,-12513
1812,82,892670,28250,988505,999510,-11005
1813,82,892752,34300,988250,999825,-11575
1814,90,892961,36400,990505,987120,3385
1815,88,893053,33750,990514,989670,844
1816,89,893392,37800,991300,990554,746
1817,83,894054,32000,992412,993320,-908
1818,90,894455,31600,993300,998801,-5501
1819,83,894502,36750,995264,999851,-4587
1820,83,894794,33400,995814,999820,-4006
1821,88,895363,36350,997462,993040,4422
1822,80,896352,31350,998555,994040,4515
1823,84,896581,30950,999850,995288,4562
1824,87,896736,30350,999864,996058,3806
1869,86,917036,32250,998292,996937,1355
1869,86,917036,29300,999842,998090,1752
1870,89,917070,22400,999897,999108,789
1870,89,917070,20400,999947,999987,-40
1870,89,917070,18300,988643,998301,-9658
1870,89,917070,20200,989793,999337,-9544
1870,89,917070,21700,990681,999998,-9317
1870,89,917070,17650,992607,999887,-7280
1870,89,917070,19200,993607,991952,1655
1870,89,917070,21650,997107,992732,4375
1870,89,917070,20400,999841,993502,6339
1870,89,917070,17100,996611,994732,1879
1870,89,917070,17750,999661,995940,3721
1870,89,917070,8100,999978,997102,2876
1869,86,917036,6600,997937,998102,-165
1869,86,917036,15100,999320,998762,558
1869,86,917036,14050,999843,999602,241
1870,89,917070,6500,999937,999940,-3
1871,85,917636,10200,961418,993961,-32543
1871,85,917636,8600,961818,994628,-32810
1871,85,917636,11100,961918,995536,-33618
1871,85,917636,13000,962219,996461,-34242
1871,85,917636,11600,962549,997461,-34912
1872,89,918541,9100,962719,998128,-35409
1872,89,918541,10500,963049,999128,-36079
1872,89,918541,5200,963219,999961,-36742
1872,89,918541,14300,963549,981518,-17969
1872,89,918541,19100,963719,985518,-21799
1873,85,918789,17650,964381,987018,-22637
1873,85,918789,16550,966049,990294,-24245
1873,85,918789,16300,975199,993518,-18319
1873,85,918789,18050,972431,996844,-24413
1873,85,918789,12650,975699,998568,-22869
1873,85,918789,17150,978031,999844,-21813
1873,85,918789,14350,979531,981846,-2315
1873,85,918789,17750,985899,982802,3097
1873,85,918789,18000,986031,984028,2003
1873,85,918789,16000,986399,985420,979
1873,85,918789,17500,988899,986420,2479
1874,82,919304,22000,992031,988144,3887
1874,82,919304,19200,996899,990544,6355
1874,82,919304,16200,998949,992219,6730
1874,82,919304,11900,999449,993238,6211
1874,82,919304,14700,999949,994219,5730
1874,82,919304,8500,999968,994706,5262
1875,80,919378,6050,999468,995542,3926
1875,80,919378,500,968219,996206,-27987
1875,80,919378,500,968599,997042,-28443
1875,80,919378,2000,968719,998042,-29323
1875,80,919378,4600,969099,999899,-30800
1875,80,919378,12050,974099,999788,-25689
1876,90,919384,8500,972219,998278,-26059
1877,87,919507,8600,976099,998778,-22679
1878,86,919780,9050,978269,999778,-21509
1879,80,920133,13500,982269,999965,-17696
1880,90,920490,15300,984769,984918,-149
1881,88,920606,12650,986299,985218,1081
1882,80,920722,12150,987799,985418,2381
1883,86,920913,16050,994299,985718,8581
1884,88,920930,14650,993799,985918,7881
1885,89,921132,21750,996849,986218,10631
1886,86,921748,17200,998349,986807,11542
1887,86,922249,21200,999469,987807,11662
1888,89,922304,20250,999969,988490,11479
1925,83,935070,12800,983742,989490,-5748
1925,83,935070,13550,984401,990825,-6424
1925,83,935070,18100,987401,991857,-4456
1925,83,935070,16600,991451,992884,-1433
1924,83,935026,18650,991842,994384,-2542
1926,87,935198,21700,992842,994925,-2083
1926,87,935198,24500,995951,995857,94
1926,87,935198,26000,999642,996884,2758
1926,87,935198,26700,999501,997868,1633
1926,87,935198,18700,999794,998884,910
1926,87,935198,14600,977318,999868,-22550
1926,87,935198,12600,979318,999990,-20672
1926,87,935198,13700,981868,989468,-7600
1926,87,935198,9450,983368,989818,-6450
1926,87,935198,13700,988068,989968,-1900
1926,87,935198,12850,988018,990318,-2300
1926,87,935198,12650,989068,990468,-1400
1926,87,935198,12800,993168,990368,2800
1926,87,935198,19000,994168,990868,3300
1927,81,936061,15150,996668,990968,5700
1927,81,936061,20700,999568,992754,6814
1927,81,936061,15600,999668,993254,6414
1927,81,936061,17200,999871,995402,4469
1927,81,936061,8100,991702,997902,-6200
1927,81,936061,9150,994668,999902,-5234
1927,81,936061,8600,996368,992368,4000
1927,81,936061,12600,999718,992518,7200
1927,81,936061,7500,999868,992868,7000
1927,81,936061,500,968868,993018,-24150
1927,81,936061,500,968968,992918,-23950
1927,81,936061,50,968918,993418,-24500
1928,82,936222,500,969418,993518,-24100
1928,82,936222,500,969468,993918,-24450
1928,82,936222,500,969918,994018,-24100
1928,82,936222,500,969968,994418,-24450
1928,82,936222,500,970418,994518,-24100
1928,82,936222,500,970468,994918,-24450
1928,82,936222,500,970918,995018,-24100
1928,82,936222,500,970968,995418,-24450
1928,82,936222,1000,971468,995518,-24050
1929,87,937317,7100,975018,995918,-20900
1930,90,937672,9550,981518,996018,-14500
1931,83,937758,3550,981568,996418,-14850
1932,89,939989,4500,986018,996518,-10500
1933,83,940045,4000,985568,999518,-13950
1934,84,940364,5600,988618,999918,-11300
1935,81,940494,6050,991618,997018,-5400
1936,90,941720,2600,993168,997468,-4300
1937,86,942345,5600,995768,997068,-1300
1938,90,942360,3550,997668,997568,100
1939,87,944425,7500,999818,997968,1850
1956,81,952899,6500,988218,998068,-9850
1956,81,952899,6050,988368,999118,-10750
1958,81,953094,6050,988718,999894,-11176
1958,81,953094,2050,988418,999071,-10653
1958,81,953094,4050,989118,999621,-10503
1958,81,953094,5100,991618,977318,14300
1958,81,953094,4050,993318,979368,13950
1958,81,953094,3550,994818,983168,11650
1959,85,954040,5100,997168,984668,12500
1959,85,954040,4500,999168,985668,13500
1959,85,954040,2050,999968,987868,12100
1959,85,954040,500,990418,990668,-250
1959,85,954040,500,990768,993218,-2450
1959,85,954040,500,990918,995418,-4500
1959,85,954040,50,990818,997918,-7100
1959,85,954040,500,991318,999968,-8650
