job_id,tasks_num_of_single_job,task_generation_time,total_time,complation_time,complation_time_ordered,shortened_completion_time
0,12,477,88000,6156,6156,0
1,100,1048,920000,12654,8596,4058
3,31,1134,68500,4133,9595,-5462
3,31,1134,203500,7986,12836,-4850
4,96,1328,784000,12613,12653,-40
5,41,1503,244000,13096,11656,1440
6,80,1618,560000,13596,12986,610
7,54,1937,416000,18596,13095,5501
8,51,2396,444000,20226,17726,2500
9,96,2676,824000,26225,26226,-1
10,49,2772,356000,28725,29726,-1001
11,54,2929,376000,31726,32226,-500
12,94,3209,816000,34725,33726,999
13,13,3401,52000,32726,22095,10631
15,29,3444,132500,27726,23496,4230
15,29,3444,315500,33726,24106,9620
16,43,4490,292000,25615,23406,2209
17,58,4533,592000,25616,24513,1103
18,66,4566,584000,25236,28666,-3430
19,36,4726,304000,21796,26635,-4839
20,74,4904,616000,25796,30016,-4220
22,62,5476,176500,28926,28986,-60
22,62,5476,487500,26796,30396,-3600
23,11,5946,124000,30626,30205,421
24,86,6547,624000,31115,37706,-6591
25,25,6613,260000,31116,35516,-4400
26,26,6936,144000,28666,35896,-7230
27,98,6999,792000,36126,39666,-3540
28,35,7408,460000,35246,30646,4600
29,71,7513,724000,39926,35026,4900
30,37,7573,388000,39026,51226,-12200
31,70,7968,560000,45246,57726,-12480
32,19,8395,116000,47886,59226,-11340
33,57,8409,548000,57246,63226,-5980
34,72,8565,648000,62886,69226,-6340
35,88,8575,632000,63386,75226,-11840
36,14,8692,136000,60746,76226,-15480
37,98,9116,792000,84386,84226,160
38,33,9186,332000,85386,86726,-1340
39,78,9284,712000,89386,91226,-1840
40,38,9390,432000,91746,94226,-2480
41,91,9569,804000,96246,98726,-2480
42,71,9594,564000,96746,103226,-6480
43,27,10223,228000,100746,104226,-3480
44,25,10294,220000,99386,105726,-6340
45,69,10365,436000,102386,108726,-6340
46,87,10545,668000,101746,76315,25431
47,34,10802,296000,80776,76816,3960
48,73,10904,492000,80656,77816,2840
49,23,11341,132000,82656,78316,4340
51,41,11393,628500,79016,80815,-1799
51,41,11393,403500,78896,81315,-2419
52,50,11422,440000,78516,82315,-3799
53,76,11627,664000,83626,83315,311
54,81,11679,764000,83666,85716,-2050
55,95,11871,940000,88546,93716,-5170
56,10,12070,80000,59996,94716,-34720
57,100,12237,680000,89516,102215,-12699
58,80,12324,520000,89126,106716,-17590
59,77,12594,508000,89896,111716,-21820
60,16,12683,64000,86496,112716,-26220
61,90,12692,680000,89996,114715,-24719
62,76,12918,584000,93656,116306,-22650
63,60,13483,400000,102996,121806,-18810
64,63,13690,412000,106396,127306,-20910
65,40,13762,320000,106496,130805,-24309
66,40,14177,160000,107996,133805,-25809
67,36,14967,264000,111896,87716,24180
68,24,15118,256000,110996,84496,26500
69,44,15206,376000,111496,94843,16653
70,18,15769,192000,109386,89976,19410
71,91,15824,684000,110386,94946,15440
72,49,15984,316000,111386,95445,15941
73,36,16518,224000,116386,99656,16730
74,88,16756,672000,118366,100446,17920
75,34,16983,256000,122366,95476,26890
76,16,17037,104000,122386,95366,27020
77,86,17183,624000,124866,101056,23810
78,24,17201,136000,118386,100836,17550
79,31,17359,204000,125366,105843,19523
80,24,17529,176000,125386,106445,18941
81,79,17822,636000,130386,116156,14230
82,61,18285,444000,135366,116843,18523
83,90,18480,680000,136386,117556,18830
84,13,18573,92000,132886,121656,11230
85,72,18740,568000,141866,123056,18810
86,16,18835,184000,139886,127156,12730
87,95,19254,660000,143366,128445,14921
88,88,19277,712000,142886,132656,10230
89,38,19316,272000,140366,109716,30650
90,15,19603,100000,107908,107655,253
91,40,19776,440000,122396,133945,-11549
92,80,19885,600000,128406,134056,-5650
94,63,19932,392500,133666,138156,-4490
94,63,19932,571500,133416,143656,-10240
95,82,20012,648000,128616,144945,-16329
96,27,20097,268000,128166,149843,-21677
97,81,20136,884000,129896,150445,-20549
98,61,21268,524000,141116,154656,-13540
99,98,21390,712000,142616,155945,-13329
100,17,21404,108000,139396,153336,-13940
101,16,22111,184000,143616,156056,-12440
102,91,22384,924000,145896,160156,-14260
103,30,22808,120000,147116,159836,-12720
104,12,23075,48000,148116,160726,-12610
105,28,23493,192000,151116,161226,-10110
106,31,23730,364000,153616,162226,-8610
107,58,23757,432000,153896,163726,-9830
108,72,24177,648000,154896,165836,-10940
109,16,24941,104000,156616,166836,-10220
110,37,25251,188000,161616,168226,-6610
111,75,25415,580000,164346,170336,-5990
112,86,25532,584000,166846,172726,-5880
113,60,26104,400000,171846,174726,-2880
114,50,26144,440000,172335,176726,-4391
115,86,26847,784000,179846,179726,120
116,38,26946,272000,180846,180836,10
117,74,27253,536000,186835,184726,2109
118,55,27447,420000,189335,185226,4109
119,40,27660,320000,190846,134326,56520
120,95,27836,860000,194846,176656,18190
121,25,28157,260000,196835,136715,60120
122,50,28325,440000,192835,138715,54120
123,54,28521,376000,196846,139826,57020
124,53,28727,452000,196346,141215,55131
125,25,28975,340000,181396,177343,4053
126,84,29818,576000,184116,177446,6670
127,15,30211,140000,184396,144826,39570
128,28,30461,272000,184896,145576,39320
129,43,30960,452000,187896,178056,9840
130,49,31005,396000,188396,182156,6240
131,17,31097,68000,186896,151126,35770
132,65,31149,340000,189616,154626,34990
133,33,31613,212000,193396,182843,10553
134,73,31628,692000,192896,182946,9950
135,25,31642,180000,191896,183556,8340
137,71,31970,300500,194896,166576,28320
137,71,31970,403500,194396,170126,24270
138,71,32220,604000,199116,188446,10670
139,56,32359,504000,202396,177576,24820
140,65,32382,660000,202896,193843,9053
141,63,32482,532000,202425,187076,15349
142,14,32549,136000,201926,188076,13850
143,29,32606,196000,203896,190076,13820
144,84,32688,816000,204396,194445,9951
145,63,33888,412000,217425,196076,21349
146,85,34006,540000,218926,200126,18800
147,70,34076,560000,220925,206576,14349
148,10,34126,40000,217925,207126,10799
149,26,34520,104000,224925,208626,16299
150,63,34618,452000,226925,210076,16849
151,38,34848,272000,230425,169655,60770
152,72,35045,488000,232925,171155,61770
153,71,35563,524000,237425,199446,37979
154,86,36044,864000,246926,172307,74619
155,11,36278,44000,249426,172807,76619
156,12,36463,128000,252926,153136,99790
157,94,36526,616000,259926,158255,101671
158,55,36731,380000,257426,158256,99170
159,63,36772,652000,264926,199945,64981
160,78,36849,792000,263425,204156,59269
161,79,36932,716000,263926,204843,59083
162,59,36965,516000,260925,173807,87118
163,73,37311,532000,264925,204946,59979
164,79,37343,596000,261426,182705,78721
165,91,37364,724000,264425,189205,75220
166,25,38004,220000,211716,190536,21180
167,86,38087,464000,217846,197705,20141
168,29,38252,276000,225346,199036,26310
169,96,38270,904000,225846,204205,21641
170,74,38484,416000,231716,209705,22011
171,61,38672,484000,234346,214036,20310
173,28,38716,281500,234716,215705,19011
174,72,38741,187000,236216,217205,19011
174,72,38741,727500,236846,220036,16810
175,19,39022,196000,235216,220536,14680
176,84,39359,816000,244216,225036,19180
177,21,39803,204000,247216,226205,21011
178,32,39981,208000,250846,229036,21810
179,52,40127,488000,255346,231705,23641
180,11,40300,84000,257846,232036,25810
181,88,40670,672000,266846,235036,31810
182,26,40780,264000,269216,235705,33511
183,18,40997,152000,270846,236205,34641
184,47,41004,388000,273846,239205,34641
185,27,41340,268000,282716,240205,42511
186,85,41346,620000,284716,244705,40011
187,29,41418,196000,288846,246536,42310
188,60,41802,680000,297216,248036,49180
189,54,41907,336000,300716,252705,48011
190,97,41960,988000,303216,258705,44511
191,90,42006,880000,304716,263205,41511
192,38,42183,352000,309346,265205,44141
193,88,42498,752000,319846,278085,41761
194,47,42581,388000,320716,279586,41130
195,59,42758,436000,325346,282085,43261
196,54,43050,496000,334216,284086,50130
197,89,43165,596000,337716,287586,50130
198,40,43527,440000,344346,289086,55260
200,93,43595,376500,345716,291705,54011
200,93,43595,931500,347216,295705,51511
201,36,43997,224000,354716,299036,55680
202,53,44247,332000,363846,301036,62810
203,97,44386,628000,369346,306705,62641
204,75,44557,460000,370716,310205,60511
205,97,44767,668000,373216,317036,56180
206,34,44831,376000,371346,319705,51641
207,75,45018,820000,375346,323205,52141
208,20,45563,120000,378846,324205,54641
209,46,45654,344000,379346,327205,52141
210,43,45758,372000,381216,329036,52180
211,45,46140,180000,388346,332205,56141
212,33,46242,292000,391846,333205,58641
213,87,46530,748000,399846,336705,63141
214,80,46624,600000,399346,341036,58310
215,79,46730,596000,404346,345705,58641
216,54,46882,456000,406216,348536,57680
218,33,46961,240500,402846,351536,51310
218,33,46961,331500,406716,352705,54011
219,19,47067,196000,392346,353705,38641
220,43,47102,332000,405716,356205,49511
222,82,47197,120500,409716,356705,53011
222,82,47197,767500,410216,361205,49011
223,42,47310,288000,411716,364705,47011
224,54,47415,336000,411216,366205,45011
225,23,47644,132000,408846,367536,41310
226,25,47957,220000,416346,369036,47310
227,54,48019,456000,417216,371205,46011
228,23,48255,132000,416716,372036,44680
229,37,48581,268000,421216,373536,47680
230,78,48705,672000,421716,379536,42180
231,39,48990,276000,421846,382036,39810
232,29,50364,116000,426346,384536,41810
233,89,50530,676000,432346,389705,42641
234,64,50825,536000,437716,394536,43180
235,62,50870,368000,437846,398205,39641
236,69,50885,356000,434846,401705,33141
237,90,51070,760000,440216,407036,33180
238,86,51476,984000,442846,411205,31641
239,15,51791,140000,442716,411536,31180
240,45,51925,340000,446846,412536,34310
241,89,52361,676000,452716,416036,36680
242,36,52483,184000,453216,417036,36180
243,100,52522,920000,454216,421536,32680
245,89,53048,100500,460846,423205,37641
245,89,53048,675500,460216,427536,32680
246,19,53123,116000,457346,428036,29310
247,55,53270,220000,462346,429705,32641
248,35,53570,220000,465716,431205,34511
249,27,53743,228000,464846,432036,32810
250,54,54001,376000,467846,435205,32641
251,18,54238,72000,468216,436205,32011
252,76,54304,624000,472216,438705,33511
253,66,54682,464000,492545,441036,51509
254,84,54709,576000,493045,446036,47009
255,32,55007,288000,501546,447705,53841
257,46,55024,164500,500045,448536,51509
257,46,55024,423500,502546,451205,51341
258,49,55082,316000,504045,453036,51009
259,69,55189,436000,501545,456705,44840
260,49,55235,356000,507546,458536,49010
261,69,55627,756000,512545,460705,51840
262,68,55688,632000,518045,463536,54509
263,50,55747,680000,519045,465036,54009
264,71,55805,484000,521045,468036,53009
265,46,56314,304000,530545,470036,60509
266,49,56357,556000,533046,471536,61510
267,50,56389,320000,532545,473536,59009
268,94,56601,616000,538546,476536,62010
269,47,56998,348000,541045,478705,62340
270,52,57027,448000,540545,480536,60009
271,21,57148,164000,543045,481036,62009
272,22,57296,88000,544545,483205,61340
273,19,57610,196000,545046,484036,61010
274,38,58082,352000,550546,485536,65010
276,28,58264,80500,546046,483945,62101
276,28,58264,271500,553045,487036,66009
277,54,58378,336000,559545,491056,68489
278,74,58503,616000,559546,497556,61990
279,34,58733,296000,562046,501556,60490
280,59,58764,556000,566546,506445,60101
282,21,58878,144500,569045,507945,61100
282,21,58878,203500,570045,509945,60100
283,87,59300,628000,577046,518945,58101
284,99,59409,796000,578046,526556,51490
285,77,59597,668000,580045,532556,47489
286,24,60022,136000,585545,534556,50989
287,91,60330,564000,594545,544445,50100
288,52,60436,248000,595546,549556,45990
289,45,60893,420000,603045,551556,51489
290,67,60981,708000,605546,556056,49490
291,99,61030,836000,607546,564945,42601
292,40,61512,440000,616046,566445,49601
294,50,61566,300500,617046,568056,48990
294,50,61566,359500,617545,573445,44100
295,73,61655,532000,618046,579056,38990
296,59,61675,476000,617546,583945,33601
297,84,62068,776000,622045,591445,30600
298,19,62167,116000,619545,592445,27100
299,12,62484,88000,627545,593556,33989
300,64,62755,536000,630545,599056,31489
301,37,62945,388000,631046,600556,30490
302,75,63265,540000,634546,606556,27990
303,63,63691,492000,642545,609945,32600
304,19,63856,76000,648046,611445,36601
306,95,64233,636500,658545,621056,37489
306,95,64233,699500,659045,630945,28100
307,68,64521,392000,660545,636056,24489
308,67,64643,588000,662546,641056,21490
310,47,64894,52500,661046,642056,18990
310,47,64894,347500,665545,646056,19489
311,46,65456,344000,677545,649556,27989
312,80,65589,600000,683546,655445,28101
313,41,65598,284000,684045,659056,24989
314,91,65700,644000,685046,665056,19990
315,27,65920,268000,689045,667056,21989
316,92,66108,688000,692045,675056,16989
317,79,66326,716000,694046,682445,11601
318,45,66496,380000,696546,685056,11490
319,87,67107,668000,713045,692445,20600
320,54,67371,456000,720045,697445,22600
321,90,67439,600000,720546,703056,17490
322,95,67530,740000,721545,710556,10989
323,85,67782,580000,730046,716445,13601
324,59,67822,476000,730545,721556,8989
325,95,67894,780000,731046,730945,101
326,71,68089,604000,733045,735556,-2511
327,95,68249,940000,735545,742056,-6511
328,46,68308,184000,735045,746445,-11400
329,51,68489,364000,736545,751556,-15011
330,50,68496,360000,736546,754556,-18010
331,97,69456,748000,744045,763056,-19011
332,99,69586,876000,746046,771945,-25899
333,16,69724,144000,747546,772445,-24899
334,16,69811,104000,748045,774445,-26400
335,56,70333,424000,753545,778945,-25400
336,78,70505,872000,755545,784445,-28900
337,27,70669,268000,757546,787445,-29899
338,22,70752,168000,755546,788556,-33010
339,71,70831,564000,761545,794445,-32900
340,17,70890,188000,761046,796056,-35010
341,96,71007,624000,763545,803556,-40011
342,82,71295,648000,765545,810445,-44900
343,93,71567,572000,766546,819445,-52899
344,88,72879,632000,772546,827945,-55399
345,65,73281,660000,774545,833556,-59011
346,15,73554,140000,776546,835445,-58899
347,22,73820,128000,781545,837445,-55900
348,60,73958,560000,784045,843445,-59400
350,67,74011,300500,784046,847056,-63010
350,67,74011,587500,784546,853445,-68899
351,23,74056,132000,782546,854556,-72010
352,93,74345,772000,787546,862556,-75010
353,41,74967,324000,790545,866056,-75511
354,18,75090,192000,790546,867056,-76510
355,69,75494,516000,796545,872945,-76400
356,24,75758,176000,798546,875056,-76510
357,99,75853,876000,800545,882445,-81900
358,38,75958,392000,801045,885556,-84511
359,87,76356,908000,802545,891556,-89011
360,63,77039,452000,807045,897056,-90011
361,75,77374,580000,810046,903056,-93010
362,29,77730,156000,811545,905445,-93900
363,37,77959,348000,814546,908945,-94399
364,88,78567,672000,819546,916445,-96899
365,71,78615,564000,821546,920556,-99010
366,87,79078,628000,824546,927945,-103399
367,98,79412,712000,829546,938945,-109399
368,15,79512,220000,827045,940445,-113400
369,71,79657,524000,833045,947056,-114011
370,35,79767,340000,832045,545666,286379
371,58,80067,432000,843546,545906,297640
374,93,80244,168500,843045,547013,296032
374,93,80244,188500,845546,318018,527528
374,93,80244,931000,845045,551406,293639
375,66,80305,544000,846046,556906,289140
376,26,80519,224000,849546,341576,507970
377,13,80537,92000,853045,322518,530527
378,78,80581,672000,853545,558016,295529
379,24,80779,216000,852045,562166,289879
380,99,80916,596000,859045,562406,296639
381,94,80941,576000,859545,563516,296029
382,40,80966,520000,859546,569013,290533
383,91,81068,924000,861046,574513,286533
384,88,81585,672000,867045,574896,292149
385,33,81600,332000,868045,578906,289139
386,81,82007,724000,872545,580016,292529
387,68,82020,592000,873546,584166,289380
388,19,82072,276000,864546,415876,448670
389,47,82303,508000,875545,585516,290029
390,51,82544,444000,882046,416056,465990
391,81,82569,524000,881046,589906,291140
392,18,82570,192000,877046,591013,286033
394,69,83088,636500,890046,595166,294880
394,69,83088,635500,891046,600666,290380
395,78,83130,792000,891045,606166,284879
396,26,83207,144000,886046,606406,279640
397,19,83258,76000,892045,352746,539299
398,91,83382,644000,894045,607516,286529
399,21,83661,164000,894046,354576,539470
400,79,84006,836000,896546,611906,284640
401,44,84690,296000,897545,613396,284149
402,12,84773,88000,899045,357236,541809
403,64,85218,496000,902545,617406,285139
404,74,85346,616000,905046,618516,286530
405,75,85850,700000,909045,628166,280879
406,50,85906,400000,908546,629513,279033
407,59,86238,316000,913545,366236,547309
408,31,86481,164000,915045,368254,546791
409,27,86626,108000,914046,369754,544292
410,52,86629,528000,913546,633906,279640
411,25,86887,140000,916546,376175,540371
412,60,86909,400000,923545,635016,288529
413,81,87371,644000,926045,635396,290649
414,33,87403,372000,925046,640516,284530
415,34,87464,216000,926046,423536,502510
416,78,87567,432000,924545,640896,283649
418,53,87615,224500,920545,427056,493489
418,53,87615,251500,925545,409754,515791
419,16,88284,64000,541966,410754,131212
420,72,88499,728000,557965,646013,-88048
421,23,88499,172000,551965,429036,122929
422,74,88573,616000,558965,650166,-91201
423,43,88690,292000,557966,650406,-92440
424,90,88728,600000,559966,655906,-95940
425,10,88931,40000,555465,435754,119711
426,12,89039,88000,562966,437175,125791
427,52,89241,408000,565965,657013,-91048
428,66,89506,624000,569465,661406,-91941
429,20,89646,160000,571466,662516,-91050
430,74,90015,656000,580966,454754,126212
431,20,90073,80000,574966,457175,117791
432,87,90146,668000,584966,668013,-83047
433,38,90184,272000,583465,668396,-84931
434,41,90323,284000,586466,467175,119291
435,83,90372,932000,587465,677666,-90201
436,38,90697,312000,589966,677906,-87940
437,43,91091,452000,592966,679013,-86047
438,45,91231,420000,593466,679396,-85930
439,51,91666,404000,595465,683406,-87941
440,62,91988,368000,599465,487175,112290
441,65,92527,540000,607966,684516,-76550
442,16,92575,224000,596465,684896,-88431
443,98,92826,592000,616465,688906,-72441
444,17,92945,68000,618465,500254,118211
445,55,93025,380000,616966,690013,-73047
446,80,93091,600000,621465,690396,-68931
447,65,93122,420000,620965,694166,-73201
448,84,93799,816000,634466,695513,-61047
449,61,93852,564000,635465,699666,-64201
450,52,93958,288000,635966,524254,111712
451,48,94266,472000,639466,699906,-60440
452,13,94691,92000,638465,527675,110790
453,53,94806,412000,647966,701016,-53050
454,32,94853,248000,647465,533254,114211
455,32,94935,168000,658966,535254,123712
456,54,94956,456000,657965,705166,-47201
457,94,95218,656000,664465,706513,-42048
458,54,95309,336000,661465,706896,-45431
459,34,95468,336000,666466,710666,-44200
460,68,95530,592000,673465,712016,-38551
461,23,95680,92000,663966,555175,108791
462,80,95688,600000,674966,716166,-41200
463,16,96055,64000,672966,563254,109712
464,96,96173,544000,685466,717513,-32047
465,78,96192,552000,689465,573254,116211
466,94,96215,736000,690465,721666,-31201
467,56,96425,544000,691465,727406,-35941
468,73,96595,732000,692965,728513,-35548
469,31,96906,124000,695465,584675,110790
470,68,97337,472000,702465,728516,-26051
471,43,97449,452000,699466,734016,-34550
472,64,97868,456000,711466,596175,115291
473,46,97931,344000,708465,598754,109711
474,32,98354,248000,716965,600675,116290
475,87,98387,1028000,716966,739513,-22547
476,100,98503,920000,719465,745013,-25548
477,42,98558,328000,717466,745016,-27550
478,36,99281,184000,721465,618754,102711
479,12,99423,88000,724965,745396,-20431
480,34,99728,336000,726965,620754,106211
481,89,99758,716000,727966,749406,-21440
482,57,100189,548000,735465,750896,-15431
483,77,100229,508000,735466,756013,-20547
484,12,100443,48000,708536,636754,71782
485,66,100533,464000,739966,760166,-20200
487,95,100694,112500,741466,641675,99791
487,95,100694,859500,743465,761513,-18048
488,55,100962,460000,746465,765906,-19441
489,90,101151,800000,748465,771406,-22941
490,24,101179,216000,744966,658675,86291
491,69,101422,476000,751965,664175,87790
493,94,101834,61500,753466,664754,88712
493,94,101834,890500,755465,772896,-17431
494,69,101843,556000,754965,673754,81211
495,26,102095,264000,748036,776666,-28630
497,73,103355,100500,763536,776906,-13370
497,73,103355,531500,764536,778016,-13480
498,55,103542,380000,766775,782166,-15391
499,42,103581,368000,765775,687175,78600
500,18,103683,112000,763966,688175,75791
501,54,103846,376000,768536,782406,-13870
502,63,105287,452000,776036,695175,80861
503,59,105304,596000,776275,783896,-7621
504,22,105626,128000,778036,701254,76782
505,45,105959,220000,782775,704254,78521
506,25,106463,220000,785775,706254,79521
507,51,106548,404000,788775,710175,78600
508,100,106867,840000,796036,789013,7023
509,44,106911,416000,794536,789016,5520
510,74,107503,656000,808536,793406,15130
511,60,107706,440000,811536,794513,17023
512,66,107711,504000,811775,794516,17259
513,97,107769,788000,812036,798906,13130
514,54,108827,576000,814036,743175,70861
515,80,109906,520000,825775,800396,25379
516,13,110012,52000,826036,747675,78361
517,91,110369,564000,834775,804166,30609
518,38,110443,152000,838536,754754,83782
519,30,110478,200000,836536,804406,32130
520,87,110678,588000,841036,759254,81782
521,81,111254,764000,853036,805513,47523
522,81,111287,724000,852775,805896,46879
523,78,111588,992000,858275,811013,47262
524,79,112064,596000,865275,815166,50109
525,88,112260,552000,868275,816513,51762
526,25,112658,220000,868775,816516,52259
527,66,113195,504000,876536,816896,59640
528,60,113420,560000,875536,820666,54870
529,58,113795,392000,884536,820906,63630
530,50,114014,280000,886536,822016,64520
531,63,114071,652000,888536,826406,62130
532,40,114098,280000,889775,791175,98600
533,61,114692,684000,902775,827513,75262
535,87,114963,456500,911036,827516,83520
535,87,114963,907500,911775,831906,79869
536,98,115000,632000,912275,833013,79262
537,23,115313,132000,924536,804754,119782
538,23,115498,132000,923275,806436,116839
539,84,115566,576000,934036,833016,101020
540,36,115632,144000,936275,812936,123339
541,99,115668,756000,932775,833396,99379
542,28,115909,192000,944036,837166,106870
543,87,115914,788000,942775,837406,105369
544,64,115951,576000,945275,827425,117850
545,67,116044,668000,945775,838516,107259
546,80,116273,600000,949536,842666,106870
547,86,116787,664000,955775,846436,109339
548,94,117318,616000,962536,852425,110111
549,97,117709,828000,962775,857936,104839
550,63,117731,452000,962275,861425,100850
551,25,118207,100000,892466,863425,29041
552,80,118744,600000,897465,870936,26529
553,62,118827,368000,896965,875425,21540
554,14,119472,96000,897466,875925,21541
555,69,119538,396000,906966,879936,27030
556,17,119566,68000,902465,881436,21029
557,73,119711,532000,909966,885436,24530
559,61,119804,668500,914466,892936,21530
559,61,119804,403500,914965,894925,20040
560,83,120160,732000,921965,900925,21040
561,35,120193,300000,923965,902425,21540
562,89,120499,1076000,928465,905925,22540
563,38,120562,232000,927966,909425,18541
564,46,120691,384000,928965,911936,17029
565,39,120724,236000,929465,914425,15040
566,96,120967,984000,932465,919425,13040
567,20,121431,160000,933966,919925,14041
568,90,121485,840000,936966,926425,10541
569,66,121605,544000,938965,930436,8529
570,19,121647,116000,935465,932425,3040
571,53,122255,372000,949966,935936,14030
572,93,122322,1052000,949466,941936,7530
573,15,122648,100000,956466,943425,13041
574,54,122694,456000,958966,946925,12041
575,86,122736,904000,961965,953436,8529
576,45,122810,380000,959966,955936,4030
577,85,122942,580000,967466,962425,5041
578,72,122994,528000,968466,965425,3041
579,79,123012,596000,966466,969936,-3470
580,26,123107,224000,969466,971925,-2459
581,33,123269,252000,970965,973425,-2460
582,82,123358,448000,971965,977436,-5471
583,25,124241,260000,980466,978925,1541
584,56,124453,464000,985465,981436,4029
585,66,124552,544000,985966,984436,1530
586,85,124773,740000,989965,988436,1529
587,14,124853,136000,990965,988936,2029
588,95,124872,780000,990466,994425,-3959
589,21,124896,164000,991465,994936,-3471
591,59,125186,264500,994465,996925,-2460
591,59,125186,435500,994466,999425,-4959
592,46,125668,384000,997965,999936,-1971
593,27,125909,148000,998966,890175,108791
594,63,126017,448000,999966,890675,109291
595,21,126132,164000,999466,891175,108291
596,52,126413,344000,998466,690386,308080
597,21,126861,196000,740614,690646,49968
598,97,126995,684000,746114,892675,-146561
599,43,127116,180000,498675,893254,-394579
600,81,127696,584000,746115,893754,-147639
601,94,128192,792000,746116,894175,-148059
602,35,128642,200000,499675,635036,-135361
603,31,128702,152000,499681,696146,-196465
604,38,129189,400000,751615,701386,50229
605,62,129499,392000,751126,706026,45100
606,15,129602,56000,378809,706886,-328077
607,74,129748,556000,751616,894675,-143059
608,91,129936,788000,751615,895175,-143560
610,45,130171,80500,628654,710986,-82332
610,45,130171,455500,757115,895254,-138139
611,26,130330,208000,756626,711526,45100
612,93,131054,752000,762615,895754,-133139
613,13,131118,92000,762614,684496,78118
614,95,131126,924000,757116,896175,-139059
615,72,131209,616000,639613,896254,-256641
616,63,131284,388000,634546,722526,-87980
617,10,131573,36000,366241,645815,-279574
618,30,131631,228000,762126,722526,39600
619,45,131846,324000,645546,706416,-60870
620,91,132016,660000,762615,723646,38969
621,100,132023,712000,762616,896675,-134059
622,14,132284,128000,767626,711916,55710
623,80,132431,696000,650613,897175,-246562
625,75,132846,120500,651046,237436,413610
625,75,132846,575500,650925,897675,-246750
626,91,133002,848000,656425,739026,-82601
627,96,133346,732000,768114,898175,-130061
628,72,133375,508000,661613,898254,-236641
630,72,133640,76500,768115,739026,29089
630,72,133640,459500,666926,733916,-66990
632,43,133702,84500,656546,898754,-242208
632,43,133702,323500,768116,899175,-131059
633,64,133770,336000,617936,248436,369500
634,71,133812,624000,544656,899254,-354598
635,45,133860,412000,768115,899675,-131560
636,82,134548,576000,672925,899754,-226829
637,49,134704,464000,773614,744526,29088
638,56,134771,364000,667154,900175,-233021
639,31,135022,268000,672613,900254,-227641
640,32,135077,188000,672654,900675,-228021
641,58,135077,324000,678154,900754,-222600
642,57,135500,448000,773616,749486,24130
643,36,135517,324000,773615,750316,23299
644,55,136462,472000,779114,901175,-122061
645,61,136707,412000,683925,755816,-71891
646,28,136968,184000,561546,755526,-193980
647,64,137049,548000,689113,901254,-212141
649,59,137223,388500,779115,901675,-122560
649,59,137223,323500,779115,901754,-122639
650,41,137569,320000,689425,902175,-212750
651,94,137921,720000,779116,902754,-123638
652,16,138099,52000,514809,409133,105676
653,73,138256,712000,784126,875906,-91780
654,39,138440,312000,520309,903175,-382866
656,60,138917,524500,784615,766916,17699
656,60,138917,671500,705426,904175,-198749
657,70,138925,456000,699926,904254,-204328
658,86,138943,776000,695046,904754,-209708
659,16,139236,224000,700154,772496,-72342
660,86,139516,760000,700546,905175,-204629
661,99,139568,544000,624936,905254,-280318
662,92,139947,776000,705613,905754,-200141
663,85,140046,620000,784615,906254,-121639
664,24,140408,156000,784616,547876,236740
665,98,140729,660000,789626,906675,-117049
666,12,140800,120000,790114,906754,-116640
667,56,141224,492000,710926,788916,-77990
668,10,141593,80000,633666,788916,-155250
669,31,141712,280000,644046,548106,95940
670,33,141775,368000,644666,789095,-144429
671,23,141965,120000,643656,907175,-263519
672,96,142139,668000,711113,794496,-83383
673,57,142170,656000,790115,799996,-9881
674,44,142173,348000,644026,805316,-161290
675,76,142369,760000,711546,877016,-165470
676,26,142539,220000,790115,553556,236559
677,79,142555,604000,721926,907254,-185328
678,64,142694,544000,790116,907754,-117638
679,36,143998,212000,722425,908254,-185829
680,55,144194,360000,795126,908675,-113549
681,14,145294,132000,589807,816416,-226609
682,54,145469,352000,589307,909175,-319868
683,28,145748,100000,592796,909254,-316458
685,66,146033,204500,666026,909675,-243649
685,66,146033,603500,795614,877396,-81782
687,55,146207,140500,666046,821816,-155770
687,55,146207,479500,795616,909754,-114138
688,26,146268,212000,795615,910175,-114560
689,100,146302,848000,795615,910675,-115060
690,38,146426,264000,671156,910754,-239598
691,11,146547,84000,661166,911175,-250009
692,73,146733,532000,677046,911254,-234208
693,32,147091,288000,738613,911754,-173141
694,27,147104,228000,677026,537518,139508
695,40,147151,240000,738426,912254,-173828
696,17,147454,148000,682526,838316,-155790
697,68,147988,432000,682546,912675,-230129
698,75,148063,740000,800626,912754,-112128
699,74,148326,576000,744113,795146,-51033
700,17,148372,188000,801114,540018,261096
701,87,148765,468000,688156,913175,-225019
702,74,148999,736000,801115,844095,-42980
703,56,149286,464000,801116,913675,-112559
704,76,149442,904000,806126,914175,-108049
705,84,149519,616000,801115,914675,-113560
706,96,149652,784000,806614,915175,-108561
707,22,149951,248000,806615,855095,-48480
708,11,150356,44000,667016,544736,122280
709,23,150446,92000,668016,535805,132211
710,36,151388,264000,705166,537526,167640
711,85,151444,620000,806615,915254,-108639
712,75,151525,500000,760426,860316,-99890
713,51,151971,484000,715526,915675,-200149
714,76,152056,584000,811626,916175,-104549
715,67,152594,428000,760613,916254,-155641
716,95,152709,780000,812114,916754,-104640
717,37,153188,188000,698516,917175,-218659
718,17,153678,188000,766154,551236,214918
719,78,154148,512000,812115,882516,-70401
720,67,154205,428000,721026,564606,156420
721,36,154954,384000,812115,860595,-48480
722,10,155016,80000,721156,810526,-89370
724,61,155303,748500,812116,917254,-105138
724,61,155303,403500,817126,917754,-100628
725,97,155508,628000,766425,918175,-151750
726,85,155823,460000,771426,918254,-146828
727,71,155864,404000,817615,569876,247739
728,53,155932,532000,817616,865996,-48380
729,100,156074,680000,758516,918754,-160238
730,33,156239,172000,760386,560736,199650
731,99,156332,716000,823115,919254,-96139
732,82,156358,648000,817615,919675,-102060
733,87,156457,748000,823114,871416,-48302
734,14,156547,176000,823116,871416,-48300
735,15,156649,60000,766516,520633,245883
736,42,157104,248000,772886,521133,251753
737,43,157313,292000,777546,570226,207320
738,87,157340,588000,828126,871496,-43370
739,19,158033,76000,786386,919754,-133368
740,98,158080,672000,788016,920754,-132738
741,99,158163,876000,828614,921175,-92561
742,90,158477,800000,833626,922175,-88549
743,88,158868,672000,834114,923175,-89061
744,12,158994,88000,797886,535714,262172
745,61,159464,604000,806886,877095,-70209
746,74,159485,616000,834115,923254,-89139
747,35,159577,220000,807886,882416,-74530
748,32,160412,288000,812886,923675,-110789
749,82,160678,728000,834116,887816,-53700
750,13,160973,52000,819516,381296,438220
751,87,161320,828000,839614,924175,-84561
752,44,161477,296000,831386,575556,255830
753,78,161562,552000,839126,924254,-85128
754,65,161623,340000,835516,924675,-89159
755,91,162143,764000,841386,924754,-83368
756,49,162152,396000,840516,925175,-84659
757,40,162931,240000,855516,925675,-70159
758,72,162977,648000,855886,893496,-37610
759,72,163003,808000,856386,898996,-42610
760,69,163154,636000,859516,838026,21490
761,60,163464,560000,860016,926175,-66159
762,63,163495,492000,861886,904316,-42430
763,49,164237,396000,865386,926254,-60868
764,63,164698,412000,869516,926675,-57159
765,27,164835,228000,871886,904416,-32530
766,34,165013,296000,872886,926754,-53868
767,58,165265,512000,879516,585236,294280
768,22,165415,168000,872016,927175,-55159
769,83,165665,732000,892016,927675,-35659
770,87,165748,828000,892386,909916,-17530
771,78,165865,632000,896886,849026,47860
772,95,166072,820000,902886,928175,-25289
773,20,166209,160000,904386,928675,-24289
774,65,166226,580000,905386,929175,-23789
775,88,166415,872000,908016,929675,-21659
776,50,166529,240000,909516,929754,-20238
777,23,166615,212000,910016,930175,-20159
778,40,167227,280000,920516,930254,-9738
779,66,167294,744000,923516,926416,-2900
780,62,167468,528000,926016,931175,-5159
781,89,167663,676000,931386,931675,-289
782,16,167671,144000,931516,931816,-300
783,14,167713,96000,928516,931754,-3238
784,53,168087,332000,937016,932175,4841
785,68,168533,672000,943016,932675,10341
786,54,168614,456000,941016,932754,8262
787,66,168639,544000,945386,933175,12211
788,29,168855,236000,947886,860886,87000
789,65,168997,540000,948516,933254,15262
790,23,169106,132000,948886,595214,353672
791,19,169297,156000,949386,595714,353672
792,45,170056,340000,958516,937316,21200
793,48,170442,432000,964386,937416,26970
794,70,170570,560000,969016,937416,31600
795,47,170589,348000,967886,937496,30390
796,76,170681,544000,970886,942816,28070
797,60,170938,560000,980516,942916,37600
798,61,170967,404000,979886,942996,36890
799,56,170970,464000,975886,870486,105400
800,86,171420,864000,987516,948316,39200
801,97,171540,908000,988516,948416,40100
802,27,171664,188000,988886,948496,40390
803,96,172521,788000,999886,948595,51291
804,94,172529,708000,997516,953816,43700
805,53,172801,296000,998886,660305,338581
806,54,172907,260000,883616,665305,218311
807,78,172946,512000,999516,953916,45600
808,57,173086,500000,889866,953916,-64050
809,76,173386,560000,907116,953996,-46880
810,62,173435,440000,908616,691305,217311
811,69,173561,548000,912866,938254,-25388
812,95,173580,500000,912366,954095,-41729
813,72,173658,472000,915866,876526,39340
814,96,174008,592000,927116,959416,-32300
815,19,174196,60000,929366,723646,205720
816,69,174427,344000,936616,959416,-22800
817,46,174538,376000,940116,959595,-19479
818,15,174824,52000,946616,939754,6862
819,50,175080,356000,954616,964816,-10200
820,99,175088,804000,955116,964916,-9800
821,37,175306,96000,959116,940675,18441
822,64,175321,616000,959366,965095,-5729
823,59,175554,400000,963366,970416,-7050
824,20,175586,80000,951116,941254,9862
825,21,175664,192000,965366,941675,23691
826,35,176041,348000,969366,942175,27191
827,45,176204,248000,973616,970416,3200
828,27,176461,196000,978116,970496,7620
829,84,176762,832000,986616,975916,10700
831,76,176904,189500,987866,943175,44691
831,76,176904,502500,988616,975996,12620
832,15,177158,40000,990366,943675,46691
833,15,177661,168000,996366,893896,102470
834,77,177739,568000,997116,976095,21021
835,19,177884,96000,997366,887526,109840
836,13,178504,112000,932047,888386,43661
837,49,178678,460000,999116,981316,17800
838,79,178898,516000,999866,981416,18450
839,87,178965,468000,940047,944675,-4628
840,36,179093,176000,939309,981595,-42286
841,47,179368,248000,940809,944754,-3945
842,55,179718,376000,941809,893886,47923
843,37,180350,152000,943547,986816,-43269
844,69,180498,300000,946547,986916,-40369
845,27,180652,164000,947809,986996,-39187
846,80,180738,352000,948309,987095,-38786
847,18,181035,160000,950309,992316,-42007
848,68,181109,532000,950809,992595,-41786
849,61,181547,328000,955309,868146,87163
850,87,181984,564000,961547,874646,86901
851,33,182024,252000,960547,997816,-37269
853,78,182347,316500,961309,882146,79163
853,78,182347,351500,963275,997916,-34641
855,95,183246,57500,968156,887305,80851
855,95,183246,478500,969156,899646,69510
856,44,183330,184000,971656,898646,73010
857,55,183429,384000,972275,997996,-25721
858,11,183593,104000,971275,998095,-26820
859,51,183824,384000,973275,905805,67470
860,86,184125,572000,974156,947175,26981
861,18,184224,16000,974275,913805,60470
862,76,185045,576000,980775,921146,59629
863,60,185270,468000,984275,947565,36710
864,23,185352,156000,981656,948065,33591
865,30,185395,260000,984156,931146,53010
866,22,185486,72000,986275,932805,53470
867,61,185625,384000,987275,936646,50629
868,42,185781,272000,988275,939805,48470
869,30,185996,212000,990775,948065,42710
870,35,186147,176000,992656,948565,44091
871,52,186449,248000,995656,950146,45510
872,82,186608,496000,998275,957146,41129
873,63,186670,336000,999156,961146,38010
875,89,187066,284500,999275,968146,31129
875,89,187066,363500,998656,975305,23351
876,68,187128,532000,999775,981646,18129
877,15,187247,140000,999656,982146,17510
879,38,187533,73500,985026,985305,-279
880,86,187583,263000,990656,988146,2510
880,86,187583,463500,990526,995646,-5120
882,68,187854,116500,995656,999646,-3990
882,68,187854,227500,991166,999805,-8639
883,79,189215,656000,996156,952065,44091
884,35,189702,116000,942113,952065,-9952
885,57,189993,164000,942154,785936,156218
886,44,190064,188000,996666,952565,44101
887,98,190474,280000,927615,952565,-24950
889,100,190567,105500,942425,798325,144100
889,100,190567,506500,942546,953565,-11019
890,60,190645,208000,948046,909526,38520
891,81,190744,264000,952926,954065,-1139
892,81,190766,508000,938126,954565,-16439
893,46,191019,328000,947654,914486,33168
894,64,191020,132000,802593,955065,-152472
895,59,191162,276000,953113,915026,38087
896,28,191203,128000,803155,827936,-24781
897,78,191271,276000,958426,833325,125101
898,28,191404,120000,933116,834936,98180
899,94,191562,404000,958925,955065,3860
900,44,191832,412000,959046,842825,116221
901,86,192001,524000,964154,955565,8589
902,74,192165,536000,963926,955565,8361
903,56,192273,300000,969426,956065,13361
904,20,192280,180000,964546,857825,106721
905,95,192738,644000,975425,956565,18860
906,92,192796,588000,975154,956565,18589
907,89,192943,516000,975546,957065,18481
909,37,193620,201500,980654,957565,23089
909,37,193620,222500,980426,957565,22861
910,72,193750,324000,944116,881825,62291
911,31,194618,112000,826093,884436,-58343
912,15,194705,64000,827093,884936,-57843
913,65,194764,312000,830155,889825,-59670
914,20,194917,172000,986425,920526,65899
916,100,195043,28500,831155,891436,-60281
916,100,195043,483500,986546,958065,28481
917,52,195193,392000,991654,958565,33089
918,21,195261,92000,985926,958565,27361
919,51,195781,348000,997425,920526,76899
920,93,195897,648000,997154,959065,38089
921,77,196049,368000,837896,960065,-122169
922,39,196157,224000,997113,960565,36548
923,79,196267,556000,842896,921646,-78750
924,41,196307,136000,839655,960565,-120910
925,71,196335,312000,997546,961065,36481
926,37,196346,172000,839593,927825,-88232
927,97,197122,348000,848896,961565,-112669
928,15,197342,88000,955115,934936,20179
929,81,197481,404000,854016,940436,-86420
930,45,197538,140000,955116,943325,11791
931,10,197566,24000,419160,943436,-524276
932,64,197741,296000,860016,962065,-102049
934,80,197793,192500,854516,950936,-96420
934,80,197793,403500,955115,962065,-6950
935,37,198082,168000,865016,962565,-97549
936,70,198244,376000,960615,963065,-2450
937,18,198658,48000,857655,962436,-104781
938,91,198672,580000,960614,968825,-8211
939,24,198863,140000,876396,970436,-94040
940,44,198891,192000,881126,973825,-92699
941,69,198926,264000,960616,977436,-16820
942,20,199177,116000,965626,978825,-13199
943,51,199368,256000,887396,980825,-93429
945,97,199458,28500,864593,981325,-116732
945,97,199458,463500,966115,986325,-20210
946,43,199526,248000,966115,987936,-21821
947,77,200419,316000,971126,991825,-20699
948,37,201171,88000,868593,993936,-125343
949,74,201405,308000,971614,995436,-23822
950,100,201799,456000,976626,999936,-23310
951,55,201967,232000,977114,931526,45588
952,62,202033,324000,971615,915216,56399
953,23,202129,52000,874093,745133,128960
954,22,202385,40000,875155,932386,-57231
955,36,202693,120000,903896,920336,-16440
956,20,203431,72000,876093,747214,128879
957,57,203604,372000,977116,920595,56521
958,17,204457,20000,877155,748214,128941
959,75,204473,380000,982126,966065,16061
960,90,205175,380000,982614,936486,46128
961,41,205214,164000,982615,750714,231901
962,54,205513,352000,982615,966565,16050
963,72,205875,236000,920016,967065,-47049
964,85,205888,328000,926016,967565,-41549
965,20,206056,160000,936126,968065,-31939
966,72,206168,448000,942516,968565,-26049
967,54,206406,188000,931516,969065,-37549
968,91,206465,296000,952896,969565,-16669
971,13,206520,348500,947896,969565,-21669
970,17,206494,132000,897093,757214,139879
972,73,206650,24000,596160,970065,-373905
972,73,206650,427500,953016,953716,-700
973,82,206733,252000,958896,970065,-11169
974,35,207026,300000,964016,958976,5040
975,98,207122,528000,987626,970565,17061
976,93,207562,384000,988115,970565,17550
977,81,207637,232000,969126,942526,26600
978,35,207882,160000,988114,964476,23638
979,64,208541,216000,969396,971565,-2169
980,43,208687,240000,988115,972065,16050
981,11,208826,16000,910155,280807,629348
982,16,209266,32000,909593,764633,144960
983,90,209289,408000,975516,969836,5680
984,88,209523,420000,988116,970095,18021
985,45,209853,200000,993614,973216,20398
986,85,210833,316000,993615,975595,18020
987,92,211020,412000,993616,768714,224902
988,28,211155,128000,986396,978716,7680
989,39,211171,164000,998626,980836,17790
990,43,212295,260000,999115,770633,228482
991,94,212491,336000,999115,981216,17899
992,44,212744,224000,997516,984216,13300
993,69,212898,188000,932093,986336,-54243
994,93,213046,252000,933155,986716,-53561
995,11,213299,36000,931655,772696,158959
996,76,213358,204000,999116,992216,6900
997,75,213695,216000,937593,995216,-57623
999,43,214126,68500,940655,997336,-56681
1000,79,214226,96000,941093,779195,161898
1000,79,214226,171500,941155,997476,-56321
1001,60,214443,172000,941655,997716,-56061
1002,84,214908,164000,944655,783696,160959
1003,96,215112,200000,946093,785695,160398
1004,28,215142,96000,943655,786195,157460
1006,61,215867,96500,946155,948886,-2731
1006,61,215867,163500,952155,949146,3009
1007,32,216012,100000,948655,789195,159460
1008,48,216093,116000,955155,791195,163960
1009,59,216129,124000,955655,792695,162960
1010,51,216317,108000,959593,793196,166397
1012,69,216526,284500,960655,796695,163960
1013,87,216578,152000,959655,797696,161959
1013,87,216578,251500,960093,799195,160898
1014,28,216606,44000,961093,799695,161398
1015,41,216803,136000,958593,801695,156898
1016,46,217092,136000,961155,803195,157960
1017,41,217835,84000,962655,803695,158960
1018,69,218136,156000,965593,804196,161397
1020,83,218372,72500,966093,805196,160897
1020,83,218372,183500,966155,952986,13169
1021,59,219202,124000,970093,953526,16567
1022,99,219594,232000,971655,954646,17009
1023,80,219605,152000,973093,815195,157898
1024,60,220043,220000,975655,816696,158959
1025,60,220159,140000,976655,819195,157460
1026,74,220196,184000,978155,820195,157960
1027,30,220321,52000,977093,820696,156397
1028,94,220746,212000,981155,823195,157960
1029,63,220907,188000,988155,824196,163959
1030,89,221036,220000,989155,826695,162460
1031,95,221105,296000,990093,829696,160397
1032,68,221302,172000,993093,832695,160398
1033,91,221306,216000,992655,959026,33629
1034,87,221627,184000,992093,836695,155398
1035,64,222043,116000,995655,837196,158459
1036,57,222088,120000,996155,838696,157459
1037,57,222470,208000,996593,839695,156898
1038,95,222936,240000,999093,959886,39207
1039,18,223159,40000,999155,844195,154960
1040,90,223466,192000,998655,846695,151960
1041,41,223550,76000,999655,847196,152459
1042,55,223605,140000,999593,848695,150898
1043,98,224180,180000,971633,963986,7647
1044,55,224480,208000,975633,851695,123938
1045,50,224709,116000,977633,964526,13107
1046,68,225120,156000,983133,855196,127937
1047,43,225478,68000,987160,857196,129964
1048,55,225651,76000,989660,965386,24274
1049,26,226147,36000,996660,859695,136965
1050,30,226427,112000,999133,965646,33487
1051,74,226443,140000,999633,861196,138437
1052,99,226764,168000,998660,969486,29174
1053,72,226892,136000,999660,970026,29634
1054,98,227039,120000,402955,970886,-567931
1055,68,227055,136000,403075,971146,-568071
1056,30,227456,20000,248408,869695,-621287
1059,83,227747,52500,276666,870195,-593529
1059,83,227747,60500,276886,871196,-594310
1060,35,227798,220500,403455,974986,-571531
1060,35,227798,114500,381986,854496,-472510
1061,66,228153,88000,381596,875695,-494099
1063,72,228437,24500,403955,820633,-416678
1063,72,228437,199500,403575,975526,-571951
1064,33,228794,128000,293406,821633,-528227
1066,93,228933,136500,404075,975526,-571451
1066,93,228933,239500,404455,882195,-477740
1067,92,229076,272000,405575,884195,-478620
1068,17,229132,28000,282908,884695,-601787
1069,91,229288,304000,405455,887695,-482240
1070,35,230316,228000,304166,888196,-584030
1071,52,230344,96000,406075,889695,-483620
1072,39,230683,184000,387096,890695,-503599
1073,21,231045,40000,298016,976386,-678370
1074,26,231844,120000,305236,891696,-586460
1075,89,232124,188000,406455,893695,-487240
1076,25,232146,12000,406575,893696,-487121
1077,26,232861,200000,334516,894695,-560179
1078,42,232921,136000,407955,895695,-487740
1080,72,232957,60500,407075,876366,-469291
1080,72,232957,315500,408075,898196,-490121
1081,71,233069,176000,408955,976646,-567691
1082,82,233169,304000,387096,980486,-593390
1084,89,233319,108500,409075,903195,-494120
1084,89,233319,231500,408575,904696,-496121
1085,99,233571,188000,409455,908696,-499241
1086,45,233656,200000,360236,909195,-548959
1087,18,233909,60000,360016,809666,-449650
1088,33,233943,96000,409575,909196,-499621
1090,48,234158,156500,392596,909695,-517099
1090,48,234158,127500,369016,910196,-541180
1091,27,234616,136000,378516,911195,-532679
1093,77,234838,124500,409955,981026,-571071
1093,77,234838,295500,410075,981026,-570951
1094,38,235054,236000,403016,915696,-512680
1095,75,235119,356000,405736,981886,-576150
1096,34,235176,76000,410955,918195,-507240
1097,99,235406,284000,413016,921195,-508179
1098,90,235475,296000,415016,922696,-507680
1099,39,235488,140000,414236,924695,-510459
1100,53,235806,72000,418236,926195,-507959
1101,34,236177,180000,424236,926696,-502460
1102,46,236195,268000,423516,927195,-503679
1103,44,236498,80000,426516,928695,-502179
1104,82,236789,148000,431236,982146,-550910
1105,34,237186,88000,435016,931696,-496680
1106,100,237744,244000,449016,936195,-487179
1107,37,238160,128000,454016,936695,-482679
1108,100,238203,404000,464016,985986,-521970
1109,50,238394,164000,468736,940195,-471459
1110,72,238535,196000,469736,942195,-472459
1111,24,238543,36000,472236,942696,-470460
1112,74,238730,192000,475016,945196,-470180
1113,11,239238,24000,479236,945695,-466459
1114,63,239389,144000,480016,947695,-467679
1115,51,240388,188000,486736,948196,-461460
1116,27,240805,40000,491016,948695,-457679
1117,49,241023,200000,496516,949196,-452680
1118,14,241319,16000,499516,949696,-450180
1119,50,241454,120000,501236,951336,-450100
1120,66,241541,128000,505236,957166,-451930
1121,88,242258,300000,531516,964336,-432820
1122,89,242331,208000,538236,972836,-434600
1124,71,242375,132500,538736,978336,-439600
1124,71,242375,115500,538516,986166,-447650
1125,44,242698,160000,548236,990666,-442430
1126,56,242930,240000,556236,994836,-438600
1127,84,243060,236000,568236,999836,-431600
1128,99,243138,196000,572516,968196,-395680
1129,94,243439,256000,585236,970195,-384959
1130,26,243536,96000,589736,970695,-380959
1131,75,243731,136000,599016,971696,-372680
1132,53,243789,164000,599236,972196,-372960
1134,91,243872,368500,600736,974195,-373459
1134,91,243872,359500,603236,975695,-372459
1136,100,243963,12500,602736,976195,-373459
1136,100,243963,199500,604236,977195,-372959
1137,11,244041,100000,604016,760343,-156327
1138,71,244706,164000,611516,978695,-367179
1139,40,244962,48000,613016,979695,-366679
1140,14,245012,24000,612516,980195,-367679
1141,69,246134,188000,637516,981195,-343679
1142,60,246141,176000,636236,981196,-344960
1144,57,246408,45500,641736,981695,-339959
1144,57,246408,302500,643516,983196,-339680
1146,96,246493,116500,643016,985195,-342179
1146,96,246493,339500,644016,986696,-342680
1147,21,246666,56000,636516,987196,-350680
1148,11,247299,20000,651236,414576,236660
1149,99,247682,304000,674016,990196,-316180
1150,53,247715,156000,676516,992695,-316179
1153,33,247789,12500,670736,993196,-322460
1153,33,247789,92500,675736,994695,-318959
1154,62,247802,91500,677016,995196,-318180
1154,62,247802,315500,676736,996696,-319960
1155,21,247806,64000,674736,997196,-322460
1156,20,247830,108000,677516,997695,-320179
1157,45,248077,144000,682016,999195,-317179
1158,76,248437,168000,686736,999696,-312960
1159,27,248620,40000,687236,997366,-310130
1160,14,248791,100000,688736,816056,-127320
1161,62,249057,188000,692016,997486,-305470
1162,24,249507,40000,695236,997496,-302260
1163,18,249977,32000,699016,420076,278940
1164,11,250172,12000,697736,420356,277380
1165,51,250561,284000,704516,997649,-293133
1166,33,250669,80000,708016,421076,286940
1167,89,250805,540000,711516,861133,-149617
1168,80,251401,252000,722516,861714,-139198
1169,65,251475,200000,727016,862214,-135198
1171,12,251722,116500,729736,862714,-132978
1171,12,251722,15500,719016,832556,-113540
1172,42,251781,144000,732016,832556,-100540
1175,73,252071,20500,735016,836656,-101640
1175,73,252071,24500,736016,837446,-101430
1175,73,252071,183000,736736,863133,-126397
1176,24,252167,84000,737516,863214,-125698
1177,19,252902,28000,742016,838056,-96040
1179,88,253116,28500,755016,842156,-87140
1179,88,253116,343500,756016,987386,-231370
1181,77,253268,17500,753516,843556,-90040
1181,77,253268,290500,757236,864133,-106897
1182,13,253503,20000,757516,613798,143718
1183,14,254147,60000,759736,987646,-227910
1184,51,254583,176000,766016,853156,-87140
1185,35,254748,152000,767016,854445,-87429
1186,45,254925,156000,769236,854556,-85320
1187,53,255533,196000,776016,864214,-88198
1188,15,255775,56000,780236,991486,-211250
1189,46,256094,164000,785016,992026,-207010
1190,71,256359,404000,794236,865214,-70978
1191,65,256505,316000,797016,864843,-67827
1192,83,256551,252000,796516,865633,-69117
1193,48,257162,128000,813516,870343,-56827
1194,69,257203,228000,815516,870446,-54930
1195,39,257385,140000,816736,870945,-54209
1196,93,257762,240000,818016,875156,-57140
1197,27,258151,136000,818516,875946,-57430
1199,20,258228,180500,818736,992026,-173290
1199,20,258228,31500,817016,881343,-64327
1200,11,258851,20000,296714,635298,-338584
1201,98,259163,440000,562886,882056,-319170
1202,49,259369,124000,567916,886156,-318240
1203,94,259510,252000,568385,868214,-299829
1204,13,259794,72000,562906,643298,-80392
1205,44,260179,172000,568406,886843,-318437
1206,98,260487,216000,573885,887445,-313560
1207,37,261078,216000,584906,892446,-307540
1208,76,261209,236000,584885,897843,-312958
1209,60,261288,112000,445455,870133,-424678
1210,85,261416,256000,584666,903446,-318780
1211,31,261449,76000,589916,870714,-280798
1212,77,261592,380000,590406,992886,-402480
1213,51,261736,96000,448455,914343,-465888
1214,51,261908,84000,448955,914446,-465491
1215,50,262091,200000,595416,919843,-324427
1216,25,262436,120000,595886,920445,-324559
1217,32,262587,96000,595906,924656,-328750
1218,23,262609,64000,595885,925446,-329561
1219,56,262655,112000,451455,930156,-478701
1220,65,262776,164000,601386,930946,-329560
1221,76,262944,260000,606416,936945,-330529
1222,43,263365,196000,606906,993146,-386240
1223,98,263539,344000,612386,941843,-329457
1224,82,263544,312000,612385,947343,-334958
1225,45,263656,168000,617886,948056,-330170
1226,86,263846,260000,622916,953445,-330529
1227,17,264004,36000,485267,676298,-191031
1228,71,264197,308000,667546,953556,-286010
1229,14,264464,104000,623386,678798,-55412
1230,90,265340,268000,628885,958446,-329561
1231,100,265379,276000,628666,958945,-330279
1232,92,265708,420000,634406,963843,-329437
1233,48,265764,148000,628906,963946,-335040
1234,82,266386,220000,668935,964556,-295621
1235,21,266480,24000,489767,876714,-386947
1236,30,267062,124000,639666,968656,-328990
1237,47,267329,132000,639885,969343,-329458
1238,88,267408,280000,644916,970056,-325140
1239,58,269075,336000,650906,974946,-324040
1240,50,269517,272000,669156,981056,-311900
1241,65,269671,204000,661416,985843,-324427
1242,61,269711,272000,661906,986445,-324539
1243,80,269759,204000,666916,996986,-330070
1245,85,270058,184500,672416,991945,-319529
1245,85,270058,375500,667385,996843,-329458
1246,57,270127,160000,661886,997445,-335559
1247,18,270515,32000,524714,881633,-356919
1248,51,270522,268000,672936,997556,-324620
1249,56,270695,308000,678166,706798,-28632
1250,100,271071,352000,678385,710611,-32226
1251,79,271598,176000,963309,712111,251198
1252,31,271708,52000,572908,712298,-139390
1253,69,271800,232000,965047,715111,249936
1254,26,271872,56000,964309,716298,248011
1256,89,272104,368500,967309,997526,-30217
1256,89,272104,259500,966309,882633,83676
1257,94,272212,440000,968309,883133,85176
1258,66,272523,284000,969809,883633,86176
1259,61,273007,176000,970047,884133,85914
1260,32,273517,136000,700166,728298,-28132
1261,60,273908,332000,973309,884633,88676
1262,67,274215,360000,975047,884714,90333
1263,55,274268,120000,974047,997526,-23479
1264,77,274272,284000,974809,886633,88176
1265,40,274377,112000,973047,734298,238749
1266,86,274931,472000,977309,887133,90176
1267,42,275225,200000,978047,887633,90414
1268,63,275586,288000,979047,998646,-19599
1269,19,275708,52000,978809,889214,89595
1270,55,276466,244000,984809,890133,94676
1272,87,276531,224500,985809,890714,95095
1272,87,276531,339500,986047,892133,93914
1273,95,276662,556000,986547,893214,93333
1274,30,276716,204000,985047,500856,484191
1276,42,277316,168500,988809,893633,95176
1276,42,277316,163500,988047,893714,94333
1277,83,277745,312000,990547,895214,95333
1278,73,278403,332000,994047,896133,97914
1279,23,278418,60000,709214,896214,-187000
1280,58,278426,248000,995809,896633,99176
1281,73,278550,324000,996547,897133,99414
1282,81,278743,432000,997047,897214,99833
1283,20,278799,48000,997309,897714,99595
1284,51,279622,180000,999309,898133,101176
1285,82,279784,428000,999809,898714,101095
1286,63,279924,296000,998547,899714,98833
1287,94,280218,324000,999547,901633,97914
1288,70,280305,172000,777385,902214,-124829
1289,58,280705,200000,777386,903633,-126247
1291,38,280876,64500,767714,903714,-136000
1292,50,281018,128000,777406,904214,-126808
1292,50,281018,115500,769714,904714,-135000
1293,77,281188,388000,788166,906214,-118048
1294,49,281195,152000,788385,907633,-119248
1295,30,281392,64000,779908,908133,-128225
1296,76,281665,232000,800714,908714,-108000
1297,45,281827,184000,806714,909214,-102500
1298,75,281910,252000,813214,910633,-97419
1299,76,282023,220000,815214,911714,-96500
1300,99,282036,428000,816908,913214,-96306
1301,59,282088,252000,817908,913714,-95806
1302,29,282130,64000,813714,593821,219893
1303,67,282514,248000,821236,915133,-93897
1304,40,282723,172000,823236,915714,-92478
1306,56,283440,12500,827236,601675,225561
1306,56,283440,163500,828736,916214,-87478
1307,18,283835,44000,840136,604821,235315
1308,87,284161,492000,853636,917133,-63497
1309,99,284212,356000,854136,918714,-64578
1310,95,284389,448000,858636,920214,-61578
1311,19,284486,36000,857236,624675,232561
1312,15,284951,68000,861236,747798,113438
1313,90,284951,492000,863636,922214,-58578
1314,62,285714,336000,881236,923633,-42397
1317,60,286004,40500,886736,923714,-36978
1317,60,286004,149500,894736,925133,-30397
1317,60,286004,346000,892736,926633,-33897
1318,58,286088,152000,896736,927133,-30397
1319,62,286189,360000,904636,927214,-22578
1320,87,286361,300000,916236,928714,-12478
1321,17,286566,32000,926136,655321,270815
1322,44,286786,152000,945636,929133,16503
1324,79,286941,168500,958736,929633,29103
1325,75,286954,368000,963736,930214,33522
1325,75,286954,279500,960636,931714,28922
1327,96,286982,241500,963636,932133,31503
1327,96,286982,494500,965736,934133,31603
1329,70,287018,232500,964136,933714,30422
1329,70,287018,383500,966236,934714,31522
1330,29,287114,64000,968236,935133,33103
1331,94,287138,344000,970136,936214,33922
1332,12,287166,64000,967136,936714,30422
1333,100,287336,452000,976236,937133,39103
1335,16,287427,36500,978636,937633,41003
1336,100,287565,24000,962136,938633,23503
1336,100,287565,379500,980136,940133,40003
1337,41,288157,132000,982236,940633,41603
1338,91,289082,480000,999136,941133,58003
1339,59,289374,280000,998736,941714,57022
1340,91,289391,280000,999236,943214,56022
1341,42,289510,208000,999736,943633,56103
1342,38,289964,84000,892885,734821,158064
1343,10,290267,4000,801296,943714,-142418
1344,80,290610,228000,903886,945133,-41247
1345,91,290721,248000,908916,946133,-37217
1347,76,290764,285500,909386,947133,-37747
1347,76,290764,226500,909406,948214,-38808
1348,54,291182,148000,914885,948633,-33748
1350,96,291363,24500,827296,948714,-121418
1350,96,291363,363500,925666,950714,-25048
1351,66,291419,272000,925416,952214,-26798
1353,13,291958,52500,931385,952633,-21248
1353,13,291958,103500,920406,771821,148585
1354,78,292121,220000,931166,953714,-22548
1355,85,292160,260000,936666,954133,-17467
1356,67,292396,328000,936885,954714,-17829
1357,85,292507,152000,942385,955133,-12748
1358,33,292593,12000,842296,955633,-113337
1359,29,292997,124000,947906,956214,-8308
1360,41,293023,132000,942386,956714,-14328
1362,70,293160,117500,952916,957133,-4217
1362,70,293160,118500,936886,958714,-21828
1364,55,293381,248500,953386,959633,-6247
1364,55,293381,287500,947666,959714,-12048
1365,38,293449,152000,958906,960214,-1308
1366,29,293657,120000,958666,961133,-2467
1367,76,293840,192000,958886,962133,-3247
1368,45,293919,152000,963916,962714,1202
1369,79,294338,268000,975166,963214,11952
1370,45,294480,172000,975386,964133,11253
1371,18,294541,12000,870307,964214,-93907
1372,76,294660,244000,974916,965633,9283
1374,87,294732,88500,980666,966133,14533
1374,87,294732,271500,980906,967133,13773
1375,21,295028,16000,883307,846321,36986
1376,68,295130,56000,884807,968633,-83826
1378,89,295294,65500,986385,969133,17252
1378,89,295294,334500,991886,969714,22172
1379,70,295590,232000,997166,970214,26952
1380,85,295769,252000,997386,971133,26253
1381,53,295781,292000,997406,971214,26192
1382,89,296690,56000,898307,972214,-73907
1383,67,296793,72000,898796,972633,-73837
1384,91,297075,156000,905307,973633,-68326
1385,62,297086,56000,906307,974714,-68407
1386,59,297100,64000,905796,975214,-69418
1387,18,297109,12000,901807,895321,6486
1389,47,297483,92500,906807,899821,6986
1389,47,297483,31500,906796,975714,-68918
1391,29,298338,8500,913796,976133,-62337
1392,72,298353,28000,916807,976214,-59407
1392,72,298353,71500,918796,976714,-57918
1393,84,298488,160000,922307,978133,-55826
1394,82,298889,52000,932296,979214,-46918
1395,55,298906,32000,925807,981133,-55326
1396,87,298916,152000,933807,982133,-48326
1397,61,299120,120000,937796,982714,-44918
1398,31,299299,76000,938796,933321,5475
1399,80,299416,92000,943796,983633,-39837
1400,51,299467,56000,944807,984633,-39826
1401,81,299586,84000,949796,985714,-35918
1402,90,299694,100000,950796,987633,-36837
1403,66,299862,144000,953796,988214,-34418
1404,31,299886,12000,937307,956821,-19514
1405,81,300055,84000,955807,988633,-32826
1406,35,300146,52000,957307,988714,-31407
1407,57,300295,68000,958296,989214,-30918
1408,25,300510,20000,958307,990133,-31826
1410,43,300928,16500,962796,990633,-27837
1410,43,300928,35500,963807,973175,-9368
1411,47,301156,32000,964796,990714,-25918
1412,22,301254,24000,965307,978321,-13014
1415,38,301477,8500,966796,979321,-12525
1414,63,301466,72000,969307,991714,-22407
1415,38,301477,35500,969796,992214,-22418
1416,100,302145,164000,976307,993214,-16907
1417,64,302278,104000,977796,994133,-16337
1419,63,302515,4500,978307,994821,-16514
1419,63,302515,83500,978807,999175,-20368
1420,45,302925,40000,981307,999821,-18514
1421,31,303070,24000,983796,995133,-11337
1422,100,303423,84000,986296,997133,-10837
1423,49,303482,84000,986307,997714,-11407
1424,25,303558,28000,985796,701576,284220
1425,47,304379,72000,992307,998133,-5826
1426,81,304396,104000,994307,998714,-4407
1427,48,304693,44000,996796,771111,225685
1428,98,304919,60000,999296,999714,-418
1429,100,305034,104000,999796,772611,227185
1430,81,305347,56000,999807,695842,303965
1431,44,305991,8000,636241,772798,-136557
1432,74,306450,12000,637767,773111,-135344
1433,87,306499,20000,637741,773298,-135557
1434,92,306609,104000,728046,774111,-46065
1436,58,307564,56500,729435,774798,-45363
1436,58,307564,27500,640767,775298,-134531
1438,87,308188,4500,640267,714296,-74029
1438,87,308188,71500,641767,775798,-134031
1440,90,309038,72500,729656,776111,-46455
1440,90,309038,23500,645741,776611,-130870
1441,49,309117,60000,729436,723796,5640
1442,86,309255,56000,733436,777111,-43675
1445,83,309706,21500,646241,730296,-84055
1445,83,309706,20500,647741,734842,-87101
1445,83,309706,122000,733546,777611,-44065
1446,41,309758,8000,648267,736842,-88575
1448,78,310200,16500,650241,741842,-91601
1448,78,310200,83500,734935,777798,-42863
1451,73,310436,56500,735156,746296,-11140
1450,60,310323,68000,734936,779298,-44362
1451,73,310436,67500,738936,750796,-11860
1453,49,310845,24500,655741,779798,-124057
1454,58,311031,12000,654267,754796,-100529
1454,58,311031,59500,656241,780298,-124057
1455,43,311316,12000,656267,780611,-124344
1456,66,311586,12000,657241,780798,-123557
1458,30,312074,500,657267,762796,-105529
1460,98,312226,9000,657267,781611,-124344
1460,98,312226,500,505455,781798,-276343
1460,98,312226,58000,658241,783111,-124870
1461,71,312706,48000,506075,784111,-278036
1463,91,312892,500,505955,784298,-278343
1463,91,312892,11500,658741,784798,-126057
1464,17,312906,52000,659741,785111,-125370
1466,93,313503,44500,659241,780342,-121101
1466,93,313503,31500,661241,785611,-124370
1468,27,313849,104500,740435,786296,-45861
1472,79,314280,12000,662767,787296,-124529
1472,79,314280,16500,664267,791296,-127029
1472,79,314280,4500,507575,791842,-284267
1475,45,314673,4500,663241,794296,-131055
1473,31,314342,71000,740436,798796,-58360
1473,31,314342,15500,665267,799796,-134529
1476,34,314798,500,664241,800342,-136101
1476,34,314798,17000,740656,802842,-62186
1477,32,315172,42500,740656,804296,-63640
1478,68,315451,8000,666241,805342,-139101
1478,68,315451,71500,666267,808296,-142029
1480,98,315816,53500,511575,809296,-297721
1480,98,315816,102500,666741,813342,-146601
1483,38,316132,4500,509955,814342,-304387
1482,27,316079,8000,511075,814842,-303767
1485,51,316452,48000,512075,815842,-303767
1486,80,316497,52500,453096,817796,-364700
1487,89,316615,12000,666767,820796,-154029
1487,89,316615,25000,448096,824342,-376246
1487,89,316615,62000,448096,827796,-379700
1488,14,316736,4000,342256,828342,-486086
1490,52,317339,20500,667241,833342,-166101
1490,52,317339,51500,453096,836342,-383246
1492,48,318272,500,346756,837296,-490540
1492,48,318272,11500,667741,838842,-171101
1494,43,318674,500,347175,840842,-493667
1494,43,318674,11500,348256,842842,-494586
1495,33,318813,8000,347756,844842,-497086
1497,25,319197,56500,744436,848342,-103906
1498,34,319273,8000,349256,849342,-500086
1500,69,319606,56000,453486,851296,-397810
1502,89,319702,4500,350756,852342,-501586
1501,78,319606,60000,668267,854796,-186529
1504,30,319818,20000,668767,856796,-188029
1502,89,319702,63500,668241,860842,-192601
1505,33,319913,500,352256,863796,-511540
1504,30,319818,7500,353256,864842,-511586
1505,33,319913,7500,353675,866796,-513121
1507,35,320488,4500,354175,868296,-514121
1507,35,320488,7500,354256,870296,-516040
1509,70,321376,9500,744546,870342,-125796
1510,90,321633,56000,745935,873296,-127361
1510,90,321633,70500,745935,877796,-131861
1511,62,321655,68000,670241,880342,-210101
1512,31,321842,4000,356675,881796,-525121
1513,55,322241,20000,671767,882842,-211075
1515,79,322514,53500,671241,884296,-213055
1515,79,322514,94500,746156,887796,-141640
1516,69,322706,96000,745936,890342,-144406
1517,20,322857,52000,672767,890842,-218075
1519,100,322948,24500,671741,894342,-222601
1519,100,322948,43500,674267,897842,-223575
1520,63,323087,32000,365256,899842,-534586
1522,83,323200,8500,672741,902342,-229601
1522,83,323200,31500,674241,905842,-231601
1523,50,323520,52000,749936,908796,-158860
1524,89,323624,104000,675241,911796,-236555
1525,88,323630,40000,674767,915296,-240529
1527,95,324145,52500,750046,918796,-168750
1527,95,324145,75500,675267,922796,-247529
1528,63,324516,4000,371175,925342,-554167
1530,79,324785,12500,675767,926296,-250529
1532,87,324862,60000,676267,928842,-252575
1532,87,324862,4500,675741,930796,-255055
1532,87,324862,67000,751435,932796,-181361
1534,93,325506,8500,676741,933842,-257101
1534,93,325506,155500,751436,935842,-184406
1536,16,326358,12500,377256,936796,-559540
1536,16,326358,11500,379756,937296,-557540
1537,64,326551,92000,677741,939842,-262101
1538,37,326792,12000,383175,941842,-558667
1540,94,326905,100500,677267,942342,-265075
1540,94,326905,35500,678241,944842,-266601
1541,49,327111,108000,751656,947842,-196186
1543,12,327567,52500,679267,948796,-269529
1543,12,327567,55500,678267,949296,-271029
1545,100,327676,52500,755436,950842,-195406
1545,100,327676,87500,678767,954296,-275529
1548,67,328349,24500,397175,954842,-557667
1548,67,328349,16500,398675,956296,-557621
1550,83,328427,59500,680741,958296,-277555
1550,83,328427,81500,755546,959796,-204250
1550,83,328427,230000,679741,962342,-282601
1551,57,328611,80000,680267,965342,-285075
1552,96,329273,128000,481096,968342,-487246
1553,81,329282,108000,680767,971296,-290529
1554,11,329414,8000,409256,971342,-562086
1555,19,329644,24000,412675,972296,-559621
1557,73,330149,60500,486096,972796,-486700
1557,73,330149,163500,681241,976296,-295055
1558,14,330353,16000,419256,976842,-557586
1559,56,330422,128000,756936,978796,-221860
1561,66,330622,64500,491596,979342,-487746
1561,66,330622,163500,756935,982342,-225407
1562,62,330824,44000,681741,984342,-302601
1563,59,330876,84000,491986,987342,-495356
1564,12,330988,12000,433175,987796,-554621
1565,85,331221,120000,682741,991342,-308601
1568,89,331545,32500,682767,993796,-311029
1567,78,331374,132000,497096,997296,-500200
1568,89,331545,139500,497486,999842,-502356
1569,42,332400,84000,757156,799655,-42499
1571,88,332878,16500,446175,816798,-370623
1571,88,332878,71500,683267,810307,-127040
1573,80,333231,84500,683767,815155,-131388
1573,80,333231,47500,456256,820655,-364399
1575,32,333422,112500,683741,824655,-140914
1575,32,333422,23500,460675,827307,-366632
1577,60,333539,16500,684241,828655,-144414
1577,60,333539,35500,684767,833655,-148888
1579,22,333705,56500,502596,834307,-331711
1580,38,334067,16000,462675,835807,-373132
1581,49,334078,56000,502986,840307,-337321
1582,83,334216,92000,508096,845155,-337059
1582,83,334216,159500,685267,850655,-165388
1585,68,335197,4500,685741,851807,-166066
1585,68,335197,16500,470256,853307,-383051
1585,68,335197,39000,685767,858807,-173040
1586,35,335282,28000,686241,861307,-175066
1587,14,335679,56000,508096,862307,-354211
1589,54,335849,4500,475756,863807,-388051
1589,54,335849,67500,687241,867807,-180566
1591,22,336714,176500,513596,873807,-360211
1592,25,336785,28000,687267,875655,-188388
1592,25,336785,63500,688267,877807,-189540
1593,35,337178,36000,687767,881307,-193540
1594,92,337303,96000,513596,888807,-375211
1595,20,337384,72000,688241,890807,-202566
1597,57,337875,68500,688741,894655,-205914
1597,57,337875,87500,688767,899307,-210540
1598,92,337915,128000,689267,907307,-218040
1600,81,338376,8500,493256,910155,-416899
1600,81,338376,135500,689241,916307,-227066
1601,41,338880,160000,524596,919655,-395059
1602,70,339078,132000,760936,926655,-165719
1603,88,339562,112000,690241,933807,-243566
1604,38,339649,36000,689767,936807,-247040
1606,78,339888,8500,511756,938155,-426399
1607,85,339989,164000,535596,943307,-407711
1607,85,339989,227500,690267,947807,-257540
1608,51,340232,92000,690741,952307,-261566
1609,33,340482,36000,520575,956655,-436080
1610,41,340529,132000,690767,958807,-268040
1611,24,341217,32000,691267,960655,-269388
1613,10,341466,72500,691241,962807,-271566
1613,10,341466,15500,525565,963807,-438242
1614,72,341561,332000,761046,969307,-208261
1615,45,342518,192000,692241,972655,-280414
1616,27,342809,112000,552096,974807,-422711
1617,93,343299,360000,692767,983307,-290540
1619,73,343554,8500,545065,984655,-439590
1619,73,343554,207500,693267,991155,-297888
1620,57,343904,172000,762435,996155,-233720
1621,46,344246,224000,693741,998655,-304914
1622,66,344618,208000,693767,999807,-306040
1623,44,345421,120000,694267,607879,86388
1624,18,345724,112000,694241,675636,18605
1625,98,345923,228000,695267,826798,-131531
1626,58,346319,240000,585096,828111,-243015
1627,31,346541,84000,695741,828298,-132557
1629,58,346811,129500,762436,680756,81680
1629,58,346811,218500,695767,828611,-132844
1631,18,347697,60500,762656,614379,148277
1631,18,347697,51500,590596,828798,-238202
1633,17,348303,52500,766546,829111,-62565
1634,54,348580,104000,590986,615379,-24393
1634,54,348580,59500,586575,616379,-29804
1635,90,348658,128000,766436,829611,-63175
1637,91,349225,68500,599565,621265,-21700
1638,68,349230,96000,697267,681136,16131
1638,68,349230,203500,696767,829798,-133031
1640,40,349519,152500,607565,830111,-222546
1640,40,349519,91500,608565,629265,-20700
1641,81,349874,156000,619565,830611,-211046
1642,54,350123,104000,627075,631765,-4690
1643,49,350322,132000,628575,830798,-202223
1644,99,350330,188000,697767,686635,11132
1645,32,350357,208000,632075,637765,-5690
1646,40,350404,44000,635075,638265,-3190
1647,79,350488,152000,767935,831111,-63176
1648,33,350862,68000,641065,686636,-45571
1649,54,350928,176000,698741,831611,-132870
1650,51,351081,220000,698267,831798,-133531
1651,31,351263,52000,698241,832111,-133870
1652,13,351838,28000,649575,643765,5810
1653,26,352058,120000,698767,644379,54388
1654,69,352276,96000,699741,645765,53976
1656,85,352539,20500,662065,645879,16186
1656,85,352539,183500,699767,832611,-132844
1657,60,352941,152000,700241,832798,-132557
1658,26,353263,24000,667575,833298,-165723
1659,46,353532,80000,669065,833611,-164546
1660,48,354176,100000,671575,833798,-162223
1661,55,355440,144000,700741,652879,47862
1662,56,355622,116000,689075,834798,-145723
1663,60,355845,308000,700267,835611,-135344
1664,98,355944,320000,700767,836298,-135531
1665,58,356415,108000,712575,837298,-124723
1666,61,356567,336000,767936,838111,-70175
1667,38,356605,108000,717065,838611,-121546
1668,69,356874,236000,719575,839111,-119536
1669,91,357187,244000,722575,840298,-117723
1670,14,357421,16000,723575,708255,15320
1672,57,358004,144500,724575,666879,57696
1672,57,358004,183500,732065,840798,-108733
1673,49,358088,100000,733065,841111,-108046
1674,60,358564,128000,742575,841798,-99223
1675,73,358770,204000,744575,843111,-98536
1676,43,359225,156000,747575,843798,-96223
1678,93,359798,8500,758565,844298,-85733
1678,93,359798,359500,762065,845298,-83233
1679,93,360165,324000,771065,847798,-76733
1680,71,360329,232000,771075,849111,-78036
1681,67,360417,220000,772575,850298,-77723
1682,38,361566,180000,786065,850611,-64546
1683,85,361713,384000,789575,851298,-61723
1684,54,361785,152000,793075,852111,-59036
1685,42,361919,136000,793565,852611,-59046
1686,26,362030,80000,796565,852798,-56233
1687,56,362409,268000,804075,853798,-49723
1688,22,362474,84000,803565,854298,-50733
1689,54,362723,84000,810065,854798,-44733
1690,58,363069,208000,815075,855111,-40036
1691,33,363156,204000,814065,696879,117186
1692,19,363322,64000,818065,855298,-37233
1693,73,363425,208000,821575,856111,-34536
1694,55,363699,100000,825075,856298,-31223
1695,40,363754,100000,828065,856611,-28546
1696,65,364124,320000,835565,858298,-22733
1697,41,364203,56000,838065,858298,-20233
1698,11,364435,28000,841075,711356,129719
1699,59,364676,164000,849075,859111,-10036
1700,81,364938,236000,854575,860798,-6223
1701,85,365225,148000,861065,861298,-233
1702,79,365252,208000,861575,862111,-536
1703,47,365742,140000,864565,862611,1954
1704,23,365763,92000,867065,862798,4267
1705,39,366071,220000,868075,863298,4777
1706,73,366892,228000,880075,863611,16464
1707,27,367066,40000,878575,863798,14777
1708,50,367225,196000,887575,864611,22964
1709,73,367437,104000,889575,865798,23777
1710,64,367749,176000,897075,867111,29964
1712,96,368263,16500,900565,867298,33267
1712,96,368263,303500,911065,869611,41454
1713,88,368368,244000,914565,869798,44767
1714,82,368803,204000,924075,871111,52964
1715,84,368928,268000,926575,872111,54464
1716,49,368992,168000,926065,872298,53767
1717,59,369882,104000,936575,872611,63964
1718,20,369926,88000,934075,873111,60964
1719,79,370174,244000,940065,874298,65767
1720,20,370893,68000,944075,813696,130379
1722,47,371403,108500,952565,874611,77954
1722,47,371403,111500,955565,875298,80267
1723,99,371662,308000,964065,876611,87454
1724,63,371733,120000,963075,877611,85464
1725,62,371910,300000,971565,878611,92954
1726,56,372304,252000,988075,879298,108777
1727,50,372316,352000,988575,879798,108777
1728,71,372457,308000,992075,880298,111777
1729,49,372476,188000,992565,880611,111954
1730,89,372557,236000,996075,882111,113964
1731,39,372701,100000,999565,882611,116954
1732,47,373044,44000,999075,883111,115964
1733,67,373209,32000,998565,884298,114267
1734,57,373253,124000,999575,884611,114964
1735,95,374257,48000,805096,890356,-85260
1736,35,374372,44000,805096,893356,-88260
1738,26,375153,88500,805096,899856,-94760
1740,84,375558,53000,805596,902696,-97100
1740,84,375558,49500,810596,906196,-95600
1741,82,375638,214500,816486,911696,-95210
1741,82,375638,306500,821596,918196,-96600
1743,80,376068,500,714241,920856,-206615
1743,80,376068,7500,714741,927196,-212455
1744,85,376553,440000,832596,935856,-103260
1745,22,376653,52000,782936,938196,-155260
1746,72,376852,88000,838096,942856,-104760
1747,42,377314,92000,838096,945696,-107600
1748,83,377355,188000,838596,957856,-119260
1750,86,377361,5500,832986,958196,-125210
1750,86,377361,90500,838096,964856,-126760
1751,40,377556,44000,843596,968356,-124760
1752,51,377966,184000,844096,972696,-128600
1756,47,378913,101500,849596,980196,-130600
1757,81,378916,49500,854596,981696,-127100
1757,81,378916,93500,849486,985856,-136370
1757,81,378916,39000,849096,989856,-140760
1757,81,378916,216500,854986,995196,-140210
1758,77,380271,44000,855096,998696,-143600
1760,42,380777,5500,860096,999856,-139760
1761,88,381438,47000,860096,892798,-32702
1761,88,381438,319500,865596,895256,-29660
1765,94,382214,97500,871596,895636,-24040
1765,94,382214,93500,871486,897916,-26430
1765,94,382214,500,719741,900755,-181014
1765,94,382214,124500,871096,900756,-29660
1766,71,382366,88000,876986,901136,-24150
1767,26,382574,48000,877096,894111,-17015
1768,81,382696,136000,876596,906256,-29660
1771,18,383366,93500,882486,906636,-24150
1772,35,383593,5500,882096,911755,-29659
1773,94,383777,39000,882096,912136,-30040
1773,94,383777,39000,882096,917635,-35539
1773,94,383777,187000,888096,923135,-35039
1774,86,384388,264000,893596,928636,-35040
1775,55,384641,180000,898986,933756,-34770
1778,81,385133,44500,904096,934135,-30039
1777,96,385129,140000,909596,939255,-29659
1778,81,385133,47500,899096,945135,-46039
1780,73,385804,225500,915096,947416,-32320
1781,87,385871,88000,904596,950636,-46040
1781,87,385871,218500,915096,956135,-41039
1783,64,386273,48500,915486,961636,-46150
1784,98,386488,144000,921096,961635,-40539
1784,98,386488,51500,926096,967135,-41039
1786,35,386701,149500,926096,969416,-43320
1786,35,386701,178500,926596,972635,-46039
1788,65,387309,49500,937096,974916,-37820
1790,87,387346,132000,937096,983255,-46159
1790,87,387346,5500,931596,983256,-51660
1790,87,387346,125000,931986,983256,-51270
1791,100,387808,148000,943096,985916,-42820
1792,78,387972,188000,942596,991416,-48820
1793,46,388269,52000,942596,994635,-52039
1795,60,388489,5500,942596,999755,-57159
1796,89,388590,44000,942986,999756,-56770
1796,89,388590,350500,953596,901111,52485
1797,40,388675,92000,953986,901298,52688
1798,64,389087,140000,959096,901611,57485
1799,35,389297,88000,959096,901798,57298
1800,45,389940,48000,959486,902111,57375
1802,11,390508,52500,964596,902298,62298
1805,68,390964,9000,959596,902611,56985
1806,31,391098,49500,965096,902798,62298
1806,31,391098,5500,964596,903111,61485
1806,31,391098,87000,964986,903611,61375
1807,26,391133,86000,970096,904111,65985
1811,30,391862,44000,970096,903298,66798
1808,33,391417,4000,730267,904298,-174031
1813,81,392029,5500,970096,903798,66298
1815,74,392062,93500,981096,904611,76485
1813,81,392029,48000,975596,904798,70798
1813,81,392029,97500,986596,905798,80798
1813,81,392029,159500,975596,905611,69985
1815,74,392062,53500,981096,905111,75985
1816,88,392084,126500,981596,906111,75485
1816,88,392084,170500,992096,905298,86798
1817,38,392400,44000,986596,906298,80298
1819,65,392614,49500,987096,906798,80298
1819,65,392614,258500,997596,908298,89298
1822,92,392723,88500,998096,907611,90485
1822,92,392723,44500,997596,907111,90485
1822,92,392723,51000,992096,908611,83485
1824,48,393071,5500,997596,906611,90985
1825,48,393459,39000,997596,907798,89798
1828,15,393708,4000,732241,907298,-175057
1833,97,394472,500,732267,908111,-175844
1834,29,394569,5500,794046,908798,-114752
1831,70,394401,4000,732741,909111,-176370
1833,97,394472,9500,795435,909611,-114176
1831,70,394401,4500,734241,909298,-175057
1834,29,394569,7500,733241,910111,-176870
1833,97,394472,500,733741,909798,-176057
1833,97,394472,49500,795435,910298,-114863
1836,16,395014,46500,794046,910611,-116565
1836,16,395014,500,734741,911111,-176370
1838,85,395616,7500,735241,910798,-175557
1837,35,395588,4000,735267,911298,-176031
1839,94,395756,68000,795436,911611,-116175
1839,94,395756,7500,735767,912111,-176344
1841,64,396052,4500,738267,911798,-173531
1841,64,396052,19500,738767,912298,-173531
1843,90,396680,4500,739241,912798,-173557
1844,57,396977,8000,739741,912611,-172870
1845,87,397334,52000,795656,913111,-117455
1846,89,397553,12000,742241,913298,-171057
1847,54,397720,8000,741267,913611,-172344
1847,54,397720,15500,741767,913798,-172031
1848,10,398389,4000,742267,914111,-171844
1849,90,398587,28000,745267,914298,-169031
1851,36,398917,73500,799546,914611,-115065
1851,36,398917,58500,799436,915111,-115675
1852,91,399389,96000,801156,915298,-114142
1854,72,399666,12500,749741,914798,-165057
1854,72,399666,63500,800936,915611,-114675
1855,88,399708,8000,749767,916111,-166344
1856,55,399950,48000,804936,916298,-111362
1857,64,400470,8000,752267,916611,-164344
1858,58,400471,12000,752741,915798,-163057
1859,44,400676,20000,752767,917298,-164531
1860,15,400755,4000,751241,916798,-165557
1861,32,401085,44000,805046,917611,-112565
1862,31,401273,4000,753241,917798,-164557
1863,73,401623,12000,755767,917111,-161344
1864,67,401767,24000,756767,918111,-161344
1865,38,401860,8000,758241,918611,-160370
1866,92,401936,20000,757267,918298,-161031
1868,67,402417,48500,806435,919298,-112863
1868,67,402417,59500,806656,918798,-112142
1869,22,402607,8000,760267,920111,-159844
1871,78,402928,5500,806436,919611,-113175
1872,74,402951,107000,810436,919111,-108675
1872,74,402951,15500,762741,919798,-157057
1873,79,403201,52000,810546,920298,-109752
1874,82,403398,20000,763267,920611,-157344
1875,55,403919,16000,766267,920798,-154531
1878,100,404319,29500,811935,921111,-109176
1879,76,404425,8500,768767,921298,-152531
1878,100,404319,54500,811935,921611,-109676
1879,76,404425,15500,767741,921798,-154057
1881,33,404781,28500,771241,922111,-150870
1881,33,404781,63500,812156,922798,-110642
1882,45,404897,48000,811936,922298,-110362
1883,100,405737,8000,771767,922611,-150844
1884,44,406192,4000,772241,923111,-150870
1885,95,407007,16000,773241,923298,-150057
1888,88,407790,500,773267,924111,-150844
1888,88,407790,500,773741,924298,-150557
1889,87,408198,24500,815936,924798,-108862
1890,83,408240,99000,816046,923611,-107565
1890,83,408240,19500,776741,923798,-147057
1891,92,408242,8000,776267,925111,-148844
1894,82,409391,500,777267,924611,-147344
1894,82,409391,8500,778741,926298,-147557
1894,82,409391,15000,778241,925798,-147557
1898,33,410094,4500,779241,926111,-146870
1896,44,409954,8000,779767,925298,-145531
1899,83,410373,4500,780741,927111,-146370
1898,33,410094,55500,817435,925611,-108176
1899,83,410373,63500,817436,926611,-109175
1901,27,410814,4500,782767,926798,-144031
1902,70,410875,16000,786267,927298,-141031
1903,95,410898,12000,784267,927798,-143531
1904,96,411032,24000,787741,927611,-139870
1907,80,411391,8000,786241,928111,-141870
1906,28,411100,4500,785241,928798,-143557
1908,38,411430,8000,788241,928298,-140057
1909,65,411630,8000,791241,928611,-137370
1910,100,411631,8000,789241,929611,-140370
1909,65,411630,27500,790241,929111,-138870
1913,51,411802,12000,792267,930111,-137844
1912,19,411700,21500,817656,929298,-111642
1913,51,411802,39000,817656,930298,-112642
1913,51,411802,67000,821436,929798,-108362
1914,54,412044,8000,792767,930611,-137844
1916,48,412333,48500,821546,930798,-109252
1917,37,412363,16000,795241,931298,-136057
1918,51,412535,12000,795267,931111,-135844
1918,51,412535,15500,796241,931798,-135557
1922,96,413099,500,795741,932611,-136870
1924,31,413393,500,796267,931611,-135344
1926,75,413567,500,796741,932298,-135557
1922,96,413099,51500,822935,932111,-109176
1925,37,413424,48500,822936,932798,-109862
1929,84,413849,4000,797741,933111,-135370
1928,57,413614,4000,797767,933298,-135531
1929,84,413849,28000,801241,933611,-132370
1929,84,413849,48500,823156,933798,-110642
1930,23,414056,4000,799767,934798,-135031
1929,84,413849,26500,801767,934111,-132344
1931,78,414325,8000,802741,935298,-132557
1931,78,414325,11500,802241,935111,-132870
1933,20,414716,500,802267,935611,-133344
1934,60,414924,8000,806241,934298,-128057
1935,96,415047,12000,805267,934611,-129344
1936,96,415110,144000,828435,936611,-108176
1938,78,415302,8000,807241,936798,-129557
1937,87,415219,12000,807267,936298,-129031
1939,97,415328,16000,806767,935798,-129031
1939,97,415328,15500,807741,937111,-129370
1941,43,416245,9500,828436,936111,-107675
1943,60,416293,43000,828436,937298,-108862
1943,60,416293,8500,810741,937611,-126870
1943,60,416293,19000,811241,937798,-126557
1944,86,416537,16000,811267,938111,-126844
1945,16,416786,8000,811741,938298,-126557
1946,38,417042,4000,810767,938611,-127844
1947,79,417778,4000,811767,938798,-127031
1949,93,418200,4500,812267,939111,-126844
1949,93,418200,15500,813267,939611,-126344
1950,86,418832,60000,828656,940111,-111455
1952,40,419075,4500,814241,940298,-126057
1952,40,419075,11500,815241,940611,-125370
1954,63,419873,500,815267,939798,-124531
1956,75,420281,52000,832436,939298,-106862
1955,84,420267,56000,833935,940798,-106863
1957,67,420676,52000,832546,941111,-108565
1957,67,420676,23500,818741,941298,-122557
1958,11,420741,8000,819241,941611,-122370
1959,75,420980,12000,819741,941798,-122057
1962,57,421747,500,819767,942298,-122531
1961,29,421596,8000,821267,942111,-120844
1964,71,421797,8000,821767,942611,-120844
1964,71,421797,44500,837936,943298,-105362
1964,71,421797,99000,834156,942798,-108642
1966,47,422024,4500,822267,943111,-120844
1966,47,422024,11500,823241,943611,-120370
1967,86,422460,16000,824241,943798,-119557
1968,22,422478,4000,822767,944111,-121344
1970,94,422742,8500,825241,944298,-119057
1973,89,423009,8000,825767,944611,-118844
1973,89,423009,48500,838046,944798,-106752
1975,85,423370,500,825267,945111,-119844
1973,89,423009,63000,839435,945798,-106363
1974,31,423125,4000,826241,945611,-119370
1975,85,423370,19500,828267,945298,-117031
1979,69,423964,8500,827767,946111,-118344
1977,20,423740,48000,839436,946298,-106862
1978,26,423776,4000,828741,946798,-118057
1979,69,423964,11500,829241,946611,-117370
1980,77,424650,56000,843436,947111,-103675
1981,89,424684,72000,839656,947298,-107642
1982,96,425110,60000,843546,947611,-104065
1984,97,425479,44500,844935,947798,-102863
1984,97,425479,39500,835267,948111,-112844
1985,65,426315,72000,837241,948298,-111057
1986,85,426438,176000,845156,948798,-103642
1988,95,426641,24500,837767,949111,-111344
1988,95,426641,123500,839767,948611,-108844
1989,41,426719,56000,839741,949611,-109870
1991,99,426961,16500,548256,949298,-401042
1991,99,426961,163500,838767,949798,-111031
1992,95,427287,112000,840241,950111,-109870
1993,63,427328,104000,842767,950298,-107531
1994,33,427430,32000,566256,950611,-384355
1995,44,427534,72000,844741,950798,-106057
1996,35,427546,40000,842741,951298,-108557
1997,81,427607,104000,843767,951111,-107344
1998,32,428032,52000,846267,951611,-105344
1999,46,428070,92000,580675,951798,-371123
2000,78,428152,160000,848936,952611,-103675
2001,38,428747,36000,846241,952298,-106057
2002,19,428793,24000,584756,952111,-367355
2003,38,429200,56000,846741,953798,-107057
2004,61,429491,132000,850435,953111,-102676
2005,36,429602,104000,849046,953298,-104252
2006,97,429894,140000,849267,952798,-103531
2007,59,430027,84000,847741,953611,-105870
2008,77,430222,96000,850241,954111,-103870
2009,76,430459,108000,850741,954298,-103557
2010,27,430771,48000,851241,954611,-103370
2011,23,431023,48000,850767,954798,-104031
2012,86,431111,164000,852241,955611,-103370
2013,46,431379,60000,851767,956298,-104531
2014,45,431902,116000,852767,955111,-102344
2015,87,432176,200000,854436,955298,-100862
2016,81,432650,124000,853267,955798,-102531
2017,88,432657,116000,857241,956798,-99557
2018,55,432826,136000,856241,956111,-99870
2019,21,432930,64000,855935,956611,-100676
2020,12,432944,12000,854267,957111,-102844
2021,28,433177,36000,855267,957298,-102031
2022,39,433262,96000,858267,957611,-99344
2023,35,433395,52000,859741,957798,-98057
2024,74,433541,124000,859267,958111,-98844
2025,89,433623,152000,861267,958298,-97031
2026,68,433880,112000,862241,958611,-96370
2030,91,434136,20500,711256,958798,-247542
2028,58,434012,88000,861767,959111,-97344
2031,28,434162,36500,862267,959611,-97344
2031,28,434162,152000,863241,959798,-96557
2031,28,434162,51000,863267,959298,-96031
2032,55,434668,104000,863767,960298,-96531
2033,43,434897,116000,866267,960111,-93844
2034,83,435064,188000,866767,960611,-93844
2035,24,435288,44000,869241,961111,-91870
2036,24,435296,32000,867741,960798,-93057
2037,70,435368,96000,870267,961298,-91031
2038,64,435369,160000,868241,961611,-93370
2039,18,435403,20000,751175,961798,-210623
2040,97,435723,140000,871267,962111,-90844
2041,46,435743,64000,871741,962798,-91057
2042,18,436139,32000,761256,962298,-201042
2043,34,436621,52000,872741,963111,-90370
2044,28,436719,48000,872767,963611,-90844
2045,75,436762,128000,874241,962611,-88370
2046,38,437204,76000,874741,963298,-88557
2048,81,437502,88500,875767,964111,-88344
2048,81,437502,127500,876267,964298,-88031
2049,99,438218,216000,878267,964611,-86344
2050,63,438572,104000,879741,963798,-84057
2051,59,438902,96000,880241,965111,-84870
2053,28,439259,72500,880267,965298,-85031
2053,28,439259,47500,880767,964798,-84031
2054,32,440116,32000,881767,965611,-83844
2055,99,440280,144000,883241,966298,-83057
2056,76,440398,92000,883741,965798,-82057
2057,42,441008,64000,884741,966111,-81370
2058,51,441133,88000,886267,966611,-80344
2059,69,441189,100000,886241,966798,-80557
2061,71,441544,40500,887267,967111,-79844
2061,71,441544,119500,888767,967798,-79031
2062,64,441627,172000,889741,967298,-77557
2063,91,441906,136000,891241,968111,-76870
2064,47,441920,152000,880175,967611,-87436
2065,47,441990,76000,887241,968298,-81057
2066,97,442086,144000,891767,968611,-76844
2067,32,442105,40000,887175,968798,-81623
2068,60,442444,152000,892241,969111,-76870
2069,42,442721,160000,892756,969298,-76542
2070,78,443493,92000,907756,969611,-61855
2071,97,443588,160000,909256,970111,-60855
2072,84,443928,172000,917756,969798,-52042
2073,51,444177,116000,920756,970611,-49855
2074,29,444554,64000,929756,970298,-40542
2075,91,444939,192000,941756,971298,-29542
2076,52,444966,84000,942256,970798,-28542
2077,76,445082,164000,945675,971798,-26123
2078,69,445500,168000,952756,971611,-18855
2079,22,445551,36000,954756,972298,-17542
2080,90,445943,136000,964756,971111,-6355
2081,87,446402,172000,980756,972611,8145
2083,44,446721,12500,993256,972798,20458
2084,88,446772,136000,993756,972111,21645
2084,88,446772,179500,997756,973111,24645
2085,97,446928,160000,999675,973298,26377
2086,71,447109,100000,998756,973798,24958
2087,31,447184,36000,995675,973611,22064
2088,40,447381,32000,999756,974111,25645
2089,88,447842,16000,905241,974298,-69057
2090,78,448133,60000,906241,974798,-68557
2091,99,448180,24000,906767,975298,-68531
2092,13,448239,44000,877936,974611,-96675
2094,83,448939,500,907241,975111,-67870
2096,41,449274,8000,907741,976111,-68370
2095,89,449234,8000,908241,975611,-67370
2098,65,449758,4000,908267,976298,-68031
2097,25,449681,12000,909767,975798,-66031
2098,65,449758,15500,910267,976611,-66344
2099,89,450046,24000,911267,977798,-66531
2100,79,450744,8000,912241,976798,-64557
2101,99,451003,60000,913267,977111,-63844
2103,38,451322,13500,913241,977298,-64057
2103,38,451322,42500,913741,977611,-63870
2104,28,452254,8000,915267,978298,-63031
2107,50,452684,500,914241,978111,-63870
2106,50,452492,8000,914741,978611,-63870
2108,74,452842,8000,915241,979798,-64557
2108,74,452842,7500,915741,979298,-63557
2109,95,453596,20000,916767,978798,-62031
2110,33,453627,44000,882046,979611,-97565
2111,85,454848,68000,918267,979111,-60844
2113,66,455124,500,918741,980298,-61557
2113,66,455124,7500,918767,980611,-61844
2114,45,456367,12000,920767,980111,-59344
2115,41,456456,12000,920267,980798,-60531
2117,52,456843,4500,921241,981111,-59870
2118,77,457108,12000,922267,981298,-59031
2118,77,457108,59500,922767,981798,-59031
2120,66,457402,500,922241,982111,-59870
2120,66,457402,19500,924241,981611,-57370
2121,72,457781,64000,924767,982611,-57844
2122,43,458484,4000,925241,982298,-57057
2124,93,459785,500,925267,982798,-57531
2124,93,459785,15500,926241,983111,-56870
2125,66,459915,92000,926267,983611,-57344
2131,98,462007,5500,888935,983298,-94363
2130,88,461800,5500,888936,983798,-94862
2136,93,462836,5500,889156,984111,-94955
2138,43,463002,5500,892936,984298,-91362
2139,85,463392,44000,893046,984611,-91565
2147,87,465306,44000,894435,984798,-90363
2151,56,465750,5500,894436,985111,-90675
2151,56,465750,5500,894656,985298,-90642
2155,73,466574,5500,898436,986111,-87675
2157,39,466705,5500,898546,985611,-87065
2158,40,466826,44000,899935,985798,-85863
2155,73,466574,5500,899936,986298,-86362
2161,56,467432,44000,900156,986611,-86455
2158,40,466826,44000,903936,986798,-82862
2163,74,468198,5500,904046,987111,-83065
2163,74,468198,5500,905435,987298,-81863
2167,49,468978,5500,905436,987611,-82175
2172,98,470131,5500,905656,987798,-82142
2171,17,469724,5500,909436,988111,-78675
2173,62,470461,5500,909546,988798,-79252
2173,62,470461,5500,910935,988298,-77363
2174,88,470652,44000,910936,988611,-77675
2174,88,470652,5500,911156,989298,-78142
2178,96,471092,5500,914936,989611,-74675
2180,69,472007,5500,915046,989111,-74065
2186,66,473418,82500,916435,990111,-73676
2183,16,472936,5500,916436,990298,-73862
2184,89,473136,5500,916656,990798,-74142
2195,81,476157,5500,920436,990611,-70175
2197,49,476222,82500,920546,989798,-69252
2201,49,476423,5500,921935,991111,-69176
2200,100,476347,44000,921936,991298,-69362
2199,81,476327,82500,922156,991611,-69455
2200,100,476347,5500,925936,991798,-65862
2195,81,476157,5500,926046,992298,-66252
2195,81,476157,44000,927435,992111,-64676
2200,100,476347,5500,927436,993111,-65675
2198,93,476262,82500,927656,993298,-65642
2204,98,477293,5500,931436,992798,-61362
2208,60,478560,5500,931546,992611,-61065
2212,39,479055,5500,932935,993611,-60676
2207,78,478452,44000,932936,993798,-60862
2209,68,478608,5500,933156,994111,-60955
2211,95,478909,5500,936936,994798,-57862
2213,92,479220,500,819214,996298,-177084
2213,92,479220,39000,909436,994298,-84862
2214,62,479271,39000,905656,995798,-90142
2211,95,478909,77500,910935,995111,-84176
2213,92,479220,77500,911156,994611,-83455
2211,95,478909,500,820408,996111,-175703
2214,62,479271,500,820714,995611,-174897
2213,92,479220,500,820908,995298,-174390
2213,92,479220,39000,914936,996798,-81862
2214,62,479271,500,821408,996611,-175203
2214,62,479271,44000,937046,997111,-60065
2212,39,479055,500,821714,997611,-175897
2215,99,479283,500,821908,997798,-175890
2214,62,479271,39000,916436,997298,-80862
2215,99,479283,44000,938435,998611,-60176
2214,62,479271,500,822408,998798,-176390
2215,99,479283,39000,916435,998111,-81676
2217,18,479537,500,822908,998298,-175390
2216,51,479502,500,823214,999798,-176584
2213,92,479220,500,823408,999111,-175703
2211,95,478909,500,823714,999298,-175584
2212,39,479055,500,823908,999611,-175703
2211,95,478909,500,824214,640018,184196
2216,51,479502,500,824408,994298,-169890
2216,51,479502,500,824714,994611,-169897
2215,99,479283,116000,927435,994798,-67363
2213,92,479220,500,825214,639736,185478
2212,39,479055,39000,920546,640518,280028
2212,39,479055,39000,927656,995298,-67642
2211,95,478909,39000,922156,995611,-73455
2213,92,479220,116000,927436,996111,-68675
2215,99,479283,39000,921935,996298,-74363
2214,62,479271,500,826714,642018,184696
2211,95,478909,500,826908,641736,185172
2216,51,479502,39000,931436,996611,-65175
2218,64,479627,500,827408,643236,184172
2211,95,478909,500,827714,997298,-169584
2210,81,478791,39000,932936,643018,289918
2212,39,479055,39000,931546,998298,-66752
2218,64,479627,39000,933156,998798,-65642
2211,95,478909,4000,828714,644018,184696
2213,92,479220,87000,936936,999611,-62675
2213,92,479220,116500,938656,999798,-61142
2213,92,479220,83000,843214,644236,198978
2214,62,479271,95500,937046,643736,293310
2218,64,479627,137000,938436,644518,293918
2216,51,479502,42000,845908,644736,201172
2217,18,479537,71500,942436,645018,297418
2219,82,479760,51000,849214,645236,203978
2219,82,479760,59500,848908,645518,203390
2220,11,480325,8000,850214,645736,204478
2222,94,480563,28500,856908,646018,210890
2222,94,480563,155500,942546,646236,296310
2223,67,481388,116000,944156,646518,297638
2224,42,481411,44000,873714,647018,226696
2225,31,481411,28000,876214,646736,229478
2226,89,481453,120000,943936,647518,296418
2227,42,481527,128000,947936,647236,300700
2229,50,481927,16500,880714,647736,232978
2229,50,481927,51500,879908,648018,231890
2230,13,482043,12000,881714,648236,233478
2231,41,482128,36000,883214,648736,234478
2232,65,482674,144000,949435,648518,300917
2233,16,483285,20000,886408,649018,237390
2234,62,484084,64000,903408,649236,254172
2235,71,484110,108000,949436,649518,299918
2236,95,484274,148000,949656,649736,299920
2237,89,484346,92000,908214,650018,258196
2238,86,485088,120000,954935,650236,304699
2240,96,485274,80500,921714,650736,270978
2240,96,485274,139500,953546,650518,303028
2241,65,485504,108000,954936,619726,335210
2242,65,486396,112000,958936,621536,337400
2243,30,486574,56000,955156,624876,330280
2244,64,487193,60000,937714,651018,286696
2247,73,487351,52500,959046,651236,307810
2247,73,487351,12500,936908,652236,284672
2247,73,487351,111000,960435,651736,308699
2248,40,487849,36000,947714,652018,295696
2249,49,488211,32000,964214,651518,312696
2250,90,488241,96000,966908,652518,314390
2252,15,488403,176500,971214,652736,318478
2252,15,488403,15500,972908,653018,319890
2253,83,488472,76000,972214,653236,318978
2254,90,488541,88000,976714,654018,322696
2255,91,488576,160000,977714,654236,323478
2256,62,488693,80000,978214,644018,334196
2257,97,488903,144000,980714,653518,327196
2258,47,489799,48000,986714,653736,332978
2259,63,490065,56000,989714,654518,335196
2260,69,490417,52000,991714,655518,336196
2261,39,490986,44000,999214,655018,344196
2264,80,491351,60500,999908,655236,344672
2263,33,491295,20000,999714,654736,344978
2264,80,491351,87500,998908,655736,343172
2265,10,491359,12000,997408,656236,341172
2266,41,491589,60000,999408,656018,343390
2267,83,491791,132000,971656,656518,315138
2268,96,491941,88000,975436,657736,317700
2270,75,493041,5500,975546,656736,318810
2270,75,493041,82500,976935,658018,318917
2273,16,493716,5500,976936,658236,318700
2277,14,495010,5500,977156,657018,320138
2278,38,495109,44000,980936,625226,355710
2280,53,495255,5500,981046,660736,320310
2281,93,495301,5500,982435,659018,323417
2279,63,495160,5500,982436,657236,325200
2281,93,495301,44000,982656,661518,321138
2281,93,495301,44000,986436,657518,328918
2287,53,497188,44000,986546,661736,324810
2290,52,497907,44000,987935,659236,328699
2290,52,497907,121000,987936,661925,326011
2294,92,498922,5500,988156,658518,329638
2293,98,498767,5500,991936,661018,330918
2294,92,498922,5500,992046,627036,365010
2293,98,498767,5500,993435,662036,331399
2294,92,498922,5500,993436,659518,333918
2293,98,498767,44000,993656,662536,331120
2295,65,498941,5500,997436,658736,338700
2298,48,499284,5500,997546,625106,372440
2297,46,499254,82500,998935,659736,339199
2297,46,499254,5500,998936,662425,336511
2299,29,499621,5500,999156,630376,368780
2414,43,525068,121000,993656,660018,333638
2415,31,525288,116000,993436,660236,333200
2413,48,524837,39000,997436,661236,336200
2418,92,525758,500,588675,663536,-74861
2417,82,525538,77500,998936,660518,338418
2415,31,525288,44000,997546,663036,334510
2418,92,525758,39000,999156,630556,368600
2417,82,525538,500,589181,663925,-74744
2417,82,525538,5500,602736,662925,-60189
2416,92,525383,500,589675,663425,-73750
2420,65,525934,500,589681,664036,-74355
2422,17,526283,500,590175,630606,-40431
2418,92,525758,500,590181,664425,-74244
2419,27,525874,500,590675,664925,-74250
2421,82,526194,500,590681,664536,-73855
2423,55,526325,500,591175,665536,-74361
2429,81,528334,500,591181,665036,-73855
2430,43,528387,500,591675,665425,-73750
2430,43,528387,500,591681,665925,-74244
2430,43,528387,500,592175,654736,-62561
2429,81,528334,500,592181,666036,-73855
2429,81,528334,500,592675,666425,-73750
2430,43,528387,500,592681,667536,-74855
2430,43,528387,500,593175,666536,-73361
2429,81,528334,500,593181,666925,-73744
2431,53,529191,500,593675,667036,-73361
2431,53,529191,500,593681,656018,-62337
2431,53,529191,500,594175,667925,-73750
2432,100,529228,5500,607506,667425,-59919
2434,53,529283,500,594181,668036,-73855
2432,100,529228,500,594675,668425,-73750
2434,53,529283,500,594681,669425,-74744
2431,53,529191,500,595066,668536,-73470
2433,66,529273,500,595216,669536,-74320
2432,100,529228,500,595566,669925,-74359
2432,100,529228,500,595716,662925,-67209
2431,53,529191,500,596066,668925,-72859
2432,100,529228,500,596216,670425,-74209
2432,100,529228,500,596566,670536,-73970
2432,100,529228,500,596716,670925,-74209
2433,66,529273,500,597066,671036,-73970
2432,100,529228,500,597216,669036,-71820
2433,66,529273,500,597566,671425,-73859
2431,53,529191,500,597716,670036,-72320
2432,100,529228,500,598066,672425,-74359
2432,100,529228,500,598216,672036,-73820
2432,100,529228,500,598566,671536,-72970
2432,100,529228,500,598716,672536,-73820
2434,53,529283,500,599066,671925,-72859
2433,66,529273,5500,607616,672925,-65309
2434,53,529283,500,599216,673036,-73820
2431,53,529191,500,599566,673425,-73859
2434,53,529283,5500,608005,672036,-64031
2432,100,529228,500,599716,673536,-73820
2433,66,529273,500,600066,672925,-72859
2434,53,529283,500,600216,674036,-73820
2436,76,530143,500,600566,674425,-73859
2436,76,530143,500,600716,674925,-74209
2435,88,530122,5500,608005,675036,-67031
2435,88,530122,500,601066,676536,-75470
2436,76,530143,5500,608236,677536,-69300
2436,76,530143,500,601216,677925,-76709
2435,88,530122,500,601566,679036,-77470
2438,36,530415,500,601716,681425,-79709
2437,29,530325,500,602066,681536,-79470
2435,88,530122,500,602216,680536,-78320
2435,88,530122,500,602566,681036,-78470
2439,54,530517,500,602716,684036,-81320
2436,76,530143,5500,613006,684425,-71419
2438,36,530415,500,603066,684536,-81470
2439,54,530517,500,603216,685536,-82320
2435,88,530122,500,603566,686425,-82859
2435,88,530122,500,603716,687036,-83320
2439,54,530517,500,604066,687536,-83470
2435,88,530122,500,604216,687925,-83709
2435,88,530122,500,604566,688425,-83859
2436,76,530143,5500,613116,690925,-77809
2435,88,530122,500,604716,689536,-84820
2435,88,530122,5500,613505,689425,-75920
2435,88,530122,500,605066,690425,-85359
2439,54,530517,500,605216,690536,-85320
2438,36,530415,5500,613505,691925,-78420
2439,54,530517,500,605566,692036,-86470
2439,54,530517,500,605716,693536,-87820
2437,29,530325,500,606066,694536,-88470
2439,54,530517,500,606216,694425,-88209
2439,54,530517,500,606566,695036,-88470
2441,50,531448,500,606716,696425,-89709
2440,27,531390,500,607066,696536,-89470
2443,86,531563,500,607216,697036,-89820
2443,86,531563,500,607566,698425,-90859
2440,27,531390,500,607716,698536,-90820
2440,27,531390,500,608066,698925,-90859
2442,39,531521,500,608216,699036,-90820
2443,86,531563,500,608566,699036,-90470
2441,50,531448,500,608716,699925,-91209
2442,39,531521,500,609066,700036,-90970
2442,39,531521,500,609216,701925,-92709
2443,86,531563,500,609566,701536,-91970
2443,86,531563,500,609716,702425,-92709
2441,50,531448,500,610066,703925,-93859
2443,86,531563,500,610216,704425,-94209
2443,86,531563,500,610566,704925,-94359
2443,86,531563,500,610716,705536,-94820
2442,39,531521,500,611066,706425,-95359
2443,86,531563,500,611216,707036,-95820
2444,19,531643,500,611566,707536,-95970
2443,86,531563,500,611716,707925,-96209
2445,46,532138,500,612066,709265,-97199
2441,50,531448,500,612216,709536,-97320
2441,50,531448,500,612566,713379,-100813
2443,86,531563,500,612716,715765,-103049
2441,50,531448,500,613066,717765,-104699
2441,50,531448,500,613216,725765,-112549
2443,86,531563,500,613566,734379,-120813
2445,46,532138,5500,613736,738265,-124529
2445,46,532138,500,613716,744379,-130663
2444,19,531643,500,614066,753265,-139199
2445,46,532138,500,614216,761879,-147663
2446,54,533020,500,614566,765879,-151313
2446,54,533020,4000,614716,771265,-156549
2446,54,533020,39000,615066,774879,-159813
2447,61,533292,42500,615216,777265,-162049
2447,61,533292,4000,615566,785379,-169813
2446,54,533020,46000,615716,790879,-175163
2447,61,533292,11000,616066,798379,-182313
2446,54,533020,4000,616216,800765,-184549
2447,61,533292,4000,616566,806879,-190313
2446,54,533020,4000,616716,814379,-197663
2448,63,533748,9000,618506,816379,-197873
2448,63,533748,4000,617066,821265,-204199
2449,58,533749,500,617216,824265,-207049
2448,63,533748,5500,618616,824879,-206263
2449,58,533749,500,617566,826379,-208813
2447,61,533292,500,617716,828879,-211163
2448,63,533748,5500,619005,830765,-211760
2447,61,533292,14500,618066,838265,-220199
2447,61,533292,18000,618216,841379,-223163
2448,63,533748,25000,618566,844765,-226199
2449,58,533749,81000,618716,853765,-235049
2449,58,533749,53000,619066,859265,-240199
2450,47,534139,56500,619216,863379,-244163
2451,100,534267,112500,619566,869265,-249699
2448,63,533748,131500,619005,873765,-254760
2448,63,533748,7500,619716,876265,-256549
2451,100,534267,46000,620066,880265,-260199
2451,100,534267,28500,620216,885265,-265049
2451,100,534267,11000,620566,887265,-266699
2448,63,533748,30000,619236,892265,-273029
2450,47,534139,14500,620716,895765,-275049
2451,100,534267,42500,621066,904379,-283313
2449,58,533749,7500,621216,905879,-284663
2448,63,533748,49500,621566,908879,-287313
2450,47,534139,21500,621716,913265,-291549
2448,63,533748,30000,624006,918265,-294259
2449,58,533749,245500,624006,921379,-297373
2452,59,534350,21500,622216,924765,-302549
2452,59,534350,11000,622566,928265,-305699
2451,100,534267,145500,629506,935265,-305759
2453,88,534574,67500,627566,939879,-312313
2453,88,534574,115500,629216,947265,-318049
2454,84,534814,28000,629716,954765,-325049
2455,38,535176,8000,630716,957879,-327163
2457,50,535389,4500,630566,960879,-330313
2457,50,535389,19500,632216,966765,-334549
2459,82,535940,12500,634216,968765,-334549
2460,24,536019,28000,635216,975265,-340049
2462,19,536233,4000,632566,976765,-344199
2461,48,536171,56000,636716,978765,-342049
2463,69,536457,52000,635566,980379,-344813
2464,81,536682,76000,640066,986379,-346313
2464,81,536682,111500,641566,994379,-352813
2465,60,536742,76000,642566,999765,-357199
2466,20,536994,12000,641216,999879,-358663
2468,92,537383,12500,644716,749036,-104320
2468,92,537383,87500,645566,751536,-105970
2469,20,537450,8000,646716,752425,-105709
2471,79,538133,12500,649716,674726,-25010
2471,79,538133,51500,651216,752036,-100820
2472,70,538246,116000,652066,752925,-100859
2473,31,538359,12000,652566,753036,-100470
2474,37,538858,64000,654066,753536,-99470
2476,15,539043,4500,653566,753925,-100359
2476,15,539043,7500,654216,679876,-25660
2477,21,539176,44000,640616,754425,-113809
2478,47,539677,20000,656216,755036,-98820
2479,75,539801,20000,656716,756036,-99320
2481,47,540642,12500,658216,756425,-98209
2481,47,540642,31500,660216,756925,-96709
2482,17,540676,12000,661216,758536,-97320
2483,86,541244,100000,664716,758425,-93709
2484,79,541298,180000,665066,759425,-94359
2485,27,541412,8000,665566,759536,-93970
2486,13,541849,4000,663066,760036,-96970
2488,69,541903,16500,668066,761036,-92970
2488,69,541903,67500,666716,761925,-95209
2489,50,542085,56000,667566,762036,-94470
2490,94,542919,88000,677566,762536,-84970
2491,79,542975,120000,678566,763536,-84970
2492,50,543045,116000,675066,764925,-89859
2493,63,543059,32000,679066,765425,-86359
2494,56,543395,68000,680066,766925,-86859
2496,64,543466,24500,680716,766536,-85820
2496,64,543466,67500,682216,767425,-85209
2498,65,543941,500,679566,767536,-87970
2498,65,543941,159500,683066,768536,-85470
2499,43,544467,20000,684216,769925,-85709
2500,45,544758,24000,686216,770425,-84209
2502,23,545223,500,685566,770925,-85359
2502,23,545223,11500,686066,771536,-85470
2503,93,545500,108000,690216,772536,-82320
2504,92,545534,40000,694216,773425,-79209
2505,52,545640,12000,691566,773536,-81970
2506,87,545699,88000,695716,774925,-79209
2507,81,546261,108000,697566,776036,-78470
2508,70,546394,88000,701216,777536,-76320
2510,60,546439,8500,701066,777925,-76859
2510,60,546439,71500,702216,778536,-76320
2512,83,546913,500,697716,779036,-81320
2512,83,546913,91500,705066,779036,-73970
2513,60,547202,84000,707716,779536,-71820
2514,93,547272,72000,707566,780425,-72859
2515,79,547594,28000,708716,781425,-72709
2516,28,548744,4000,709066,782536,-73470
2517,100,549184,32000,712066,782425,-70359
2518,41,549221,16000,711566,782925,-71359
2520,85,549995,500,712216,783036,-70820
2520,85,549995,91500,715216,783425,-68209
2522,67,550775,24500,718566,783925,-65359
2522,67,550775,19500,718716,784536,-65820
2523,83,551138,36000,720716,785536,-64820
2524,52,551581,28000,721716,786425,-64709
2526,74,553347,4500,723216,786925,-63709
2526,74,553347,115500,726066,788425,-62359
2527,78,553818,84000,729566,789925,-60359
2528,90,554006,68000,727566,790425,-62859
2529,88,554129,72000,729716,792036,-62320
2531,17,554629,500,729216,792425,-63209
2532,77,554998,8000,731216,792536,-61320
2532,77,554998,119500,734216,793925,-59709
2533,49,555111,28000,734716,794425,-59709
2534,79,555564,76000,737066,794536,-57470
2535,87,556024,132000,739566,795425,-55859
2537,83,556259,8500,740066,795536,-55470
2537,83,556259,63500,740566,796036,-55470
2538,67,557009,36000,743216,797036,-53820
2539,46,557383,56000,746716,800036,-53320
2540,33,557486,56000,743566,798536,-54970
2542,48,557813,72500,754066,799925,-45859
2542,48,557813,75500,752566,802036,-49470
2544,71,557915,36500,753716,802425,-48709
2544,71,557915,99500,754216,802536,-48320
2545,15,557919,56000,751716,802925,-51209
2546,73,558995,36000,757566,803925,-46359
2549,87,559457,4500,756716,804036,-47320
2549,87,559457,100500,759566,804425,-44859
2549,87,559457,63000,758066,805036,-46970
2551,79,559899,96500,760216,805425,-45209
2551,79,559899,83500,765216,806036,-40820
2553,91,560299,20500,766216,806925,-40709
2553,91,560299,55500,767566,807925,-40359
2554,44,560360,48000,761716,808036,-46320
2555,86,560600,84000,771216,808425,-37209
2557,57,561133,500,767716,808536,-40820
2557,57,561133,47500,774566,809036,-34470
2559,40,561210,4500,769216,809425,-40209
2559,40,561210,23500,774716,809536,-34820
2560,38,561635,104000,775566,809925,-34359
2561,23,561768,52000,775066,707556,67510
2562,11,562311,8000,776066,810036,-33970
2563,74,562946,24000,778066,810536,-32470
2565,81,563627,52500,783566,810925,-27359
2566,77,563764,128000,788716,811425,-22709
2566,77,563764,135500,791566,813036,-21470
2567,16,563769,48000,778566,813425,-34859
2569,45,563822,96500,793716,812536,-18820
2569,45,563822,119500,793216,813536,-20320
2570,29,563896,56000,794566,813925,-19359
2571,72,564004,44000,795716,814036,-18320
2572,31,564117,112000,796566,814536,-17970
2574,62,564568,64500,797716,815036,-17320
2574,62,564568,123500,799216,816036,-16820
2575,20,564575,8000,796066,816536,-20470
2576,19,564881,56000,801216,816425,-15209
2577,53,564930,68000,800066,817536,-17470
2578,99,565484,56000,808566,818536,-9970
2580,81,565825,80500,812716,819536,-6820
2580,81,565825,103500,815566,819425,-3859
2581,92,566113,152000,821216,821036,180
2582,91,566195,100000,821716,821925,-209
2583,24,566228,32000,822066,822425,-359
2584,100,566363,196000,823216,823925,-709
2585,11,567235,4000,823566,824425,-859
2588,69,567685,64500,829716,824036,5680
2587,18,567660,52000,825716,824925,791
2588,69,567685,151500,830066,825425,4641
2589,50,568386,160000,831566,825925,5641
2590,30,568712,64000,833566,826036,7530
2591,100,568946,72000,837716,827036,10680
2592,100,569538,220000,840216,828536,11680
2593,64,570074,72000,841566,829925,11641
2594,64,570488,24000,843216,830036,13180
2596,27,570874,4500,842566,831536,11030
2596,27,570874,63500,844216,830536,13680
2597,34,571223,28000,845066,831425,13641
2598,56,571282,172000,844066,833536,10530
2599,71,571315,48000,844716,832036,12680
2600,91,571475,72000,610675,833425,-222750
2601,66,571582,96000,750506,834036,-83530
2602,76,571948,72000,616181,834425,-218244
2603,11,572219,8000,614181,834536,-220355
2604,70,572508,92000,751005,834925,-83920
2605,73,572576,96000,751005,835425,-84420
2606,82,572659,96000,750616,835536,-84920
2607,97,573138,96000,756006,837036,-81030
2608,41,573385,148000,761506,838925,-77419
2609,25,573512,144000,761616,839425,-77809
2610,62,573602,40000,636175,840425,-204250
2611,91,573837,52000,640181,841036,-200855
2612,94,573943,180000,767505,840925,-73420
2613,28,574079,20000,639181,841425,-202244
2614,49,574196,28000,648681,841536,-192855
2615,97,574312,220000,767116,842036,-74920
2616,74,574390,76000,767505,843036,-75531
2617,90,574762,32000,651675,844036,-192361
2619,70,574781,88500,772506,844925,-72419
2620,93,574895,140000,772616,845536,-72920
2620,93,574895,123500,773005,846536,-73531
2621,27,575088,56000,773005,846925,-73920
2622,20,575313,8000,657175,847425,-190250
2623,12,575971,56000,773236,847925,-74689
2624,51,576180,28000,664681,848425,-183744
2625,37,576186,20000,664675,848536,-183861
2626,32,576300,120000,778116,849425,-71309
2628,71,577011,72500,783506,849925,-66419
2628,71,577011,55500,674681,850036,-175355
2630,60,577155,24500,678175,851036,-172861
2630,60,577155,143500,784005,851925,-67920
2631,88,577399,188000,784005,852536,-68531
2633,97,577449,32500,685181,852925,-167744
2633,97,577449,139500,784236,853036,-68800
2635,80,577890,4500,688681,854536,-165855
2635,80,577890,111500,789116,854036,-64920
2637,75,578163,28500,693675,854925,-161250
2637,75,578163,79500,789006,855036,-66030
2638,52,578364,24000,694675,855925,-161250
2639,21,578420,8000,692675,856536,-163861
2640,17,579107,20000,698681,857536,-158855
2641,33,579211,52000,789505,856425,-66920
2642,56,579234,28000,700181,857925,-157744
2643,67,579526,96000,789505,858536,-69031
2644,34,579619,16000,699181,858425,-159244
2646,48,580121,4500,702181,858925,-156744
2646,48,580121,55500,707175,859036,-151861
2647,41,580834,32000,710181,859925,-149744
2648,66,581224,184000,795005,860425,-65420
2649,66,581392,32000,715681,861036,-145355
2650,90,581757,104000,794506,862036,-67530
2652,79,582046,56500,795005,862425,-67420
2652,79,582046,99500,800006,864536,-64530
2653,31,582358,16000,728675,863425,-134750
2655,32,582591,53500,795236,864425,-69189
2655,32,582591,66500,795236,864536,-69300
2656,73,582628,96000,805506,865925,-60419
2658,100,582852,8500,733681,866036,-132355
2658,100,582852,223500,800736,867036,-66300
2659,19,583352,60000,805616,868036,-62420
2660,32,583784,64000,806005,867536,-61531
2661,56,583945,72000,811116,869425,-58309
2662,25,584096,20000,744675,869536,-124861
2663,23,584188,12000,740675,869036,-128361
2665,60,584384,37500,806005,870925,-64920
2665,60,584384,82500,806005,869925,-63920
2666,35,584568,64000,806236,871036,-64800
2667,85,584760,152000,811505,871425,-59920
2669,63,585306,4500,755675,873925,-118250
2669,63,585306,91500,811736,871536,-59800
2671,97,585452,120500,816506,872536,-56030
2671,97,585452,171500,817005,874036,-57031
2672,13,585504,56000,816616,874925,-58309
2673,20,585508,12000,765675,874425,-108750
2674,65,585569,112000,817236,874536,-57300
2675,93,585890,60000,770175,876925,-106750
2677,91,586746,140500,822505,876536,-54031
2677,91,586746,159500,822736,877925,-55189
2678,99,586915,320000,833006,878536,-45530
2679,59,587159,60000,789175,879925,-90750
2680,52,587540,168000,833116,880425,-47309
2682,40,587949,20500,796181,880925,-84744
2682,40,587949,39500,798675,881036,-82361
2683,94,588276,188000,833736,882036,-48300
2685,46,588319,61500,839005,757106,81899
2685,46,588319,114500,838616,882925,-44309
2686,24,588548,64000,839005,883036,-44031
2687,66,588903,208000,844006,883536,-39530
2689,56,589574,8500,811181,884425,-73244
2689,56,589574,87500,844505,884036,-39531
2690,40,589797,116000,844505,884925,-40420
2692,92,590201,68500,844736,885536,-40800
2692,92,590201,67500,819181,887036,-67855
2694,62,591301,24500,822681,887536,-64855
2694,62,591301,115500,849506,887925,-38419
2695,15,591748,56000,849616,888036,-38420
2696,59,592387,112000,850005,888536,-38531
2698,69,592732,108500,855116,888925,-33809
2698,69,592732,187500,855505,889425,-33920
2699,18,593257,20000,837675,889925,-52250
2700,42,593272,44000,841675,890036,-48361
2701,46,593396,92000,855736,891425,-35689
2702,43,593658,140000,860506,891536,-31030
2703,12,594333,56000,860616,891925,-31309
2704,25,594745,140000,861005,892036,-31031
2705,29,594982,76000,861236,892425,-31189
2706,41,595211,112000,877336,892925,-15589
2707,18,595239,108000,876066,893036,-16970
2708,56,595342,196000,884066,893536,-9470
2709,98,595417,168000,884836,895536,-10700
2710,96,595505,288000,891066,897536,-6470
2711,74,595579,280000,893066,898925,-5859
2712,25,595774,48000,896336,900036,-3700
2713,53,595921,132000,898336,899925,-1589
2714,82,596089,228000,900566,901925,-1359
2715,26,596473,48000,905836,902425,3411
2716,24,596766,120000,915836,902536,13300
2717,40,596988,64000,925566,903536,22030
2718,28,597192,44000,926336,905425,20911
2720,45,597349,164500,937566,905925,31641
2721,70,597384,112000,938336,906536,31800
2721,70,597384,323500,938566,906425,32141
2722,82,597505,112000,943836,907425,36411
2723,18,597628,112000,943336,908036,35300
2724,21,597635,40000,947566,909036,38530
2725,79,597746,284000,951066,908925,42141
2726,15,597922,68000,951566,909425,42141
2727,61,598213,172000,961336,911425,49911
2728,90,598429,256000,966336,911036,55300
2729,78,598434,220000,967066,911925,55141
2730,24,598623,76000,968066,912425,55641
2732,76,599122,56500,973836,912036,61800
2732,76,599122,207500,976066,913425,62641
2733,20,599265,36000,976566,913536,63030
2734,27,600084,36000,993566,914536,79030
2735,77,600129,208000,998566,914925,83641
2737,48,600385,16500,999836,915536,84300
2737,48,600385,175500,993336,916036,77300
2739,92,600561,24500,995336,916425,78911
2739,92,600561,147500,999566,917536,82030
2740,96,600675,256000,999336,918425,80911
2741,71,600709,80000,998836,918925,79911
2742,21,601475,44000,932006,919036,12970
2743,92,601776,176000,932736,919536,13200
2744,33,602423,132000,943006,920036,22970
2745,65,602825,132000,943736,921425,22311
2747,51,602964,93500,949236,922536,26700
2747,51,602964,170500,948506,923925,24581
2750,97,603550,5500,948616,924036,24580
2749,33,603211,44000,949005,924536,24469
2750,97,603550,126500,954006,925425,28581
2752,81,604158,5500,954116,925925,28191
2752,81,604158,214500,960005,926036,33969
2753,64,604186,44000,954505,927425,27080
2754,72,604498,88000,960005,927925,32080
2755,42,604999,88000,965006,928425,36581
2757,97,605871,49500,965736,928536,37200
2760,34,606094,132000,971005,775536,195469
2759,55,606070,49500,971005,929036,41969
2761,20,606246,88000,971236,929536,41700
2760,34,606094,82500,976006,929925,46081
2762,31,606259,44000,976116,930425,45691
2763,25,606816,44000,976505,930536,45969
2765,26,607485,44000,976505,930925,45580
2765,26,607485,5500,976736,930036,46700
2766,68,607829,82500,981506,931425,50081
2767,69,607885,220000,987736,931036,56700
2768,66,607971,88000,987006,931536,55470
2769,83,608063,44000,987116,932036,55080
2769,83,608063,170500,993005,931925,61080
2772,10,608491,5500,992616,933425,59191
2773,82,608525,5500,993005,932425,60580
2773,82,608525,88000,998006,933536,64470
2773,82,608525,209000,998505,932925,65580
2775,66,609154,5500,998736,933925,64811
3260,41,718690,39000,998736,933036,65700
3261,61,719103,500,845681,932536,-86855
3261,61,719103,500,846175,934036,-87861
3262,67,719111,500,846181,778876,67305
3262,67,719111,500,846675,934536,-87861
3262,67,719111,500,846681,934925,-88244
3261,61,719103,500,847175,934425,-87250
3262,67,719111,500,847181,935036,-87855
3260,41,718690,500,847675,945925,-98250
3261,61,719103,500,847681,949036,-101355
3262,67,719111,500,848175,935425,-87250
3261,61,719103,500,848181,934036,-85855
3260,41,718690,500,848675,940036,-91361
3260,41,718690,500,848681,935536,-86855
3261,61,719103,500,849175,934425,-85250
3261,61,719103,500,849181,946036,-96855
3262,67,719111,500,849675,949425,-99750
3262,67,719111,500,849681,946425,-96744
3262,67,719111,500,850175,935925,-85750
3261,61,719103,500,850181,946536,-96355
3261,61,719103,500,850675,946925,-96250
3262,67,719111,500,850681,949536,-98855
3264,53,719415,500,851175,949925,-98750
3262,67,719111,500,851181,953425,-102244
3263,23,719402,500,851675,958536,-106861
3262,67,719111,500,851681,960425,-108744
3261,61,719103,500,852175,964925,-112750
3261,61,719103,500,852181,966425,-114244
3261,61,719103,500,852675,969036,-116361
3261,61,719103,500,852681,968925,-116244
3264,53,719415,500,853175,974425,-121250
3264,53,719415,500,853181,980036,-126855
3260,41,718690,500,853675,981536,-127861
3262,67,719111,500,853681,982536,-128855
3262,67,719111,500,854175,983925,-129750
3262,67,719111,500,854181,985036,-130855
3261,61,719103,500,854675,989925,-135250
3264,53,719415,500,854681,994925,-140244
3262,67,719111,500,855175,996036,-140861
3261,61,719103,500,855181,998425,-143244
3264,53,719415,500,855675,999925,-144250
3261,61,719103,500,855681,817376,38305
3262,67,719111,500,856175,817556,38619
3261,61,719103,500,856181,819536,36645
3262,67,719111,500,856675,823056,33619
3261,61,719103,500,856681,823106,33575
3261,61,719103,500,857175,822876,34299
3264,53,719415,500,857181,823226,33955
3265,70,719800,500,857675,825036,32639
3263,23,719402,500,857681,828376,29305
3265,70,719800,500,858175,828556,29619
3262,67,719111,500,858181,828606,29575
3261,61,719103,500,858675,830536,28139
3265,70,719800,500,858681,833876,24805
3261,61,719103,500,859175,834106,25069
3262,67,719111,500,859181,834226,24955
3261,61,719103,500,859675,836036,23639
3264,53,719415,500,859681,839556,20125
3265,70,719800,500,860175,839726,20449
3265,70,719800,500,860181,844876,15305
3264,53,719415,500,860675,845056,15619
3261,61,719103,500,860681,845106,15575
3265,70,719800,500,861175,845226,15949
3263,23,719402,500,861181,850556,10625
3264,53,719415,500,861675,850376,11299
3264,53,719415,500,861681,850726,10955
3265,70,719800,500,862175,855876,6299
3263,23,719402,500,862181,852536,9645
3265,70,719800,500,862675,858036,4639
3264,53,719415,500,862681,861376,1305
3266,20,720087,500,863175,861556,1619
3265,70,719800,500,863181,869036,-5855
3265,70,719800,500,863675,863536,139
3266,20,720087,500,863681,872376,-8695
3267,74,720145,500,864175,867226,-3051
3265,70,719800,500,864181,872556,-8375
3266,20,720087,500,864675,872606,-7931
3265,70,719800,500,864681,874536,-9855
3265,70,719800,500,865175,872726,-7551
3266,20,720087,500,865181,878056,-12875
3267,74,720145,500,865675,877876,-12201
3267,74,720145,500,865681,880036,-14355
3266,20,720087,500,866175,878106,-11931
3268,93,720236,500,866181,883376,-17195
3263,23,719402,500,866675,878226,-11551
3268,93,720236,500,866681,883556,-16875
3267,74,720145,500,867175,883606,-16431
3268,93,720236,500,867181,885536,-18355
3265,70,719800,500,867675,888876,-21201
3265,70,719800,500,867681,889056,-21375
3267,74,720145,500,868175,889106,-20931
3268,93,720236,500,868181,891036,-22855
3268,93,720236,500,868675,894556,-25881
3267,74,720145,500,868681,889226,-20545
3267,74,720145,500,869175,899876,-30701
3265,70,719800,500,869181,900056,-30875
3265,70,719800,500,869675,894376,-24701
3267,74,720145,500,869681,894606,-24925
3265,70,719800,500,870175,894376,-24201
3265,70,719800,500,870181,894606,-24425
3266,20,720087,500,870675,900106,-29431
3266,20,720087,500,870681,899876,-29195
3267,74,720145,500,871175,900056,-28881
3268,93,720236,500,871181,900226,-29045
3265,70,719800,500,871675,905606,-33931
3265,70,719800,500,871681,905726,-34045
3267,74,720145,500,872175,910876,-38701
3266,20,720087,500,872181,673518,198663
3268,93,720236,500,872675,911056,-38381
3268,93,720236,500,872681,678018,194663
3265,70,719800,500,873175,911106,-37931
3265,70,719800,500,873181,911226,-38045
3267,74,720145,500,873675,916376,-42701
3269,99,720431,500,873681,918536,-44855
3269,99,720431,500,874175,921876,-47701
3265,70,719800,500,874181,922056,-47875
3265,70,719800,500,874675,703018,171657
3267,74,720145,500,874681,922106,-47425
3265,70,719800,500,875175,924036,-48861
3268,93,720236,500,875181,927556,-52375
3269,99,720431,500,875675,713236,162439
3267,74,720145,500,875681,929536,-53855
3268,93,720236,500,876175,932876,-56701
3269,99,720431,500,876181,933106,-56925
3269,99,720431,500,876675,935036,-58361
3269,99,720431,500,876681,938376,-61695
3269,99,720431,500,877175,940536,-63361
3271,51,720588,500,877181,944106,-66925
3270,32,720509,500,877675,944226,-66551
3271,51,720588,500,877681,751518,126163
3267,74,720145,500,878175,946036,-67861
3268,93,720236,500,878181,949376,-71195
3269,99,720431,500,878675,762236,116439
3270,32,720509,500,878681,954876,-76195
3267,74,720145,500,879175,955226,-76051
3271,51,720588,500,879181,780518,98663
3269,99,720431,500,879675,780736,98939
3269,99,720431,500,879681,957036,-77355
3271,51,720588,500,880175,960556,-80381
3267,74,720145,500,880181,962536,-82355
3271,51,720588,500,880675,966106,-85431
3268,93,720236,500,880681,968036,-87355
3267,74,720145,500,881175,971606,-90431
3268,93,720236,500,881181,805236,75945
3270,32,720509,500,881675,982556,-100881
3268,93,720236,500,881681,987876,-106195
3268,93,720236,500,882175,816518,65657
3266,20,720087,500,882181,988226,-106045
3265,70,719800,500,882675,993556,-110881
3269,99,720431,500,882681,995536,-112855
3271,51,720588,500,883175,837236,45939
3268,93,720236,500,883181,999106,-115925
3267,74,720145,500,883675,999226,-115551
3267,74,720145,500,883681,850018,33663
3271,51,720588,500,884175,858236,25939
3268,93,720236,500,884181,866518,17663
3268,93,720236,500,884675,869236,15439
3267,74,720145,500,884681,870518,14163
3267,74,720145,500,885175,873518,11657
3267,74,720145,500,885181,881518,3663
3268,93,720236,500,885675,885518,157
3268,93,720236,500,885681,886736,-1055
3267,74,720145,500,886175,893736,-7561
3268,93,720236,500,886181,900518,-14337
3268,93,720236,500,886675,911018,-24343
3268,93,720236,500,886681,916236,-29555
3267,74,720145,500,887175,918736,-31561
3271,51,720588,500,887181,924018,-36837
3268,93,720236,500,887675,926518,-38843
3269,99,720431,500,887681,928518,-40837
3267,74,720145,500,888175,932018,-43843
3270,32,720509,500,888181,937736,-49555
3267,74,720145,500,888675,943518,-54843
3271,51,720588,500,888681,949518,-60837
3268,93,720236,500,889175,956518,-67343
3267,74,720145,500,889181,960018,-70837
3268,93,720236,500,889675,969518,-79843
3267,74,720145,500,889681,976236,-86555
3267,74,720145,500,890175,983736,-93561
3268,93,720236,500,890181,986236,-96055
3269,99,720431,500,890675,993518,-102843
3268,93,720236,500,890681,995736,-105055
3267,74,720145,500,891175,997518,-106343
3268,93,720236,500,891181,999736,-108555
3271,51,720588,500,891675,972065,-80390
3268,93,720236,500,891681,973065,-81384
3269,99,720431,500,892175,975065,-82890
3267,74,720145,500,892181,975065,-82884
3268,93,720236,500,892675,975565,-82890
3270,32,720509,500,892681,975565,-82884
3272,75,720965,500,893175,904896,-11721
3271,51,720588,500,893181,973065,-79884
3270,32,720509,500,893675,976065,-82390
3268,93,720236,500,893681,972565,-78884
3270,32,720509,500,894175,976065,-81890
3269,99,720431,500,894181,977565,-83384
3269,99,720431,500,894675,973565,-78890
3272,75,720965,500,894681,977565,-82884
3272,75,720965,500,895175,973565,-78390
3268,93,720236,500,895181,976565,-81384
3272,75,720965,500,895675,972565,-76890
3268,93,720236,500,895681,974065,-78384
3272,75,720965,500,896175,976565,-80390
3270,32,720509,500,896181,974065,-77884
3268,93,720236,500,896675,974565,-77890
3271,51,720588,500,896681,977065,-80384
3272,75,720965,500,897175,980065,-82890
3272,75,720965,500,897181,978065,-80884
3269,99,720431,500,897675,977065,-79390
3269,99,720431,500,897681,980565,-82884
3269,99,720431,500,898175,980565,-82390
3271,51,720588,500,898181,908666,-10485
3271,51,720588,500,898675,981065,-82390
3272,75,720965,500,898681,974565,-75884
3272,75,720965,500,899175,985565,-86390
3272,75,720965,500,899181,981065,-81884
3272,75,720965,500,899675,908906,-9231
3269,99,720431,500,899681,985565,-85884
3272,75,720965,500,900175,978065,-77890
3269,99,720431,500,900181,910016,-9835
3269,99,720431,500,900675,981565,-80890
3272,75,720965,500,900681,981565,-80884
3272,75,720965,500,901175,982065,-80890
3270,32,720509,500,901181,982065,-80884
3271,51,720588,500,901675,982565,-80890
3269,99,720431,500,901681,978565,-76884
3269,99,720431,500,902175,982565,-80390
3269,99,720431,500,902181,978565,-76384
3270,32,720509,500,902675,979065,-76390
3271,51,720588,500,902681,910013,-7332
3270,32,720509,500,903175,979065,-75890
3272,75,720965,500,903181,979565,-76384
3271,51,720588,500,903675,983065,-79390
3271,51,720588,500,903681,983065,-79384
3271,51,720588,500,904175,983565,-79390
3272,75,720965,500,904181,979565,-75384
3273,42,721573,500,904675,983565,-78890
3272,75,720965,500,904681,984065,-79384
3272,75,720965,500,905175,984065,-78890
3272,75,720965,500,905181,984565,-79384
3273,42,721573,500,905675,984565,-78890
3273,42,721573,500,905681,980065,-74384
3272,75,720965,500,906175,985065,-78890
3274,74,721665,500,906181,985065,-78884
3273,42,721573,500,906675,986065,-79390
3273,42,721573,500,906681,914166,-7485
3273,42,721573,500,907175,987065,-79890
3274,74,721665,500,907181,910396,-3215
3275,99,721732,500,907675,987065,-79390
3273,42,721573,500,907681,986065,-78384
3272,75,720965,500,908175,986565,-78390
3274,74,721665,500,908181,987565,-79384
3275,99,721732,500,908675,987565,-78890
3274,74,721665,500,908681,989565,-80884
3274,74,721665,500,909175,988065,-78890
3272,75,720965,500,909181,990065,-80884
3275,99,721732,500,909675,990565,-80890
3272,75,720965,500,909681,988065,-78384
3275,99,721732,500,910175,988565,-78390
3275,99,721732,500,910181,986565,-76384
3275,99,721732,500,910675,988565,-77890
3274,74,721665,500,910681,989065,-78384
3275,99,721732,500,911175,990565,-79390
3274,74,721665,500,911181,994565,-83384
3275,99,721732,500,911675,994565,-82890
3274,74,721665,500,911681,995065,-83384
3274,74,721665,500,912175,989065,-76890
3275,99,721732,500,912181,991065,-78884
3275,99,721732,500,912675,995065,-82390
3275,99,721732,500,912681,991065,-78384
3275,99,721732,500,913175,995565,-82390
3274,74,721665,500,913181,989565,-76384
3273,42,721573,500,913675,991565,-77890
3273,42,721573,500,913681,991565,-77884
3275,99,721732,500,914175,996565,-82390
3274,74,721665,500,914181,992065,-77884
3276,11,721773,500,914675,992065,-77390
3273,42,721573,500,914681,995565,-80884
3277,40,721947,500,915175,992565,-77390
3275,99,721732,500,915181,996065,-80884
3273,42,721573,500,915675,996565,-80890
3273,42,721573,500,915681,997065,-81384
3274,74,721665,500,916175,992565,-76390
3275,99,721732,500,916181,990065,-73884
3274,74,721665,500,916675,915516,1159
3274,74,721665,500,916681,997065,-80384
3275,99,721732,500,917175,993065,-75890
3278,95,722173,500,917181,914406,2775
3278,95,722173,500,917675,993065,-75390
3275,99,721732,500,917681,996065,-78384
3278,95,722173,500,918175,993565,-75390
3275,99,721732,500,918181,993565,-75384
3274,74,721665,500,918675,994065,-75390
3275,99,721732,500,918681,997565,-78884
3278,95,722173,500,919175,997565,-78390
3274,74,721665,500,919181,994065,-74884
3277,40,721947,500,919675,998065,-78390
3277,40,721947,500,919681,998065,-78384
3278,95,722173,500,920175,915513,4662
3278,95,722173,500,920181,998565,-78384
3275,99,721732,500,920675,998565,-77890
3278,95,722173,500,920681,999065,-78384
3275,99,721732,500,921175,919666,1509
3275,99,721732,500,921181,921013,168
3273,42,721573,500,921675,921016,659
3278,95,722173,500,921681,915896,5785
3278,95,722173,500,922175,925166,-2991
3275,99,721732,500,922181,999065,-76884
3278,95,722173,500,922675,999565,-76890
3275,99,721732,500,922681,999565,-76884
3273,42,721573,500,923175,919906,3269
3274,74,721665,500,923181,925406,-2225
3274,74,721665,500,923675,921396,2279
3275,99,721732,500,923681,926513,-2832
3278,95,722173,500,924175,926516,-2341
3278,95,722173,500,924181,926896,-2715
3275,99,721732,500,924675,930666,-5991
3277,40,721947,500,924681,930906,-6225
3274,74,721665,500,925175,932013,-6838
3274,74,721665,500,925181,932016,-6835
3274,74,721665,500,925675,932396,-6721
3275,99,721732,500,925681,936166,-10485
3276,11,721773,500,926175,936406,-10231
3277,40,721947,500,926181,937516,-11335
3275,99,721732,500,926675,937513,-10838
3275,99,721732,500,926681,941666,-14985
3274,74,721665,500,927175,941906,-14731
3275,99,721732,500,927181,937896,-10715
3280,77,722367,500,927675,943013,-15338
3274,74,721665,500,927681,943016,-15335
3274,74,721665,500,928175,943396,-15221
3277,40,721947,500,928181,947166,-18985
3278,95,722173,500,928675,947406,-18731
3278,95,722173,500,928681,948516,-19835
3277,40,721947,500,929175,948513,-19338
3279,15,722265,500,929181,952666,-23485
3278,95,722173,500,929675,959513,-29838
3278,95,722173,500,929681,948896,-19215
3280,77,722367,500,930175,954396,-24221
3275,99,721732,500,930181,954013,-23832
3279,15,722265,500,930675,954016,-23341
3275,99,721732,500,930681,952906,-22225
3280,77,722367,500,931175,958166,-26991
3276,11,721773,500,931181,959896,-28715
3278,95,722173,500,931675,958406,-26731
3278,95,722173,500,931681,959516,-27835
3278,95,722173,500,932175,963666,-31491
3280,77,722367,500,932181,963906,-31725
3280,77,722367,500,932675,965396,-32721
3281,68,722642,500,932681,965013,-32332
3281,68,722642,500,933175,965016,-31841
3281,68,722642,500,933181,969166,-35985
3280,77,722367,500,933675,969406,-35731
3278,95,722173,500,933681,970513,-36832
3280,77,722367,500,934175,970516,-36341
3281,68,722642,500,934181,974906,-40725
3281,68,722642,500,934675,970896,-36221
3279,15,722265,500,934681,976013,-41332
3277,40,721947,500,935175,974666,-39491
3280,77,722367,500,935181,976396,-41215
3277,40,721947,500,935675,976016,-40341
3280,77,722367,500,935681,980166,-44485
3281,68,722642,500,936175,981896,-45721
3278,95,722173,500,936181,980406,-44225
3278,95,722173,500,936675,981513,-44838
3279,15,722265,500,936681,992513,-55832
3277,40,721947,500,937175,985906,-48731
3278,95,722173,500,937181,981516,-44335
3278,95,722173,500,937675,987016,-49341
3277,40,721947,500,937681,991166,-53485
3278,95,722173,500,938175,985666,-47491
3280,77,722367,500,938181,987396,-49215
3278,95,722173,500,938675,992516,-53841
3280,77,722367,500,938681,987013,-48332
3278,95,722173,500,939175,996666,-57491
3280,77,722367,500,939181,991406,-52225
3277,40,721947,500,939675,998013,-58338
3280,77,722367,500,939681,992896,-53215
3278,95,722173,500,940175,996906,-56731
3280,77,722367,500,940181,998016,-57835
3280,77,722367,500,940675,998396,-57721
3278,95,722173,500,940681,948754,-8073
3280,77,722367,500,941175,948675,-7500
3280,77,722367,500,941181,949175,-7994
3278,95,722173,500,941675,949254,-7579
3280,77,722367,500,941681,949675,-7994
3280,77,722367,500,942175,949754,-7579
3278,95,722173,500,942181,947675,-5494
3281,68,722642,500,942675,950175,-7500
3278,95,722173,500,942681,950254,-7573
3280,77,722367,500,943175,947754,-4579
3279,15,722265,500,943181,950675,-7494
3280,77,722367,500,943675,950754,-7079
3278,95,722173,500,943681,951175,-7494
3280,77,722367,500,944175,951254,-7079
3281,68,722642,500,944181,951675,-7494
3278,95,722173,500,944675,948175,-3500
3281,68,722642,500,944681,948254,-3573
3280,77,722367,500,945175,951754,-6579
3281,68,722642,500,945181,952175,-6994
3281,68,722642,500,945675,952254,-6579
3281,68,722642,500,945681,952675,-6994
3282,73,723106,500,946175,953175,-7000
3282,73,723106,500,946181,954175,-7994
3280,77,722367,500,946675,952754,-6079
3280,77,722367,500,946681,953254,-6573
3282,73,723106,500,947175,953675,-6500
3281,68,722642,500,947181,954254,-7073
3280,77,722367,500,947675,954675,-7000
3281,68,722642,500,947681,953754,-6073
3282,73,723106,500,948175,954754,-6579
3281,68,722642,500,948181,955175,-6994
3282,73,723106,500,948675,957675,-9000
3281,68,722642,500,948681,955254,-6573
3281,68,722642,500,949175,958175,-9000
3282,73,723106,500,949181,955675,-6494
3282,73,723106,500,949675,958254,-8579
3281,68,722642,500,949681,955754,-6073
3281,68,722642,500,950175,962675,-12500
3282,73,723106,500,950181,958675,-8494
3282,73,723106,500,950675,956175,-5500
3282,73,723106,500,950681,956254,-5573
3283,56,723551,500,951175,956675,-5500
3283,56,723551,500,951181,962754,-11573
3284,59,723572,500,951675,956754,-5079
3282,73,723106,500,951681,958754,-7073
3282,73,723106,500,952175,959175,-7000
3284,59,723572,500,952181,965675,-13494
3284,59,723572,500,952675,959254,-6579
3284,59,723572,500,952681,959675,-6994
3282,73,723106,500,953175,957175,-4000
3282,73,723106,500,953181,959754,-6573
3284,59,723572,500,953675,963175,-9500
3283,56,723551,500,953681,957254,-3573
3282,73,723106,500,954175,957754,-3579
3282,73,723106,500,954181,960175,-5994
3283,56,723551,500,954675,965754,-11079
3284,59,723572,500,954681,960254,-5573
3283,56,723551,500,955175,966175,-11000
3283,56,723551,500,955181,966254,-11073
3283,56,723551,500,955675,967675,-12000
3282,73,723106,500,955681,960675,-4994
3282,73,723106,500,956175,963254,-7079
3282,73,723106,500,956181,963675,-7494
3283,56,723551,500,956675,960754,-4079
3282,73,723106,500,956681,963754,-7073
3283,56,723551,500,957175,966675,-9500
3284,59,723572,500,957181,961175,-3994
3282,73,723106,500,957675,961254,-3579
3283,56,723551,500,957681,966754,-9073
3283,56,723551,500,958175,964175,-6000
3284,59,723572,500,958181,961675,-3494
3282,73,723106,500,958675,961754,-3079
3284,59,723572,500,958681,964254,-5573
3283,56,723551,500,959175,962175,-3000
3283,56,723551,500,959181,962254,-3073
3283,56,723551,500,959675,964675,-5000
3284,59,723572,500,959681,964754,-5073
3284,59,723572,500,960175,968254,-8079
3284,59,723572,500,960181,965175,-4994
3284,59,723572,500,960675,967754,-7079
3284,59,723572,500,960681,967175,-6494
3283,56,723551,500,961175,968675,-7500
3283,56,723551,500,961181,965254,-4073
3283,56,723551,500,961675,967254,-5579
3283,56,723551,500,961681,970675,-8994
3284,59,723572,500,962175,968754,-6579
3285,46,724520,500,962181,970754,-8573
3285,46,724520,500,962675,968175,-5500
3285,46,724520,500,962681,971175,-8494
3285,46,724520,500,963175,971254,-8079
3285,46,724520,500,963181,969175,-5994
3285,46,724520,500,963675,971675,-8000
3285,46,724520,500,963681,971754,-8073
3285,46,724520,500,964175,972175,-8000
3285,46,724520,500,964181,974675,-10494
3285,46,724520,500,964675,969254,-4579
3286,77,725030,500,964681,969675,-4994
3285,46,724520,500,965175,976254,-11079
3286,77,725030,500,965181,976675,-11494
3286,77,725030,500,965675,969754,-4079
3285,46,724520,500,965681,972254,-6573
3286,77,725030,500,966175,974754,-8579
3285,46,724520,500,966181,970175,-3994
3285,46,724520,500,966675,976754,-10079
3286,77,725030,18000,966681,972675,-5994
3285,46,724520,81000,967175,972754,-5579
3285,46,724520,67000,967181,973175,-5994
3286,77,725030,18000,967675,975175,-7500
3286,77,725030,39000,967681,977175,-9494
3287,37,725191,95000,968175,977254,-9079
3287,37,725191,32000,968181,975254,-7073
3285,46,724520,109000,968675,970254,-1579
3287,37,725191,123000,968681,977675,-8994
3287,37,725191,88000,969175,977754,-8579
3288,17,725300,39000,969181,978175,-8994
3286,77,725030,67000,969675,978254,-8579
3285,46,724520,81000,969681,973254,-3573
3286,77,725030,49500,970175,978675,-8500
3286,77,725030,84500,970181,973675,-3494
3287,37,725191,112500,970675,978754,-8079
3286,77,725030,11000,970681,973754,-3073
3286,77,725030,42500,971175,975675,-4500
3286,77,725030,119500,971181,979754,-8573
3286,77,725030,18000,971675,975754,-4079
3286,77,725030,91500,971681,974175,-2494
3286,77,725030,67000,972175,974254,-2079
3286,77,725030,77500,972181,980175,-7994
3288,17,725300,63500,972675,980254,-7579
3287,37,725191,53000,972681,982254,-9573
3289,44,725488,63500,973175,979175,-6000
3286,77,725030,111500,979681,980675,-994
3287,37,725191,49000,982675,976175,6500
3289,44,725488,23500,983181,980754,2427
3290,19,725574,63500,987681,979254,8427
3290,19,725574,39500,990675,979675,11000
3291,69,726025,96000,999681,981175,18506
3292,70,726098,84000,999181,981254,17927
3293,47,726154,36000,999675,981675,18000
3294,31,726504,16000,998675,981754,16921
3395,17,751992,500,926665,982175,-55510
3395,17,751992,500,926666,982754,-56088
3394,79,751932,500,927165,983175,-56010
3398,94,752217,500,927166,984754,-57588
3392,60,751835,500,927665,982675,-55010
3396,66,752002,500,927666,983254,-55588
3396,66,752002,500,928165,983675,-55510
3398,94,752217,500,928166,983754,-55588
3394,79,751932,500,928665,985175,-56510
3396,66,752002,500,928666,987675,-59009
3394,79,751932,500,929165,986754,-57589
3396,66,752002,500,929166,984175,-55009
3397,95,752189,500,929665,985254,-55589
3398,94,752217,500,929666,984254,-54588
3392,60,751835,500,930165,985675,-55510
3396,66,752002,500,930166,985754,-55588
3392,60,751835,500,930665,984675,-54010
3396,66,752002,500,930666,986175,-55509
3396,66,752002,500,931165,986254,-55089
3399,65,752691,500,931166,986675,-55509
3396,66,752002,500,931665,987754,-56089
3400,73,752714,500,931666,987175,-55509
3402,80,752854,500,932165,990754,-58589
3402,80,752854,500,932166,987254,-55088
3399,65,752691,500,932665,992254,-59589
3397,95,752189,500,932666,988675,-56009
3400,73,752714,500,933165,992675,-59510
3400,73,752714,500,933166,988175,-55009
3397,95,752189,500,933665,991175,-57510
3398,94,752217,500,933666,988754,-55088
3402,80,752854,500,934165,992754,-58589
3402,80,752854,500,934166,991254,-57088
3399,65,752691,500,934665,989254,-54589
3402,80,752854,500,934666,991675,-57009
3399,65,752691,500,935165,988254,-53089
3403,42,752984,500,935166,993175,-58009
3404,28,753294,500,935665,996175,-60510
3404,28,753294,500,935666,989675,-54009
3400,73,752714,500,936165,993254,-57089
3403,42,752984,500,936166,996254,-60088
3403,42,752984,500,936665,993675,-57010
3400,73,752714,500,936666,993754,-57088
3403,42,752984,500,937165,996675,-59510
3405,27,753375,500,937166,991754,-54588
3407,92,753412,500,937665,996754,-59089
3399,65,752691,500,937666,994175,-56509
3402,80,752854,500,938165,994254,-56089
3402,80,752854,500,938166,989754,-51588
3400,73,752714,500,938665,997175,-58510
3407,92,753412,500,938666,994675,-56009
3409,51,753538,500,939165,990175,-51010
3400,73,752714,500,939166,989175,-50009
3407,92,753412,500,939665,994754,-55089
3401,18,752814,500,939666,990254,-50588
3408,68,753456,500,940165,990675,-50510
3406,27,753399,500,940166,995175,-55009
3403,42,752984,500,940665,997254,-56589
3410,98,753717,500,940666,995254,-54588
3409,51,753538,500,941165,992175,-51010
3408,68,753456,500,941166,997675,-56509
3407,92,753412,500,941665,997754,-56089
3410,98,753717,500,941666,998175,-56509
3404,28,753294,500,942165,995675,-53510
3408,68,753456,500,942166,995754,-53588
3408,68,753456,500,942665,999175,-56510
3404,28,753294,500,942666,999254,-56588
3407,92,753412,500,943165,999675,-56510
3409,51,753538,500,943166,999754,-56588
3407,92,753412,500,943665,998254,-54589
3409,51,753538,500,943666,998675,-55009
3407,92,753412,500,944165,998754,-54589
3407,92,753412,500,944166,972065,-27899
3410,98,753717,500,944665,973065,-28400
3408,68,753456,500,944666,975065,-30399
3407,92,753412,500,945165,975065,-29900
3410,98,753717,500,945166,975565,-30399
3406,27,753399,500,945665,975565,-29900
3405,27,753375,500,945666,904896,40770
3409,51,753538,500,946165,973065,-26900
3412,52,754248,500,946166,976065,-29899
3412,52,754248,500,946665,972565,-25900
3409,51,753538,500,946666,976065,-29399
3410,98,753717,500,947165,977565,-30400
3413,51,754392,500,947166,973565,-26399
3410,98,753717,500,947665,977565,-29900
3413,51,754392,500,947666,973565,-25899
3413,51,754392,500,948165,976565,-28400
3414,46,754491,500,948166,972565,-24399
3412,52,754248,500,948665,974065,-25400
3414,46,754491,500,948666,976565,-27899
3410,98,753717,500,949165,974065,-24900
3410,98,753717,500,949166,974565,-25399
3414,46,754491,500,949665,977065,-27400
3414,46,754491,500,949666,980065,-30399
3413,51,754392,500,950165,978065,-27900
3411,47,754111,500,950166,977065,-26899
3415,99,754493,500,950665,980565,-29900
3413,51,754392,11000,950666,980565,-29899
3411,47,754111,500,951165,908666,42499
3412,52,754248,11000,951166,981065,-29899
3415,99,754493,7500,951665,974565,-22900
3419,32,754872,28500,951666,985565,-33899
3411,47,754111,11000,952165,981065,-28900
3420,67,754922,14500,952166,908906,43260
3411,47,754111,18000,952665,985565,-32900
3419,32,754872,25000,952666,978065,-25399
3415,99,754493,4000,953165,910016,43149
3420,67,754922,25000,953166,981565,-28399
3414,46,754491,18000,953665,981565,-27900
3420,67,754922,14500,953666,982065,-28399
3415,99,754493,7500,954165,982065,-27900
3418,30,754857,7500,954166,982565,-28399
3413,51,754392,32000,954665,978565,-23900
3420,67,754922,18000,954666,982565,-27899
3414,46,754491,21500,955165,978565,-23400
3416,32,754823,28500,955166,979065,-23899
3413,51,754392,14500,955665,910013,45652
3420,67,754922,14500,955666,979065,-23399
3416,32,754823,25000,956165,979565,-23400
3420,67,754922,25500,957666,983065,-25399
3415,99,754493,34000,958165,983065,-24900
3418,30,754857,23500,962666,983565,-20899
3420,67,754922,16500,963166,979565,-16399
3420,67,754922,11500,961166,983565,-22399
3422,26,755214,23500,964165,984065,-19900
3420,67,754922,52000,964666,984065,-19399
3422,26,755214,4500,962166,984565,-22399
3424,28,755718,19500,965666,984565,-18899
3424,28,755718,4500,966165,980065,-13900
3425,52,755790,27500,971165,985065,-13900
3426,61,756022,16000,970665,985065,-14400
3426,61,756022,39500,975165,986065,-10900
3427,62,756058,28000,973165,914166,58999
3428,26,756409,20000,976666,987065,-10399
3430,60,756447,16500,978166,910396,67770
3430,60,756447,43500,979665,987065,-7400
3431,79,756959,48000,985166,986065,-899
3432,41,757003,44000,984666,986565,-1899
3433,72,757217,52000,987166,987565,-399
3434,37,757331,20000,987165,987565,-400
3435,31,757942,24000,989165,989565,-400
3436,25,758500,28000,996165,988065,8100
3438,77,758645,36500,999666,990065,9601
3438,77,758645,47500,996166,990565,5601
3439,46,758667,32000,999665,988065,11600
3440,30,759340,12000,998166,988565,9601
3442,57,759358,4500,999165,986565,12600
3442,57,759358,15500,998666,988565,10101
3696,78,818359,500,926741,989065,-62324
3696,78,818359,500,926767,990565,-63798
3698,44,818557,500,927241,994565,-67324
3695,36,818349,500,927267,994565,-67298
3698,44,818557,500,927741,995065,-67324
3695,36,818349,500,927767,989065,-61298
3695,36,818349,500,928241,991065,-62824
3697,63,818540,500,928267,995065,-66798
3697,63,818540,500,928741,991065,-62324
3697,63,818540,500,928767,995565,-66798
3698,44,818557,500,929241,989565,-60324
3699,24,819323,500,929267,991565,-62298
3699,24,819323,500,929741,991565,-61824
3699,24,819323,500,929767,996565,-66798
3700,42,819683,500,930241,992065,-61824
3700,42,819683,500,930267,992065,-61798
3702,89,820435,500,930741,995565,-64824
3702,89,820435,500,930767,992565,-61798
3700,42,819683,500,931241,996065,-64824
3702,89,820435,500,931267,996565,-65298
3702,89,820435,500,931741,997065,-65324
3702,89,820435,500,931767,992565,-60798
3701,20,819989,500,932241,990065,-57824
3702,89,820435,500,932267,915516,16751
3702,89,820435,500,932741,997065,-64324
3702,89,820435,500,932767,993065,-60298
3702,89,820435,500,933241,914406,18835
3703,20,821108,500,933267,993065,-59798
3702,89,820435,500,933741,996065,-62324
3702,89,820435,500,933767,993565,-59798
3704,49,821269,500,934241,993565,-59324
3705,99,821722,500,934267,994065,-59798
3704,49,821269,500,934741,997565,-62824
3705,99,821722,500,934767,997565,-62798
3706,82,821815,500,935241,994065,-58824
3705,99,821722,500,935267,998065,-62798
3707,16,821909,500,935741,998065,-62324
3706,82,821815,500,935767,915513,20254
3706,82,821815,500,936241,998565,-62324
3705,99,821722,500,936267,998565,-62298
3706,82,821815,500,936741,999065,-62324
3704,49,821269,500,936767,919666,17101
3705,99,821722,500,937241,921013,16228
3705,99,821722,500,937267,921016,16251
3705,99,821722,500,937741,915896,21845
3706,82,821815,500,937767,925166,12601
3706,82,821815,500,938241,999065,-60824
3706,82,821815,500,938267,999565,-61298
3705,99,821722,500,938741,999565,-60824
3706,82,821815,500,938767,919906,18861
3705,99,821722,500,939241,925406,13835
3705,99,821722,500,939267,921396,17871
3705,99,821722,500,939741,926513,13228
3706,82,821815,500,939767,926516,13251
3708,29,822063,500,940241,926896,13345
3709,19,822437,500,940267,930666,9601
3708,29,822063,500,940741,930906,9835
3710,62,822914,500,940767,932013,8754
3710,62,822914,500,941241,932016,9225
3710,62,822914,500,941267,932396,8871
3710,62,822914,500,941741,936166,5575
3710,62,822914,500,941767,936406,5361
3710,62,822914,500,942241,937516,4725
3712,70,823424,500,942267,937513,4754
3712,70,823424,500,942741,941666,1075
3711,68,823201,500,942767,941906,861
3711,68,823201,500,943241,937896,5345
3711,68,823201,500,943267,943013,254
3710,62,822914,500,943741,943016,725
3712,70,823424,500,943767,943396,371
3712,70,823424,500,944241,947166,-2925
3713,83,824014,500,944267,947406,-3139
3712,70,823424,500,944741,948516,-3775
3713,83,824014,500,944767,948513,-3746
3713,83,824014,500,945241,952666,-7425
3714,85,824106,500,945267,959513,-14246
3714,85,824106,500,945741,948896,-3155
3713,83,824014,500,945767,954396,-8629
3714,85,824106,500,946241,954013,-7772
3716,84,824461,500,946267,954016,-7749
3713,83,824014,500,946741,952906,-6165
3714,85,824106,500,946767,958166,-11399
3716,84,824461,500,947241,959896,-12655
3713,83,824014,500,947267,958406,-11139
3714,85,824106,500,947741,959516,-11775
3714,85,824106,500,947767,963666,-15899
3718,41,824545,500,948241,963906,-15665
3714,85,824106,500,948267,965396,-17129
3717,78,824507,500,948741,965013,-16272
3718,41,824545,500,948767,965016,-16249
3717,78,824507,500,949241,969166,-19925
3714,85,824106,500,949267,969406,-20139
3716,84,824461,500,949741,970513,-20772
3716,84,824461,500,949767,970516,-20749
3713,83,824014,500,950241,974906,-24665
3716,84,824461,500,950267,970896,-20629
3718,41,824545,500,950741,976013,-25272
3717,78,824507,500,950767,974666,-23899
3716,84,824461,500,951241,976396,-25155
3718,41,824545,500,951267,976016,-24749
3715,46,824412,500,951741,980166,-28425
3716,84,824461,500,951767,981896,-30129
3720,88,824927,500,952241,980406,-28165
3718,41,824545,500,952267,981513,-29246
3719,88,824846,500,952741,992513,-39772
3714,85,824106,500,952767,985906,-33139
3720,88,824927,500,953241,981516,-28275
3717,78,824507,500,953267,987016,-33749
3714,85,824106,500,953741,991166,-37425
3716,84,824461,500,953767,985666,-31899
3719,88,824846,500,954241,987396,-33155
3718,41,824545,500,954267,992516,-38249
3719,88,824846,500,954741,987013,-32272
3718,41,824545,500,954767,996666,-41899
3715,46,824412,500,955241,991406,-36165
3718,41,824545,500,955267,998013,-42746
3715,46,824412,500,955741,992896,-37155
3715,46,824412,500,955767,996906,-41139
3719,88,824846,500,956241,998016,-41775
3716,84,824461,500,956267,998396,-42129
3721,16,825136,500,956741,948754,7987
3716,84,824461,500,956767,948675,8092
3719,88,824846,500,957241,949175,8066
3716,84,824461,500,957267,949254,8013
3720,88,824927,500,957741,949675,8066
3717,78,824507,500,957767,949754,8013
3716,84,824461,500,958241,947675,10566
3720,88,824927,500,958267,950175,8092
3720,88,824927,500,958741,950254,8487
3719,88,824846,500,958767,947754,11013
3720,88,824927,500,959241,950675,8566
3721,16,825136,500,959267,950754,8513
3720,88,824927,500,959741,951175,8566
3719,88,824846,500,959767,951254,8513
3720,88,824927,500,960241,951675,8566
3719,88,824846,500,960267,948175,12092
3720,88,824927,500,960741,948254,12487
3720,88,824927,500,960767,951754,9013
3722,22,825765,500,961241,952175,9066
3722,22,825765,500,961267,952254,9013
3721,16,825136,500,961741,952675,9066
3724,31,826186,500,961767,953175,8592
3722,22,825765,500,962241,954175,8066
3724,31,826186,500,962267,952754,9513
3724,31,826186,500,962741,953254,9487
3725,59,826495,500,962767,953675,9092
3725,59,826495,500,963241,954254,8987
3723,17,826004,500,963267,954675,8592
3725,59,826495,500,963741,953754,9987
3724,31,826186,500,963767,954754,9013
3726,39,826573,500,964241,955175,9066
3726,39,826573,500,964267,957675,6592
3725,59,826495,500,964741,955254,9487
3726,39,826573,500,964767,958175,6592
3725,59,826495,500,965241,955675,9566
3728,48,826698,500,965267,958254,7013
3728,48,826698,500,965741,955754,9987
3726,39,826573,500,965767,962675,3092
3728,48,826698,500,966241,958675,7566
3728,48,826698,500,966267,956175,10092
3726,39,826573,500,966741,956254,10487
3727,59,826615,500,966767,956675,10092
3726,39,826573,500,967241,962754,4487
3724,31,826186,500,967267,956754,10513
3725,59,826495,500,967741,958754,8987
3724,31,826186,500,967767,959175,8592
3728,48,826698,500,968241,965675,2566
3726,39,826573,500,968267,959254,9013
3727,59,826615,500,968741,959675,9066
3725,59,826495,500,968767,957175,11592
3729,77,827014,500,969241,959754,9487
3725,59,826495,500,969267,963175,6092
3727,59,826615,500,969741,957254,12487
3726,39,826573,500,969767,957754,12013
3728,48,826698,500,970241,960175,10066
3726,39,826573,500,970267,965754,4513
3727,59,826615,500,970741,960254,10487
3725,59,826495,500,970767,966175,4592
3730,17,827273,500,971241,966254,4987
3725,59,826495,500,971267,967675,3592
3727,59,826615,500,971741,960675,11066
3728,48,826698,500,971767,963254,8513
3730,17,827273,500,972241,963675,8566
3726,39,826573,500,972267,960754,11513
3727,59,826615,500,972741,963754,8987
3729,77,827014,500,972767,966675,6092
3729,77,827014,500,973241,961175,12066
3729,77,827014,500,973267,961254,12013
3732,39,827409,500,973741,966754,6987
3733,89,827560,500,973767,964175,9592
3733,89,827560,500,974241,961675,12566
3730,17,827273,500,974267,961754,12513
3733,89,827560,500,974741,964254,10487
3729,77,827014,500,974767,962175,12592
3733,89,827560,500,975241,962254,12987
3732,39,827409,500,975267,964675,10592
3730,17,827273,500,975741,964754,10987
3731,40,827313,500,975767,968254,7513
3733,89,827560,500,976241,965175,11066
3731,40,827313,500,976267,967754,8513
3736,44,827904,500,976741,967175,9566
3733,89,827560,500,976767,968675,8092
3732,39,827409,500,977241,965254,11987
3733,89,827560,500,977267,967254,10013
3734,28,827810,500,977741,970675,7066
3738,82,828343,500,977767,968754,9013
3738,82,828343,500,978241,970754,7487
3736,44,827904,500,978267,968175,10092
3738,82,828343,500,978741,971175,7566
3734,28,827810,500,978767,971254,7513
3738,82,828343,500,979241,969175,10066
3738,82,828343,500,979267,971675,7592
3737,17,828252,500,979741,971754,7987
3738,82,828343,500,979767,972175,7592
3738,82,828343,500,980241,974675,5566
3741,43,828781,500,980267,969254,11013
3740,11,828774,500,980741,969675,11066
3741,43,828781,500,980767,976254,4513
3738,82,828343,500,981241,976675,4566
3741,43,828781,500,981267,969754,11513
3742,82,829027,500,981741,972254,9487
3743,91,829054,500,981767,974754,7013
3742,82,829027,500,982241,970175,12066
3746,89,829254,500,982267,976754,5513
3746,89,829254,500,982741,972675,10066
3746,89,829254,500,982767,972754,10013
3743,91,829054,500,983241,973175,10066
3742,82,829027,500,983267,975175,8092
3741,43,828781,500,983741,977175,6566
3746,89,829254,500,983767,977254,6513
3746,89,829254,500,984241,975254,8987
3745,66,829165,500,984267,970254,14013
3742,82,829027,500,984741,977675,7066
3745,66,829165,500,984767,977754,7013
3743,91,829054,500,985241,978175,7066
3741,43,828781,500,985267,978254,7013
3745,66,829165,500,985741,973254,12487
3745,66,829165,500,985767,978675,7092
3742,82,829027,500,986241,973675,12566
3741,43,828781,500,986267,978754,7513
3746,89,829254,500,986741,973754,12987
3748,66,829612,500,986767,975675,11092
3747,14,829507,500,987241,979754,7487
3743,91,829054,500,987267,975754,11513
3743,91,829054,500,987741,974175,13566
3745,66,829165,500,987767,974254,13513
3749,92,829687,500,988241,980175,8066
3743,91,829054,500,988267,980254,8013
3748,66,829612,500,988741,982254,6487
3743,91,829054,500,988767,979175,9592
3749,92,829687,500,989241,980675,8566
3748,66,829612,500,989267,976175,13092
3742,82,829027,11000,989741,980754,8987
3742,82,829027,7500,989767,979254,10513
3743,91,829054,11000,990241,979675,10566
3743,91,829054,11000,990267,981175,9092
3748,66,829612,11000,990741,981254,9487
3746,89,829254,11000,990767,981675,9092
3748,66,829612,4000,991241,981754,9487
3743,91,829054,39000,991267,982175,9092
3748,66,829612,4000,991741,982754,8987
3748,66,829612,11000,991767,983175,8592
3745,66,829165,39000,992241,984754,7487
3746,89,829254,32000,992267,982675,9592
3749,92,829687,4000,992741,983254,9487
3750,83,829976,7500,992767,983675,9092
3750,83,829976,4000,993241,983754,9487
3749,92,829687,25000,993267,985175,8092
3749,92,829687,11000,993741,987675,6066
3749,92,829687,18000,993767,986754,7013
3749,92,829687,25000,994241,984175,10066
3749,92,829687,35500,994267,985254,9013
3748,66,829612,14500,994741,984254,10487
3753,73,830337,42500,994767,985675,9092
3752,26,830331,18000,995241,985754,9487
3750,83,829976,28500,995267,984675,10592
3749,92,829687,28500,995741,986175,9566
3750,83,829976,35500,995767,986254,9513
3749,92,829687,11000,996241,986675,9566
3749,92,829687,11000,996267,987754,8513
3753,73,830337,4000,996741,987175,9566
3749,92,829687,21500,996767,990754,6013
3750,83,829976,35500,997241,987254,9987
3749,92,829687,35500,997267,992254,5013
3750,83,829976,21500,997741,988675,9066
3751,39,830088,25000,997767,992675,5092
3754,26,830468,18000,998241,988175,10066
3750,83,829976,14500,998267,991175,7092
3751,39,830088,7500,998741,988754,9987
3754,26,830468,11000,998767,992754,6013
3750,83,829976,25000,999241,991254,7987
3751,39,830088,7500,999267,989254,10013
3750,83,829976,500,999741,991675,8066
3750,83,829976,7500,999767,988254,11513
3738,82,828343,4000,979741,993175,-13434
3738,82,828343,27500,981241,996175,-14934
3741,43,828781,500,980267,989675,-9408
3740,11,828774,3500,980741,993254,-12513
3741,43,828781,20500,986267,996254,-9987
3742,82,829027,24500,989767,993675,-3908
3743,91,829054,35000,991267,993754,-2487
3746,89,829254,500,982267,996675,-14408
3746,89,829254,21500,992241,991754,487
3746,89,829254,27000,992267,996754,-4487
3748,66,829612,4000,987241,994175,-6934
3749,92,829687,28000,994741,994254,487
3749,92,829687,45000,997267,989754,7513
3750,83,829976,35000,999767,997175,2592
3753,73,830337,11000,999267,994675,4592
3752,26,830331,3500,995241,990175,5066
3753,73,830337,6500,996741,989175,7566
3754,26,830468,7000,998767,994754,4013
