job_id,tasks_num_of_single_job,task_generation_time,total_time,complation_time,complation_time_ordered,shortened_completion_time
0,89,2,23800,1189,1384,195
1,85,95,22250,1441,1279,-162
2,84,895,22200,4843,3273,-1570
3,84,905,19050,4989,3729,-1260
4,80,1003,20200,5100,4153,-947
6,87,1052,27050,4856,4671,-185
6,87,1052,24550,5272,4310,-962
8,87,1422,26100,5154,4401,-753
8,87,1422,24550,4848,4848,0
9,89,1809,26500,4997,4824,-173
10,83,2094,22600,5665,4837,-828
11,87,2207,26400,5997,5115,-882
12,81,3378,24300,5615,5863,248
13,86,4155,22300,6439,5938,-501
14,85,4290,25850,7009,6173,-836
15,81,4731,20700,7574,6708,-866
16,89,4778,26500,7482,7569,87
17,84,4952,20400,7509,8374,865
18,84,5235,23550,7649,7746,97
19,84,5679,23100,7794,7796,2
20,88,6357,24650,11364,7923,-3441
21,82,6377,23900,11473,9155,-2318
24,89,6641,23050,10969,9705,-1264
24,89,6641,25250,11091,11205,114
24,89,6641,25950,10864,11416,552
25,86,7386,26350,10475,9782,-693
26,86,7396,20950,10800,10899,99
27,87,7839,25050,11556,11453,-103
28,84,8229,25350,12851,11146,-1705
29,85,8533,24050,12586,11834,-752
30,84,8716,23100,12159,12289,130
32,87,9313,22150,13796,12245,-1551
32,87,9313,23650,13929,12799,-1130
33,89,9555,21550,13309,12535,-774
36,85,10635,22050,13921,13460,-461
38,87,11141,25250,15219,13920,-1299
38,87,11141,24050,15869,14100,-1769
38,87,11141,24350,15993,14639,-1354
38,87,11141,23100,15294,15090,-204
39,89,11542,22450,15369,15522,153
40,89,11891,23800,16062,15571,-491
41,85,11983,21800,16048,16007,-41
42,80,12521,24250,16371,15940,-431
44,83,14371,26950,17276,16181,-1095
44,83,14371,20300,17259,17181,-78
45,81,14624,22050,17929,17268,-661
46,90,14649,19350,17870,17526,-344
47,83,15500,21700,18206,17162,-1044
48,87,15640,17850,18753,17252,-1501
49,84,15840,23100,18766,17877,-889
50,81,15870,24750,18550,18520,-30
51,87,16654,26400,19974,18696,-1278
52,87,16835,26400,19641,19294,-347
53,82,17071,23000,20276,20024,-252
54,87,17190,21450,20428,19990,-438
56,89,17637,24150,21725,20222,-1503
56,89,17637,27800,21693,21759,66
57,80,17924,23350,21258,22418,1160
58,89,18197,21550,22308,22471,163
60,88,18591,27000,25210,22973,-2237
61,80,18608,30050,25206,22948,-2258
61,80,18608,23750,24631,22958,-1673
62,80,18998,22450,23881,23713,-168
63,83,19650,19450,24053,23877,-176
64,86,19862,22300,25329,22756,-2573
66,87,20090,27250,25829,25124,-705
66,87,20090,24100,26380,25572,-808
67,87,20475,21000,25290,25958,668
68,89,20506,26500,25622,26130,508
69,83,21040,23500,25556,27427,1871
70,89,21633,24250,25581,27514,1933
71,88,21757,25100,26377,26872,495
72,80,22125,23350,27261,27207,-54
73,84,22598,23100,27475,26265,-1210
74,83,23188,23500,29029,26637,-2392
75,85,23322,18200,29361,26227,-3134
76,80,23735,21100,29368,26966,-2402
77,84,24369,22650,28422,27107,-1315
78,83,24427,22600,29285,27439,-1846
79,89,24669,22000,29162,28878,-284
80,87,25221,24600,28949,28793,-156
92,82,28523,19850,28929,29050,121
92,82,28523,24750,31257,29510,-1747
92,82,28523,24600,31635,29484,-2151
92,82,28523,22700,31834,30050,-1784
92,82,28523,26150,31335,30767,-568
92,82,28523,22500,31619,30619,-1000
92,82,28523,23200,32199,31218,-981
92,82,28523,22050,33546,32051,-1495
92,82,28523,20450,34047,31926,-2121
92,82,28523,23350,34021,32292,-1729
92,82,28523,23000,34099,31970,-2129
92,82,28523,19750,32322,33357,1035
93,87,29483,22800,32577,33533,956
94,88,29639,19700,32320,33189,869
95,90,30358,24300,33464,33659,195
96,84,30620,21300,34614,34159,-455
97,89,30754,24250,34608,33644,-964
98,80,31034,20650,35189,34317,-872
99,81,31259,23400,35796,34591,-1205
101,88,32723,22250,35688,34477,-1211
101,88,32723,24600,35866,34821,-1045
103,84,33025,21700,36584,35535,-1049
108,85,35014,24900,36552,35991,-561
108,85,35014,24500,36674,36651,-23
107,80,35010,21600,36813,36491,-322
108,85,35014,23350,36444,36512,68
107,80,35010,20150,37833,36720,-1113
108,85,35014,25250,38064,37339,-725
109,83,35413,22600,38779,37487,-1292
110,84,35506,21750,38711,37825,-886
111,88,35952,23300,38843,37983,-860
112,83,36273,19000,39977,38275,-1702
118,82,39091,23100,40042,38840,-1202
118,82,39091,21600,39784,39418,-366
118,82,39091,22350,39834,39481,-353
118,82,39091,25250,39965,39352,-613
118,82,39091,22100,40136,39627,-509
118,82,39091,20500,40894,40241,-653
119,84,39239,23550,40818,40517,-301
120,90,40276,27900,41402,41268,-134
121,83,40600,23050,41621,41819,198
122,83,40922,25300,42549,42275,-274
123,82,41016,23450,42532,42647,115
124,81,41483,23400,43967,42819,-1148
125,87,41572,22800,44011,43486,-525
127,85,41943,24050,43967,43986,19
128,90,42007,25400,45328,44016,-1312
128,90,42007,25150,45750,44722,-1028
129,82,42357,22550,46087,45725,-362
130,83,42624,22150,45809,45955,146
131,85,42978,21800,46508,46064,-444
136,90,45183,23000,46620,46093,-527
136,90,45183,25950,46072,46791,719
136,90,45183,23700,46051,46968,917
136,90,45183,24350,46667,46636,-31
136,90,45183,19600,47149,46780,-369
138,81,45602,24500,47722,47720,-2
138,81,45602,21100,47949,47902,-47
139,82,45954,23000,48434,48071,-363
140,90,46274,27000,48670,48338,-332
141,88,46541,25550,48782,48971,189
143,84,47582,20850,49273,49523,250
143,84,47582,27100,50583,49686,-897
145,87,47620,20650,50683,49973,-710
145,87,47620,25000,50612,50527,-85
146,82,48223,21650,51482,50756,-726
147,85,48446,20900,51162,50786,-376
154,84,50029,17550,52768,50678,-2090
154,84,50029,24900,52818,51386,-1432
154,84,50029,25300,52775,52237,-538
154,84,50029,24550,53228,52535,-693
154,84,50029,24000,53768,52997,-771
154,84,50029,21350,53760,53170,-590
154,84,50029,17400,53271,53476,205
155,83,51199,21250,53573,53022,-551
156,87,51237,26400,53310,53582,272
157,83,52149,22150,53461,53491,30
158,82,53195,18500,54207,54186,-21
159,86,53429,21400,55959,54665,-1294
161,83,53607,24000,56685,56653,-32
161,83,53607,24350,56480,57841,1361
163,81,53732,26850,56841,57303,462
163,81,53732,22000,57138,56691,-447
164,80,53805,23350,57070,57695,625
165,85,56164,24050,57182,57368,186
166,87,56594,25500,58125,58114,-11
167,89,56803,23350,59903,58658,-1245
168,88,56855,24650,60423,59622,-801
169,83,56918,22150,60903,60040,-863
170,88,57006,24200,60809,60550,-259
171,86,57071,23650,60867,60473,-394
172,85,57924,29000,59702,60345,643
173,89,58240,22450,61362,60648,-714
174,84,58336,25350,61652,61557,-95
175,87,58673,22350,61862,61799,-63
176,89,59265,28300,61573,62368,795
177,83,59497,26200,62944,62325,-619
178,88,59673,20150,63100,63028,-72
179,86,60112,23200,64351,62963,-1388
180,88,60135,24650,64275,63716,-559
181,82,60378,17150,64162,65329,1167
183,83,60616,23650,64403,65466,1063
183,83,60616,21650,64574,65829,1255
184,87,61014,21000,64874,66016,1142
187,89,61632,19850,65087,66123,1036
187,89,61632,23750,65295,66127,832
188,89,62816,21950,65355,65693,338
188,89,62816,24650,65698,65227,-471
189,84,63448,24450,66209,65528,-681
190,80,63584,23350,66226,66892,666
191,90,63776,24750,68405,67072,-1333
192,82,64050,23000,68199,68619,420
193,81,64062,22950,69675,67856,-1819
194,88,64119,26450,69716,68607,-1109
195,84,64248,25800,69653,69483,-170
196,87,64695,25500,69974,69406,-568
197,84,65006,24000,70568,69395,-1173
198,82,65394,23900,70310,69781,-529
200,83,65816,22050,69908,70281,373
201,86,66056,21700,70087,70905,818
201,86,66056,28100,71000,72481,1481
202,86,66302,24550,72810,72473,-337
203,84,66523,23550,76111,73346,-2765
204,82,66544,21200,76160,72525,-3635
206,81,66608,28850,77111,74968,-2143
206,81,66608,22900,77611,75931,-1680
207,88,67100,25550,78210,77409,-801
208,88,67108,26450,77710,73978,-3732
209,81,67364,20250,77556,76258,-1298
210,87,67380,24600,77056,78183,1127
211,82,67569,22100,78056,79070,1014
212,86,67773,22750,76574,77708,1134
213,81,68018,24300,77098,77909,811
214,80,68022,26050,77637,78951,1314
215,84,68471,24450,78698,79451,753
216,89,68999,21100,80399,78458,-1941
217,90,69041,25650,79849,78628,-1221
219,84,69190,24050,80199,79128,-1071
219,84,69190,23500,80437,78488,-1949
220,88,70077,23300,81249,76395,-4854
221,83,70301,23500,81350,76301,-5049
222,82,70579,22550,80251,77977,-2274
223,89,70672,22000,80798,77296,-3502
224,85,71513,24050,80601,77570,-3031
227,85,73448,25650,80797,78477,-2320
227,85,73448,25100,80403,79336,-1067
227,85,73448,24400,80449,81113,664
231,87,74973,24350,83822,80773,-3049
230,85,74857,24950,83966,80076,-3890
248,86,80081,24500,86558,81997,-4561
248,86,80081,20100,86279,82405,-3874
248,86,80081,23450,86329,81964,-4365
255,85,80701,26000,82230,83084,854
251,90,80317,23000,83230,81401,-1829
250,89,80313,26150,85072,83096,-1976
253,86,80552,25100,84874,84260,-614
252,89,80426,19350,84951,85360,409
252,89,80426,26750,86068,85918,-150
253,86,80552,28250,86976,87418,442
254,82,80593,18450,87076,87486,410
254,82,80593,31900,87377,88234,857
252,89,80426,21200,86909,88443,1534
254,82,80593,22500,88840,88723,-117
253,86,80552,23900,89478,90186,708
253,86,80552,22600,89830,88155,-1675
255,85,80701,21950,89890,86875,-3015
253,86,80552,26050,88490,86810,-1680
253,86,80552,24000,88707,87110,-1597
255,85,80701,22850,89226,87425,-1801
252,89,80426,27400,93930,88110,-5820
254,82,80593,24300,93740,88828,-4912
254,82,80593,23650,95309,90559,-4750
255,85,80701,26100,95790,89478,-6312
255,85,80701,20100,95430,93066,-2364
255,85,80701,22000,95390,94762,-628
256,88,81085,26000,96942,94961,-1981
257,90,81536,22950,97383,91239,-6144
258,90,82274,23400,97682,91885,-5797
259,86,82396,26800,97666,92154,-5512
260,83,82419,19900,93399,92559,-840
261,83,82618,23500,94389,93439,-950
262,82,83669,23000,94122,93535,-587
263,88,84067,25100,95039,93162,-1877
264,80,84163,20200,94755,93855,-900
265,80,84281,24250,93254,94855,1601
266,86,84380,26800,93393,95756,2363
267,85,84661,23150,94704,95843,1139
268,82,85346,21200,96662,96855,193
269,88,85507,25550,97162,97022,-140
270,82,87159,23000,94854,97227,2373
272,82,87904,25650,95254,97522,2268
272,82,87904,21600,95063,97980,2917
273,84,88553,23550,97540,93572,-3968
274,87,88579,25050,97765,95030,-2735
275,85,88972,22250,96636,95530,-1106
277,86,89182,25150,97686,97030,-656
277,86,89182,23150,97136,97994,858
278,83,89633,22150,95756,98494,2738
279,80,90169,23350,96904,98572,1668
280,86,90329,20050,96665,98458,1793
281,90,91284,25200,98126,98911,785
282,82,91637,21650,99477,98378,-1099
283,86,91915,22750,100211,98994,-1217
284,86,92186,24100,100281,98822,-1459
285,83,92314,22150,100919,99872,-1047
286,90,92670,23400,100422,101407,985
290,88,93152,24250,101161,102742,1581
290,88,93152,24800,101806,100739,-1067
290,88,93152,21800,102145,103232,1087
291,82,93193,23200,102072,103931,1859
292,90,94423,20750,101968,101160,-808
294,89,96520,21150,102211,103832,1621
294,89,96520,27900,102481,104107,1626
294,89,96520,23250,101422,103510,2088
295,90,96900,24300,102345,104335,1990
296,88,97939,28700,101381,104060,2679
297,80,98390,20650,101931,101007,-924
298,89,98908,22900,103257,101673,-1584
299,82,98958,21200,104122,102959,-1163
300,80,99055,22000,104575,103059,-1516
301,85,99250,22700,104892,103881,-1011
302,80,99543,20650,104658,104214,-444
303,86,99974,24550,104607,104322,-285
304,87,101012,21000,104715,104223,-492
305,89,101194,24250,104429,104521,92
306,82,101726,23900,104929,104616,-313
307,80,102494,22450,104356,104532,176
309,83,103829,24100,104883,104712,-171
309,83,103829,22100,104948,104845,-103
310,81,104641,21150,105773,105746,-27
311,90,104762,21600,105973,105985,12
312,87,105378,22350,109587,107032,-2555
313,87,105417,26400,109476,107221,-2255
315,83,105585,24800,109922,107777,-2145
315,83,105585,25700,109777,109369,-408
316,81,105606,23850,109376,108706,-670
317,88,105733,24200,109517,109421,-96
318,81,105993,21600,109310,109967,657
319,83,106090,22600,109312,109986,674
320,85,106568,24950,109697,110040,343
325,88,108552,24100,111510,110272,-1238
325,88,108552,22500,111653,109895,-1758
325,88,108552,26100,112153,110772,-1381
325,88,108552,23000,112630,111129,-1501
325,88,108552,24000,111386,111886,500
326,84,108782,21750,111703,112181,478
327,84,108975,23550,111899,112632,733
328,82,109154,21650,112330,113185,855
329,85,109612,23600,113489,113185,-304
330,84,109808,24000,113800,113386,-414
331,84,110091,23550,115434,113751,-1683
332,88,110117,23750,115426,113936,-1490
333,86,110690,22300,113974,114245,271
334,81,111056,21600,114277,114818,541
335,83,111259,23050,115412,114651,-761
336,87,111447,25050,116062,115610,-452
337,89,111627,25150,116671,116373,-298
338,90,111785,23400,116682,118197,1515
339,89,112224,24700,117167,116732,-435
340,89,112578,28750,117681,117421,-260
341,86,113128,27250,118124,118023,-101
342,84,113546,27150,117762,118281,519
343,89,113877,26950,117335,118639,1304
344,88,114304,24650,117790,118048,258
345,81,114395,18450,117632,118279,647
346,83,114656,21250,120041,118587,-1454
347,85,115402,24500,120770,118556,-2214
348,80,116066,22900,119094,118737,-357
349,82,116438,21650,121294,119557,-1737
351,82,116525,23950,121734,120526,-1208
351,82,116525,20700,121844,120752,-1092
353,87,117077,18100,121847,121049,-798
354,83,117083,21000,121645,121388,-257
354,83,117083,20750,121982,122265,283
356,86,118734,20250,122179,121710,-469
359,83,120143,24100,122249,121293,-956
359,83,120143,23400,121002,121052,50
359,83,120143,22400,122053,122177,124
359,83,120143,22450,122215,122068,-147
360,90,120527,25200,122555,122325,-230
361,81,121433,24300,124124,122674,-1450
362,86,121512,20050,124340,123295,-1045
364,83,121746,23400,123994,123560,-434
364,83,121746,23900,124654,123960,-694
369,81,123300,23750,124451,124510,59
368,85,123098,24350,124996,124861,-135
369,81,123300,23750,124961,125358,397
368,85,123098,22650,125660,125282,-378
369,81,123300,19700,125342,125042,-300
370,89,124518,23800,125914,125534,-380
371,89,124718,23800,126084,125958,-126
372,82,125196,23450,126422,126204,-218
373,80,125698,23350,126698,126704,6
375,87,126995,22100,128731,128281,-450
375,87,126995,25000,128845,128781,-64
376,86,127121,27250,129275,129279,4
377,85,127992,24050,129432,129257,-175
378,86,128210,26800,130988,129851,-1137
379,90,128230,18900,130957,130025,-932
380,84,128483,23550,130926,130419,-507
382,88,128705,28200,131084,131519,435
383,87,129306,21950,131067,131479,412
383,87,129306,21850,131914,131487,-427
384,82,129525,24350,134387,131920,-2467
385,87,129544,23700,133976,133570,-406
386,81,129883,20250,133952,133645,-307
387,89,130304,20650,133502,133828,326
388,81,130350,22500,133637,133851,214
406,86,132519,23400,134155,134202,47
407,80,132625,25500,134722,134445,-277
408,87,132635,22000,139120,134967,-4153
408,87,132635,21250,139636,134351,-5285
410,87,133767,25700,139609,135537,-4072
409,85,133723,22150,141655,137292,-4363
410,87,133767,24400,141788,138542,-3246
409,85,133723,23850,141824,139203,-2621
409,85,133723,24000,139250,138159,-1091
409,85,133723,25150,139119,139768,649
409,85,133723,24350,140228,140142,-86
409,85,133723,23400,140980,141069,89
410,87,133767,27950,144612,142669,-1943
410,87,133767,26500,144880,144431,-449
410,87,133767,29750,145380,144985,-395
409,85,133723,25250,145880,144103,-1777
410,87,133767,21300,145464,145640,176
410,87,133767,22750,145894,145781,-113
409,85,133723,21550,147394,147905,511
410,87,133767,22300,146894,149439,2545
409,85,133723,21850,142561,149719,7158
410,87,133767,19700,143004,146281,3277
411,81,133962,20250,143061,145742,2681
412,89,134117,24250,143604,145775,2171
413,87,134128,25500,143561,146242,2681
414,80,134186,22900,141918,145825,3907
416,88,134678,24050,145754,146081,327
416,88,134678,22350,146202,146325,123
417,81,134884,23850,146182,146131,-51
418,90,135411,27450,146930,146181,-749
419,88,135642,23300,147747,146250,-1497
420,82,136096,27500,149747,146659,-3088
421,83,136166,22600,149802,147809,-1993
423,85,136630,17100,159075,148530,-10545
423,85,136630,20850,160115,149354,-10761
424,86,136735,25900,166715,150700,-16015
425,88,136854,24650,167865,151430,-16435
427,84,136938,19300,166875,151804,-15071
427,84,136938,24400,167915,149952,-17963
428,89,137044,17950,167315,151257,-16058
429,88,137150,25100,167875,152449,-15426
430,88,137241,23750,156527,152923,-3604
431,85,137289,24950,158077,152155,-5922
432,83,137397,23050,159127,154903,-4224
433,83,137829,21700,160099,156153,-3946
435,86,138196,25050,160627,155963,-4664
435,86,138196,29000,160792,158439,-2353
436,84,138279,20850,160199,160043,-156
437,88,138666,23300,158507,162413,3906
438,85,138683,23150,158837,163229,4392
439,82,138891,24800,161707,153395,-8312
440,83,139013,25300,162337,159970,-2367
441,80,139521,22000,164348,162545,-1803
442,84,139590,20850,164307,164384,77
443,82,139780,22100,163854,165984,2130
444,88,140059,26900,159049,166863,7814
445,90,140080,25200,159228,167081,7853
446,84,140369,22650,165307,157693,-7614
447,86,140512,23650,167006,158793,-8213
448,89,140554,25150,167957,159411,-8546
449,84,140671,23550,168798,157505,-11293
450,83,140911,22600,169757,158995,-10762
451,84,141389,25350,170898,160561,-10337
452,82,141691,24350,171487,161045,-10442
453,84,141978,20850,172041,161645,-10396
463,83,145517,22950,172487,161784,-10703
463,83,145517,24600,172448,162286,-10162
474,87,148557,24650,165824,162452,-3372
480,80,149659,25150,166824,163105,-3719
480,80,149659,24250,167024,164023,-3001
483,88,150230,21250,167424,164655,-2769
483,88,150230,22950,168224,163183,-5041
482,83,150118,23400,169977,164780,-5197
483,88,150230,25700,172527,165833,-6694
483,88,150230,21650,172715,166830,-5885
484,82,150634,21200,174212,167493,-6719
485,90,151623,25700,174600,168039,-6561
486,83,151714,23700,174448,169015,-5433
487,90,151944,25750,174087,168722,-5365
486,83,151714,24550,174111,171033,-3078
487,90,151944,28750,171924,171389,-535
487,90,151944,23950,173356,168530,-4826
488,90,152267,25800,173498,169545,-3953
489,86,152275,22350,173224,170145,-3079
489,86,152275,24800,173074,169889,-3185
490,87,152431,24150,173609,170531,-3078
490,87,152431,23100,174591,170195,-4396
490,87,152431,22000,176756,168883,-7873
492,88,153984,25700,177306,169580,-7726
491,90,153900,24350,177806,170033,-7773
492,88,153984,23250,178806,170533,-8273
491,90,153900,21500,178841,170236,-8605
491,90,153900,22100,181041,170396,-10645
495,89,154256,21250,180856,170697,-10159
494,83,154204,24500,181456,170889,-10567
495,89,154256,20300,182341,171015,-11326
496,85,154678,24300,183106,170164,-12942
498,90,154848,21650,183491,171543,-11948
496,85,154678,24650,171567,172131,564
497,86,154810,20250,174403,172631,-1772
499,85,154928,23600,174709,172776,-1933
499,85,154928,24050,176009,173681,-2328
499,85,154928,27350,182370,174564,-7806
501,90,155262,22350,182418,173523,-8895
501,90,155262,24650,183730,174237,-9493
501,90,155262,26200,185232,175737,-9495
502,87,155343,26900,185020,177323,-7697
502,87,155343,19950,185459,178483,-6976
500,82,155080,23650,174415,179300,4885
501,90,155262,27450,174965,180550,5585
502,87,155343,24850,176236,181733,5497
502,87,155343,20750,178370,182987,4617
502,87,155343,28200,179570,184537,4967
503,81,155688,20800,179691,185537,5846
506,87,156131,22950,182548,186033,3485
506,87,156131,24700,183870,184421,551
505,85,156005,23150,184741,185909,1168
506,87,156131,19100,185720,186897,1177
507,80,156336,23350,186615,188109,1494
508,83,156698,23500,187270,189193,1923
510,88,157228,24550,178952,190559,11607
510,88,157228,25050,180216,191871,11655
511,85,157353,20000,180132,193171,13039
512,87,157799,23700,177851,193809,15958
513,82,158003,20300,179162,188373,9211
514,86,158377,25000,182951,182531,-420
515,86,158814,24550,186712,183026,-3686
516,85,158989,22700,188051,179242,-8809
517,86,159377,23200,190601,181915,-8686
518,86,159918,20050,194312,184042,-10270
519,85,159990,22250,194351,186465,-7886
520,83,160198,19900,186820,189492,2672
521,83,160563,21700,187802,192242,4440
522,82,161039,23900,190032,196092,6060
523,87,161119,25950,190620,197515,6895
524,84,161131,24450,190332,186687,-3645
525,88,161310,26450,191102,186873,-4229
526,80,161750,21100,191720,186583,-5137
527,86,162234,24550,193370,186633,-6737
528,85,162258,22250,193420,186639,-6781
529,80,162374,21100,192820,187307,-5513
530,82,162783,24350,191456,189004,-2452
531,86,162957,23200,192309,190175,-2134
532,86,163965,21850,192809,191657,-1152
533,87,164441,25050,193920,192759,-1161
534,90,164777,27000,194106,194359,253
535,85,165005,21800,194359,195525,1166
536,86,165388,24100,193886,196125,2239
537,90,165800,26100,194841,197304,2463
538,81,166382,23400,195950,197989,2039
539,85,167049,18200,197550,198904,1354
540,90,167359,28800,197670,200009,2339
541,89,167419,25150,197691,200639,2948
542,81,167505,22950,198050,200657,2607
543,90,167820,27450,198024,197034,-990
544,80,168073,21100,194505,197445,2940
545,83,168536,21700,195565,197673,2108
546,89,168707,22900,197615,197945,330
547,84,169070,23550,199320,198297,-1023
548,89,169254,23350,199650,198521,-1129
549,86,169949,22750,200907,198609,-2298
550,83,170085,24850,202157,198402,-3755
551,89,170171,21100,202807,199502,-3305
552,89,170237,25150,203307,201052,-2255
553,89,170802,22000,204797,201125,-3672
554,85,170868,21350,204638,201157,-3481
555,85,171673,24500,198805,201189,2384
556,82,172020,26150,200200,201657,1457
557,88,172343,23750,200691,201689,998
558,85,172403,22250,200850,201695,845
559,86,174107,22300,201191,198245,-2946
560,83,174402,23050,199955,198694,-1261
561,85,174438,22700,200181,196053,-4128
562,80,174633,23800,200955,196718,-4237
563,88,174715,23750,200731,196806,-3925
564,90,175132,24300,201231,193819,-7412
565,84,177071,22650,200900,194459,-6441
566,86,177145,24550,200233,195559,-4674
567,86,177280,25450,201417,196310,-5107
568,83,177725,24850,201433,197159,-4274
569,83,178502,21700,203133,197752,-5381
570,82,178684,23450,204682,198560,-6122
571,87,178895,27300,205911,199657,-6254
572,83,179013,23500,206695,200610,-6085
573,86,179253,21850,207432,200807,-6625
574,90,179280,28350,207195,199358,-7837
575,90,179394,27000,207511,200458,-7053
576,89,179531,26500,202434,201558,-876
577,85,179855,27650,202674,202665,-9
579,81,180799,25250,202277,203968,1691
579,81,180799,24250,202322,204468,2146
580,88,181366,21500,203342,204753,1411
581,80,181527,22000,204392,204968,576
583,89,182308,23400,205492,206275,783
583,89,182308,26900,207932,207904,-28
584,82,182383,24350,208208,209975,1767
585,80,182616,25150,208708,211804,3096
586,89,182871,23800,209208,213504,4296
587,81,182925,19350,209032,214375,5343
589,82,183322,25500,209532,216335,6803
589,82,183322,22500,209745,217335,7590
590,84,183478,23550,209808,219085,9277
594,84,184086,22350,209178,204609,-4569
592,82,183837,19400,209678,206338,-3340
595,82,184281,19800,209892,207420,-2472
596,83,184506,24900,209892,208927,-965
596,83,184506,22100,210192,210884,692
597,86,184615,19850,210842,213029,2187
599,87,184866,26350,211892,216079,4187
598,85,184803,22250,211592,217729,6137
601,86,185101,22350,212092,219806,7714
600,80,185018,20200,211341,220346,9005
603,81,185256,21850,211841,222109,10268
606,80,185904,26200,211503,224427,12924
608,87,186128,22050,211962,226488,14526
607,84,185972,24150,214579,228527,13948
608,87,186128,26250,215429,230688,15259
608,87,186128,24250,218079,232084,14005
607,84,185972,19900,218660,233359,14699
608,87,186128,20400,219588,233520,13932
609,90,186600,23400,217362,209780,-7582
610,80,186952,23350,218827,213490,-5337
611,89,187292,22900,221327,215380,-5947
613,89,187656,20800,223504,217780,-5724
613,89,187656,20150,224277,220530,-3747
614,81,188073,21150,226653,221680,-4973
615,81,188098,23400,226977,223330,-3647
617,82,189124,22250,228455,224990,-3465
618,83,189378,25250,231253,226590,-4663
618,83,189378,21200,232204,228280,-3924
621,85,190386,22700,234405,229490,-4915
621,85,190386,21950,235453,231640,-3813
624,89,190945,25350,235477,234079,-1398
627,87,191116,18700,236526,234679,-1847
625,89,190960,27650,237231,235090,-2141
626,83,191010,18850,237233,235181,-2052
628,83,191180,27850,237510,218933,-18577
629,84,191437,26200,237890,219680,-18210
631,85,192396,23700,238133,220180,-17953
632,85,192552,20800,238392,220846,-17546
634,88,193318,21300,239269,220949,-18320
633,89,193234,22450,211995,222261,10266
634,88,193318,22700,214083,224311,10228
634,88,193318,21350,215190,226383,11193
634,88,193318,24250,220662,227533,6871
659,87,203450,22250,224431,229583,5152
660,83,203877,19100,228212,229833,1621
661,83,203997,24900,228843,231361,2518
661,83,203997,24350,236453,232561,-3892
660,83,203877,24300,236856,234183,-2673
661,83,203997,19200,236605,235161,-1444
660,83,203877,25750,237827,235393,-2434
662,82,204018,27950,237762,235731,-2031
661,83,203997,24200,231081,235959,4878
661,83,203997,22900,231531,235590,4059
661,83,203997,23900,231866,236132,4266
661,83,203997,27500,232916,235783,2867
660,83,203877,22750,232838,236285,3447
662,82,204018,24100,232631,235883,3252
662,82,204018,21400,232631,235986,3355
661,83,203997,23600,229177,236120,6943
662,82,204018,22250,231817,229450,-2367
660,83,203877,22550,233927,230450,-3477
662,82,204018,24250,238532,231303,-7229
662,82,204018,27900,239427,232050,-7377
660,83,203877,23450,239758,232838,-6920
661,83,203997,22150,242353,236261,-6092
660,83,203877,27100,242757,232516,-10241
661,83,203997,23000,242932,233581,-9351
660,83,203877,22850,243257,234616,-8641
662,82,204018,25500,242462,235593,-6869
660,83,203877,21300,244008,236199,-7809
662,82,204018,21250,244532,237193,-7339
662,82,204018,17650,244205,237685,-6520
663,90,204590,24300,244645,239066,-5579
664,80,205847,17500,247812,239385,-8427
665,81,205917,24750,247345,240035,-7310
666,86,206270,20950,247845,240766,-7079
667,80,206725,21100,241217,241085,-132
668,86,206861,20500,243417,241266,-2151
669,86,206957,20050,243567,242031,-1536
670,89,207136,24250,244077,242285,-1792
671,84,207175,21750,244577,242616,-1961
672,81,207566,24300,245532,243049,-2483
673,81,207705,19350,246458,228072,-18386
674,83,207875,22150,246577,228622,-17955
675,80,207906,25150,247332,229672,-17660
676,81,207919,18900,247157,230718,-16439
677,80,208079,22900,247657,232064,-15593
678,82,208098,23000,247657,232664,-14993
679,82,208627,22100,248207,234418,-13789
680,80,209145,23350,248332,234964,-13368
681,86,209307,26800,244317,235518,-8799
682,88,209761,27800,245317,237114,-8203
683,88,209910,22850,245867,238114,-7753
684,90,210080,28800,245932,238468,-7464
685,82,210228,23900,246631,238714,-7917
686,81,210620,21600,250431,240214,-10217
687,87,210642,25950,249874,241168,-8706
688,89,210795,24250,250242,241668,-8574
689,80,210950,23350,249485,242114,-7371
690,83,211355,23500,249765,242368,-7397
691,82,212420,20300,249327,242714,-6613
692,81,212852,20250,239860,243214,3354
693,80,213204,19300,249827,243318,-6509
694,88,213402,23300,249845,243418,-6427
695,83,213436,21250,250015,243914,-6101
696,80,213609,21100,248117,243718,-4399
697,85,214502,22250,248882,244418,-4464
698,89,214924,26500,250122,241807,-8315
699,84,215641,25350,252024,243026,-8998
700,82,215719,23900,252298,236307,-15991
701,86,215828,20950,252265,236814,-15451
702,83,216122,26200,253360,237962,-15398
703,85,216235,21350,254315,239492,-14823
704,88,216814,27800,236206,240592,4386
705,85,217149,24500,237135,242092,4957
706,86,217862,22300,238495,242864,4369
707,82,218012,20750,237664,243864,6200
708,82,218047,23450,237206,244964,7758
709,84,219253,22200,238416,245592,7176
710,83,220351,21700,243565,246162,2597
711,84,220405,23100,244315,247464,3149
712,88,220694,21500,248153,249014,861
713,82,220964,25250,251403,250412,-991
714,86,221458,22300,255953,251772,-4181
715,87,221672,28200,257365,253392,-3973
716,84,221925,21750,263485,254392,-9093
717,87,221974,23250,263974,255472,-8502
718,86,222007,23650,264085,256464,-7621
719,87,222104,22800,264474,256572,-7902
720,90,222690,26100,265784,256450,-9334
721,84,223522,28050,265948,257707,-8241
722,85,223720,23150,267548,258777,-8771
723,83,223775,23950,267735,260132,-7603
724,88,223980,24200,269053,261182,-7871
725,88,224225,23750,274895,261700,-13195
726,90,224339,25200,279207,262182,-17025
727,89,224421,26500,280301,263250,-17051
728,86,224485,20950,281314,264478,-16836
729,87,224818,23700,283569,266209,-17360
730,85,225081,22250,286119,268161,-17958
731,84,225199,23100,286964,269378,-17586
732,89,225581,26950,289969,271418,-18551
733,81,225687,21600,290214,273259,-16955
734,86,225739,22750,290001,274459,-15542
735,85,226125,25850,291519,274959,-16560
736,81,226255,19350,292069,259781,-32288
737,85,226609,19100,292851,262331,-30520
738,81,226840,22950,293337,263881,-29456
739,84,227235,22650,294757,265176,-29581
740,83,227288,21700,294369,266429,-27940
741,82,227847,20300,255102,267376,12274
742,87,228048,26400,255978,267175,11197
743,83,228279,23950,256478,269434,12956
745,87,229251,22650,256152,271625,15473
745,87,229251,20050,257631,273934,16303
746,89,229272,23800,257081,275734,18653
747,90,229505,23400,257984,277928,19944
748,85,229783,20450,258242,279125,20883
749,82,229832,20300,257624,278719,21095
750,89,230529,21100,258694,260238,1544
751,90,230654,21600,258624,260482,1858
752,85,231351,25400,259199,260571,1372
753,86,231414,25000,259735,262171,2436
754,80,231522,20200,260086,263321,3235
755,84,231985,24900,262214,263404,1190
756,82,232230,21650,263036,263750,714
757,86,232270,22750,263314,263897,583
758,88,233066,28250,258883,264209,5326
760,89,233260,22600,259433,264582,5149
760,89,233260,25100,259174,265732,6558
762,90,233603,23200,262445,265831,3386
762,90,233603,21550,263369,268043,4674
763,85,233664,25850,263364,269643,6279
764,86,234025,20500,264451,271704,7253
765,88,235106,21050,265501,274643,9142
768,87,236137,24600,266601,275193,8592
768,87,236137,27900,267601,275417,7816
768,87,236137,23150,267319,275509,8190
770,90,237473,24050,267986,275713,7727
770,90,237473,22900,268151,275378,7227
771,89,237593,25150,268319,275868,7549
772,89,237964,27400,269399,275428,6029
871,88,267827,23000,270505,259903,-10602
871,88,267827,24950,271256,275467,4211
872,87,267851,24700,272805,262805,-10000
873,89,268026,25150,272205,275967,3762
872,87,267851,24300,272407,275978,3571
871,88,267827,27750,272586,275609,3023
873,89,268026,23000,274044,275709,1665
872,87,267851,20750,274594,267892,-6702
872,87,267851,19350,276344,276209,-135
872,87,267851,22100,277494,276213,-1281
871,88,267827,26150,278544,276467,-2077
873,89,268026,25050,269199,276528,7329
873,89,268026,25150,269227,276759,7532
871,88,267827,26050,268798,277017,8219
873,89,268026,21300,270408,276728,6320
872,87,267851,26100,271317,277309,5992
872,87,267851,24350,271958,277313,5355
872,87,267851,21500,275708,277067,1359
873,89,268026,23850,279617,277667,-1950
873,89,268026,23300,281617,277409,-4208
871,88,267827,25550,281758,275904,-5854
873,89,268026,24750,277637,276243,-1394
871,88,267827,25650,277388,276954,-434
871,88,267827,26850,277888,277243,-645
872,87,267851,26300,278387,277454,-933
874,82,268144,22500,279719,273527,-6192
874,82,268144,26450,279637,277743,-1894
872,87,267851,21000,279751,278004,-1747
874,82,268144,21600,280014,277512,-2502
873,89,268026,24550,276505,277843,1338
873,89,268026,22550,278449,278343,-106
873,89,268026,22500,278158,278094,-64
874,82,268144,20650,279155,278832,-323
875,80,268346,22100,279655,279832,177
874,82,268144,27350,281205,281042,-163
874,82,268144,23350,281599,281905,306
873,89,268026,22250,283255,278513,-4742
875,80,268346,25900,283257,278692,-4565
875,80,268346,21600,283299,278567,-4732
874,82,268144,30150,283855,278623,-5232
875,80,268346,25050,284937,279217,-5720
875,80,268346,19800,285568,278618,-6950
875,80,268346,23150,287148,278961,-8187
875,80,268346,21600,287423,281621,-5802
876,86,268585,22500,280984,284293,3309
876,86,268585,21500,281971,285621,3650
876,86,268585,23450,282182,287293,5111
875,80,268346,22500,282834,277258,-5576
875,80,268346,25850,284494,279222,-5272
875,80,268346,28050,283994,279758,-4236
875,80,268346,24350,284571,281013,-3558
876,86,268585,21750,284434,282158,-2276
876,86,268585,25200,287578,283163,-4415
876,86,268585,26050,287786,284713,-3073
876,86,268585,24600,289486,286258,-3228
876,86,268585,25700,290498,287879,-2619
877,88,269498,17150,290237,287591,-2646
877,88,269498,25600,290686,284244,-6442
877,88,269498,23450,290579,285342,-5237
877,88,269498,25500,293178,286392,-6786
877,88,269498,26550,292627,287832,-4795
877,88,269498,25500,292678,288982,-3696
877,88,269498,23300,292679,290782,-1897
877,88,269498,25050,292717,291892,-825
877,88,269498,25900,292613,293594,981
877,88,269498,24700,285434,295094,9660
877,88,269498,26100,285915,297144,11229
877,88,269498,25550,290369,298593,8224
877,88,269498,20550,299700,299734,34
877,88,269498,20750,302020,301505,-515
877,88,269498,23950,305220,303055,-2165
877,88,269498,22250,305370,304843,-527
877,88,269498,22350,308420,306834,-1586
877,88,269498,22650,309400,308555,-845
877,88,269498,19700,311700,309570,-2130
877,88,269498,23600,311720,311193,-527
877,88,269498,24350,292700,312455,19755
877,88,269498,21600,293300,311144,17844
877,88,269498,24400,293823,311492,17669
877,88,269498,28150,294686,291081,-3605
877,88,269498,22700,295373,291893,-3480
877,88,269498,21750,295650,295693,43
877,88,269498,21300,296272,298093,1821
877,88,269498,19250,296473,300093,3620
877,88,269498,19450,296700,303093,6393
877,88,269498,23150,297837,307474,9637
877,88,269498,24500,298350,310774,12424
878,81,270331,25500,298786,315472,16686
878,81,270331,23050,299387,320222,20835
878,81,270331,21800,299572,324222,24650
878,81,270331,21800,299887,327093,27206
878,81,270331,18650,300323,327693,27370
878,81,270331,26550,302200,328673,26473
878,81,270331,19350,301986,292172,-9814
878,81,270331,26450,303023,293222,-9801
878,81,270331,25250,303136,293822,-9314
878,81,270331,22300,303250,294961,-8289
878,81,270331,22450,303523,295272,-8251
878,81,270331,22950,305289,297611,-7678
878,81,270331,18750,304727,298911,-5816
879,88,270548,21450,306827,300411,-6416
879,88,270548,20900,308039,301625,-6414
879,88,270548,13400,308477,303122,-5355
878,81,270331,21950,309867,305742,-4125
879,88,270548,14600,310627,307392,-3235
879,88,270548,18700,312189,309275,-2914
879,88,270548,23950,313963,310425,-3538
880,87,270753,25500,314977,312743,-2234
881,85,270804,23600,315463,313293,-2170
882,82,271069,23900,316463,314255,-2208
883,86,271150,23650,316663,315020,-1643
884,89,271695,22900,317113,315834,-1279
885,84,272122,25350,317613,316934,-679
886,89,272419,26050,310126,317584,7458
887,85,272506,21800,310348,318134,7786
888,83,272904,22150,307718,318605,10887
889,82,273072,25250,308706,319143,10437
890,85,273154,25850,308718,319770,11052
891,84,273505,24000,309485,320255,10770
892,90,274507,27450,311774,321049,9275
893,90,274517,22500,312424,321384,8960
894,86,274538,22300,312556,321855,9299
895,88,274772,26000,313285,322384,9099
896,85,275669,23600,313724,323034,9310
897,84,275958,22200,319668,323943,4275
898,82,276076,18050,321920,324555,2635
900,80,276155,22150,323368,325499,2131
900,80,276155,21050,324968,314775,-10193
901,86,276210,24100,325020,317425,-7595
902,85,276508,23150,326568,320142,-6426
903,90,276753,25200,319119,321625,2506
904,82,277523,18500,319406,323542,4136
905,90,277678,25200,316303,325592,9289
906,81,277721,22950,317120,328275,11155
907,85,278067,20000,318263,328749,10486
908,88,278271,22400,319089,329246,10157
909,85,278308,25850,319417,329405,9988
910,84,279256,19050,319527,329799,10272
911,88,279504,24200,319917,329876,9959
912,86,279930,23650,322073,330084,8011
913,82,279999,23450,321573,330505,8932
914,82,280300,24800,321653,330734,9081
915,85,280531,24500,323570,330926,7356
916,85,280669,24950,324203,331049,6846
917,89,281458,16600,324753,331284,6531
919,89,281544,24450,325943,331599,5656
919,89,281544,22400,325969,331926,5957
920,81,281552,21600,326069,331946,5877
921,82,281577,18500,327069,331699,4630
922,81,281773,25650,328768,328825,57
923,88,281817,22400,329219,328823,-396
924,88,281913,21500,328119,329324,1205
925,80,281987,23350,328218,330823,2605
926,87,283223,24150,328476,330924,2448
927,85,283673,23150,331076,331823,747
928,84,283988,24450,333376,332598,-778
929,90,283996,24750,333357,329825,-3532
930,80,284402,19750,334432,330142,-4290
931,82,285177,29750,336407,331642,-4765
932,85,285642,23150,337607,331525,-6082
933,85,286618,23600,337698,332286,-5412
934,80,286971,19300,333938,331851,-2087
935,86,287097,20500,334285,332351,-1934
936,88,287274,19250,335038,332426,-2612
937,84,287561,22650,337385,331996,-5389
938,80,287676,18850,337205,332046,-5159
939,83,287889,26200,339435,332096,-7339
940,81,288184,20700,341754,332075,-9679
941,87,288429,27300,344155,332125,-12030
943,88,288452,22850,343888,332675,-11213
943,88,288452,22350,344435,332192,-12243
944,82,288993,22550,345435,333401,-12034
945,83,289382,23500,347555,332175,-15380
946,80,289531,24700,349304,333426,-15878
947,89,289686,21100,349135,333248,-15887
948,85,289762,24050,349129,333486,-15643
950,81,290026,24600,343948,333536,-10412
951,86,290085,20700,344380,332692,-11688
951,86,290085,24050,344548,333708,-10840
952,83,290414,22600,345259,332727,-12532
953,89,290494,26050,346223,332823,-13400
954,86,290520,25900,345868,332926,-12942
955,80,290918,20200,335023,332777,-2246
956,84,290933,21300,335109,332648,-2461
957,90,290970,25200,336523,332698,-3825
958,82,291220,23000,340023,332708,-7315
959,83,291529,22600,341173,332336,-8837
960,86,291911,24100,343759,333198,-10561
961,89,292310,24700,346873,333208,-13665
962,81,292410,23850,348023,335764,-12259
963,80,292873,25150,349635,338646,-10989
964,80,293148,20650,350188,340646,-9542
965,90,293625,22950,351888,332886,-19002
966,86,293782,28600,353088,333138,-19950
967,85,293804,25400,353257,335848,-17409
968,87,294056,23250,353485,337669,-15816
969,88,294373,26900,355102,340238,-14864
970,84,294551,22200,355597,341838,-13759
971,86,294762,21850,354807,343369,-11438
972,80,294772,26500,354304,345469,-8835
974,84,294962,22450,355031,347238,-7793
974,84,294962,25750,355085,348541,-6544
975,88,295406,21950,356007,350898,-5109
976,83,295451,20350,356285,352288,-3997
977,86,295480,26350,356288,354038,-2250
978,81,295612,24750,356404,355169,-1235
979,86,295662,24550,356557,355291,-1266
980,90,296184,27450,358409,336523,-21886
981,82,296364,22550,358723,337668,-21055
983,80,296966,23850,358509,338379,-20130
983,80,296966,20150,341306,339318,-1988
984,82,297792,22550,327712,340518,12806
985,83,298371,24400,341432,341879,447
986,84,298935,23550,341509,343273,1764
987,87,298971,22350,331062,343794,12732
988,85,298978,28100,341678,346944,5266
989,90,299564,25200,341932,349069,7137
990,87,299929,22350,342228,351444,9216
991,82,299934,21650,342432,352344,9912
992,88,300057,25550,342298,355094,12796
993,89,300276,24700,338762,355791,17029
995,80,300331,19450,342609,356319,13710
995,80,300331,22400,341455,357038,15583
996,88,301340,26000,341431,357669,16238
997,87,301800,20550,341931,359144,17213
998,83,301961,23950,342503,356868,14365
999,84,302636,23550,344162,357729,13567
1000,89,303347,22450,344812,358573,13761
1001,85,303394,22700,345362,359073,13711
1002,88,303940,26450,347462,360173,12711
1004,80,304043,22050,346803,360923,14120
1004,80,304043,22850,347453,335784,-11669
1005,81,304531,23400,348003,335905,-12098
1007,81,305035,21400,357909,336451,-21458
1007,81,305035,22000,357409,337904,-19505
1009,90,305337,22250,366409,340243,-26166
1009,90,305337,23800,367154,341146,-26008
1010,81,305517,23400,368559,342416,-26143
1011,85,305961,23600,377170,345166,-32004
1012,90,306007,27000,377305,346946,-30359
1013,90,306731,24750,378209,349066,-29143
1016,85,307696,21050,356112,351496,-4616
1016,85,307696,22300,356553,354146,-2407
1016,85,307696,24850,355953,356566,613
1018,87,308794,21200,357081,358946,1865
1019,84,308844,22350,357340,361173,3833
1019,84,308844,23050,356840,361673,4833
1020,81,309765,24300,357404,362673,5269
1021,88,310041,25550,357157,363673,6516
1022,88,311292,21050,357807,363979,6172
1023,90,311444,22500,357885,363766,5881
1024,86,311966,20500,358404,364479,6075
1025,89,312193,24250,358857,364546,5689
1026,88,313005,24650,358881,356022,-2859
1027,88,313279,26900,359754,357152,-2602
1029,89,313347,21900,359481,357519,-1962
1029,89,313347,19700,359957,358462,-1495
1030,81,313549,20250,360081,360231,150
1031,83,313555,20800,360304,362062,1758
1032,84,314268,21750,359890,363331,3441
1033,86,315140,22300,360440,364362,3922
1034,86,315254,24100,360457,365101,4644
1036,82,316291,21150,359012,365912,6900
1036,82,316291,21600,358762,367233,8471
1037,82,316512,22100,359273,368433,9160
1039,84,316975,19350,359162,369679,10517
1039,84,316975,25750,360655,371133,10478
1040,80,317399,19300,361805,371912,10107
1041,80,318790,26500,362020,373281,11261
1042,88,318829,22850,361520,374501,12981
1044,85,319163,23400,361962,375679,13717
1044,85,319163,25350,361873,377062,15189
1045,81,319339,24750,362335,377581,15246
1046,80,319525,25600,359762,366119,6357
1048,81,319744,23450,359303,366175,6872
1048,81,319744,24250,360312,366529,6217
1049,81,320994,24300,360664,367029,6365
1050,87,321277,26400,361658,367719,6061
1052,82,322170,19850,363542,368219,4677
1053,82,322329,20300,363620,368638,5018
1054,85,322589,20300,364369,367289,2920
1055,83,322736,24500,365505,369996,4491
1055,83,322736,23450,365920,372823,6903
1056,86,323400,23650,366520,375196,8676
1202,89,360550,22650,368755,377373,8618
1203,84,360992,22050,368255,378329,10074
1203,84,360992,28850,369205,379133,9928
1203,84,360992,26900,368969,379829,10860
1203,84,360992,24450,369455,380429,10974
1203,84,360992,21650,370005,379473,9468
1203,84,360992,23000,370342,380833,10491
1203,84,360992,23150,371442,381383,9941
1203,84,360992,19800,371777,381473,9696
1203,84,360992,22050,371970,368494,-3476
1203,84,360992,25550,372222,368421,-3801
1203,84,360992,23850,375542,369544,-5998
1203,84,360992,24350,376092,370421,-5671
1203,84,360992,24950,377295,370744,-6551
1203,84,360992,21750,378572,371467,-7105
1203,84,360992,23850,380222,372770,-7452
1203,84,360992,23100,381272,374147,-7125
1204,82,361906,28850,383272,375367,-7905
1204,82,361906,25500,385272,375867,-9405
1204,82,361906,26550,386877,377212,-9665
1204,82,361906,28200,387252,378412,-8840
1204,82,361906,27050,387427,379397,-8030
1204,82,361906,21700,387802,380131,-7671
1204,82,361906,25000,388795,380720,-8075
1204,82,361906,23400,390002,381870,-8132
1204,82,361906,25550,391692,382067,-9625
1204,82,361906,24500,392302,372546,-19756
1204,82,361906,21650,394145,373646,-20499
1204,82,361906,19500,393942,374811,-19131
1204,82,361906,26100,394822,375946,-18876
1204,82,361906,21750,395877,376911,-18966
1204,82,361906,22200,396092,381383,-14709
1204,82,361906,22500,397522,383697,-13825
1204,82,361906,24300,396952,378111,-18841
1204,82,361906,24650,398445,378496,-19949
1204,82,361906,23650,398727,379811,-18916
1204,82,361906,22100,399022,380196,-18826
1204,82,361906,26600,380522,380861,339
1204,82,361906,25200,382412,381361,-1051
1204,82,361906,25100,382522,381881,-641
1204,82,361906,21650,383462,382364,-1098
1204,82,361906,23000,384222,382607,-1615
1204,82,361906,24800,384662,382983,-1679
1204,82,361906,23900,384638,383917,-721
1204,82,361906,21650,370137,385441,15304
1204,82,361906,21050,370187,386017,15830
1204,82,361906,21600,376707,386041,9334
1204,82,361906,26550,377207,387041,9834
1204,82,361906,19350,381507,387117,5610
1204,82,361906,22200,382584,384381,1797
1204,82,361906,22050,382637,384481,1844
1204,82,361906,26550,383237,384931,1694
1205,81,362380,22600,388784,377024,-11760
1205,81,362380,24000,389287,377753,-11534
1205,81,362380,26550,392884,385031,-7853
1205,81,362380,26950,396434,385033,-11401
1205,81,362380,26450,397937,380074,-17863
1205,81,362380,27850,406237,385107,-21130
1206,85,362451,22500,408287,384664,-23623
1205,81,362380,26150,409087,385164,-23923
1205,81,362380,25000,411934,385431,-26503
1206,85,362451,21650,413034,382811,-30223
1206,85,362451,23450,414334,385531,-28803
1206,85,362451,20600,416434,383603,-32831
1206,85,362451,19800,418037,385583,-32454
1206,85,362451,26350,418837,384546,-34291
1205,81,362380,26000,421437,385664,-35773
1205,81,362380,27800,420656,386024,-34632
1205,81,362380,23450,384497,386561,2064
1205,81,362380,23400,385167,386753,1586
1206,85,362451,22900,386081,387061,980
1206,85,362451,21650,389375,387561,-1814
1205,81,362380,27250,389365,388138,-1227
1205,81,362380,24800,391225,388638,-2587
1206,85,362451,21150,393017,388953,-4064
1206,85,362451,23950,394867,389453,-5414
1206,85,362451,24800,398615,390296,-8319
1206,85,362451,23850,400617,390953,-9664
1206,85,362451,22900,401247,391496,-9751
1205,81,362380,27400,404517,392374,-12143
1205,81,362380,28500,405017,393103,-11914
1205,81,362380,24200,405831,393996,-11835
1206,85,362451,22200,407215,394538,-12677
1206,85,362451,26600,410131,405890,-4241
1206,85,362451,23600,410817,407540,-3277
1206,85,362451,25700,411967,409011,-2956
1205,81,362380,25250,414475,411267,-3208
1206,85,362451,23950,414147,412940,-1207
1206,85,362451,18900,417465,414011,-3454
1205,81,362380,27900,419481,416111,-3370
1205,81,362380,24650,419417,417567,-1850
1206,85,362451,25650,419575,419417,-158
1206,85,362451,24300,419047,421461,2414
1206,85,362451,22800,419515,423261,3746
1206,85,362451,21150,405919,424967,19048
1205,81,362380,21950,406630,426790,20160
1206,85,362451,17650,400944,428161,27217
1207,87,362754,19400,401072,429840,28768
1205,81,362380,22550,401952,431411,29459
1205,81,362380,24400,402502,433067,30565
1205,81,362380,28200,403395,435061,31666
1205,81,362380,22200,403775,436890,33115
1205,81,362380,23300,405425,438761,33336
1207,87,362754,28750,408025,441040,33015
1207,87,362754,20300,410721,443117,32396
1206,85,362451,25600,418271,445267,26996
1206,85,362451,24100,419575,446967,27392
1207,87,362754,23900,424771,448511,23740
1206,85,362451,22950,427875,450561,22686
1207,87,362754,26750,428125,452290,24165
1208,83,362811,24200,430426,453790,23364
1206,85,362451,21700,432006,455917,23911
1206,85,362451,24250,432980,457517,24537
1207,87,362754,22550,432675,459161,26486
1207,87,362754,21850,434030,460811,26781
1206,85,362451,26850,435371,463017,27646
1207,87,362754,26150,435321,465217,29896
1208,83,362811,25200,435325,466390,31065
1208,83,362811,21150,427223,468367,41144
1208,83,362811,22350,430610,470161,39551
1208,83,362811,26900,432067,472011,39944
1207,87,362754,25200,432931,474411,41480
1208,83,362811,24250,433525,476117,42592
1208,83,362811,25100,433797,477090,43293
1208,83,362811,24600,435317,427778,-7539
1207,87,362754,23450,435069,431128,-3941
1208,83,362811,29700,435525,434630,-895
1208,83,362811,25950,435681,435378,-303
1207,87,362754,25200,436467,412458,-24009
1207,87,362754,27850,436281,412958,-23323
1208,83,362811,18500,437660,413474,-24186
1208,83,362811,23750,438160,414026,-24134
1207,87,362754,20700,420187,414877,-5310
1208,83,362811,24100,421680,415673,-6007
1208,83,362811,28150,422474,416224,-6250
1207,87,362754,25200,423856,397125,-26731
1207,87,362754,22200,428330,399242,-29088
1207,87,362754,26350,429424,402392,-27032
1207,87,362754,23850,429806,405325,-24481
1207,87,362754,25550,429430,407853,-21577
1207,87,362754,30100,428987,409950,-19037
1208,83,362811,27300,429719,411280,-18439
1208,83,362811,22750,415797,412643,-3154
1207,87,362754,22100,420424,413943,-6481
1207,87,362754,23250,421806,415030,-6776
1208,83,362811,20650,421924,416430,-5494
1207,87,362754,16950,423106,417193,-5913
1208,83,362811,13200,424156,418530,-5626
1207,87,362754,16300,426374,419953,-6421
1208,83,362811,19000,426906,421358,-5548
1208,83,362811,18100,429556,422980,-6576
1208,83,362811,21150,430056,424193,-5863
1209,88,363779,25550,430824,426193,-4631
1210,80,364277,21550,431956,426900,-5056
1211,85,364733,20900,434228,427893,-6335
1212,81,364820,22500,433858,428730,-5128
1213,87,365697,22800,435419,430200,-5219
1214,90,365729,23400,435680,431343,-4337
1215,88,366550,24650,435708,432943,-2765
1216,83,366669,20350,436278,434000,-2278
1217,88,366712,25550,436230,434130,-2100
1218,80,367062,21100,437069,411675,-25394
1219,84,367216,25800,437637,413942,-23695
1220,87,367243,23250,437330,415975,-21355
1221,82,367778,25700,437878,417392,-20486
1222,86,368584,26350,438030,419475,-18555
1223,81,369931,21600,438378,420625,-17753
1224,80,370114,22000,438878,421775,-17103
1225,87,370167,25500,439069,423892,-15177
1226,89,371008,25150,439130,425042,-14088
1227,82,371404,21200,439619,425725,-13894
1228,82,371493,23000,439428,427745,-11683
1229,87,373199,24600,439180,430186,-8994
1230,80,373405,21100,428769,432286,3517
1231,86,373807,20950,439637,433936,-5701
1232,85,373994,21350,429625,436795,7170
1233,89,374175,26500,439928,439436,-492
1234,89,374666,24250,430275,440486,10211
1235,86,374705,25450,440008,443036,3028
1236,80,375008,21100,439719,444686,4967
1237,86,375230,23650,439819,448386,8567
1238,87,375278,22800,440280,451136,10856
1239,88,375398,21950,440319,453645,13326
1240,83,375502,23500,432830,454845,22015
1241,87,375915,25050,440478,458436,17958
1242,82,376028,22100,440558,460795,20237
1243,90,376173,27450,440737,464095,23358
1244,80,376611,23350,440819,466195,25376
1245,86,376794,26350,441721,468345,26624
1246,87,377308,23700,442771,470995,28224
1247,83,378814,27100,445421,473136,27715
1248,88,379379,24200,448271,476845,28574
1249,90,379680,24300,451750,477642,25892
1250,83,379887,22600,452300,478240,25940
1251,83,380119,26200,454062,479711,25649
1252,85,380307,26750,456038,480461,24423
1253,86,380384,29050,457163,481511,24348
1254,82,380448,23000,456613,482467,25854
1255,81,380574,24750,457638,483111,25473
1256,80,380738,22450,458738,483611,24873
1257,89,380811,21550,458950,484942,25992
1258,85,381110,21800,459463,479045,19582
1259,88,381407,25100,459550,481386,21836
1260,80,381519,25600,453671,483586,29915
1261,83,381743,21250,455630,485142,29512
1262,85,382615,23150,458180,485811,27631
1263,80,382696,22000,457921,486211,28290
1264,86,382736,21400,458521,486711,28190
1265,87,382904,22350,458780,486286,27506
1266,88,383281,26900,460336,487511,27175
1267,84,383448,22200,460765,487945,27180
1268,84,383661,24450,461113,438892,-22221
1269,81,383974,21150,461150,439825,-21325
1270,90,384068,22500,461388,439942,-21446
1271,82,384928,24350,461565,441348,-20217
1272,85,385034,27650,461163,442398,-18765
1273,89,385281,25600,461990,441942,-20048
1274,84,385307,22650,461615,442492,-19123
1275,80,385531,21100,461715,442825,-18890
1276,88,385762,21950,462163,443542,-18621
1277,90,386032,23850,462521,444592,-17929
1278,86,386231,23200,463021,445053,-17968
1279,81,387270,23850,463521,445092,-18429
1280,85,387327,23150,442745,445125,2380
1281,83,387460,23950,443513,445296,1783
1282,85,387567,25400,443611,447121,3510
1283,86,388501,20500,446345,449421,3076
1284,81,388521,20250,446763,450154,3391
1285,84,388619,21300,447695,451571,3876
1286,81,388761,22050,448387,452904,4517
1288,88,388964,25050,449413,454371,4958
1288,88,388964,27300,450437,456004,5567
1289,90,389114,22950,451163,457504,6341
1290,83,389249,23050,451395,459554,8159
1291,82,389610,25250,455237,460521,5284
1293,87,389617,22550,454345,461154,6809
1294,83,389695,25500,454545,462204,7659
1294,83,389695,23450,455313,463271,7958
1295,83,389728,25300,455445,464321,8876
1296,90,390106,22950,458461,464904,6443
1297,83,390228,25300,459395,466471,7076
1298,81,390234,17100,459011,466654,7643
1299,83,390359,24850,459513,467221,7708
1300,83,390515,20800,460011,468371,8360
1301,90,390833,21150,462759,470504,7745
1302,87,390941,24600,463816,473154,9338
1303,82,390973,25250,463874,474254,10380
1304,81,391624,22050,467211,474904,7693
1305,87,391750,30000,470316,475954,5638
1306,90,391785,24300,470424,476054,5630
1307,86,391788,25000,470109,477204,7095
1308,85,391862,20900,471074,477821,6747
1309,90,392066,22950,471609,479021,7412
1310,86,392357,27250,472511,479854,7343
1311,85,392492,21800,472759,480821,8062
1312,82,392818,19400,474259,481421,7162
1313,86,392896,21850,474116,484454,10338
1314,87,393053,21000,475111,485004,9893
1315,80,393229,22000,475213,486054,10841
1316,89,393582,25150,476361,487371,11010
1317,84,393592,24450,476716,488113,11397
1318,82,393929,23450,478363,488646,10283
1319,80,394020,18850,478261,488861,10600
1320,87,394041,22800,478516,489146,10630
1321,90,394588,24750,480013,489696,9683
1322,90,394694,21600,480109,489911,9802
1323,87,395363,23700,480513,490411,9898
1324,85,395664,24050,438362,490613,52251
1325,89,396072,26950,439325,490911,51586
1326,87,396170,24600,439381,490592,51211
1327,88,396825,24200,439261,491346,52085
1328,82,397982,25700,439850,491911,52061
1329,87,398162,26400,439761,492069,52308
1330,85,398948,28550,441755,488445,46690
1331,80,398960,22450,441344,488988,47644
1332,86,399300,21850,444405,489295,44890
1333,86,399363,26350,444423,490295,45872
1334,86,399600,25450,446023,490538,44515
1335,88,400227,22850,449028,491088,42060
1336,81,400394,26100,454180,492088,37908
1337,83,400525,25300,455112,492796,37684
1338,83,400573,21700,455780,492688,36908
1339,80,401580,20200,462312,488671,26359
1340,84,401597,24450,462480,489721,27241
1341,83,402139,23050,469980,490004,20024
1342,87,402325,25500,472912,490504,17592
1343,83,402375,25300,474412,491004,16592
1344,81,402812,23400,486430,491271,4841
1345,86,402813,25450,486480,472524,-13956
1346,90,403081,24300,492980,491104,-1876
1347,80,403129,23800,493812,491771,-2041
1348,81,403498,22500,496480,475232,-21248
1349,81,404025,22500,504662,475833,-28829
1350,82,404186,18950,508062,491654,-16408
1351,89,404323,26500,513762,467118,-46644
1352,80,404406,17950,517562,467959,-49603
1353,84,404541,19950,520562,468889,-51673
1354,81,404674,23850,525363,469883,-55480
1355,83,404890,23500,526079,471033,-55046
1356,84,405306,21300,529713,470855,-58858
1357,85,405311,20450,529929,471122,-58807
1358,82,405552,21200,531638,472605,-59033
1359,88,405874,26450,534529,474205,-60324
1360,85,406056,23600,536263,476355,-59908
1361,89,406103,26050,536779,477522,-59257
1362,86,406304,26800,536894,478122,-58772
1363,87,406431,19200,536462,479255,-57207
1365,87,406681,22500,541080,480255,-60825
1365,87,406681,22300,542780,481372,-61408
1366,86,407029,25900,549930,483905,-66025
1367,89,407264,23800,553512,485072,-68440
1368,89,407270,24700,553380,486305,-67075
1369,88,407281,22400,552730,486722,-66008
1370,87,407751,22800,497276,487455,-9821
1371,90,408321,23850,498315,488283,-10032
1372,81,408634,21150,498705,488883,-9822
1373,87,409278,24600,498661,489236,-9425
1374,83,409440,23950,498714,489422,-9292
1376,80,409465,26700,498864,463727,-35137
1376,80,409465,22400,499364,467027,-32337
1377,82,409987,23900,452964,469227,16263
1378,82,410733,21650,455764,470277,14513
1379,84,411260,23100,459808,471533,11725
1380,86,411539,23200,464210,472637,8427
1381,86,411605,22300,464860,473468,8608
1382,85,411677,22700,465910,474387,8477
1383,85,412178,18650,469260,474968,5708
1384,84,412730,20400,477410,475183,-2227
1385,84,412764,24450,478060,476189,-1871
1386,87,412809,22350,479210,477118,-2092
1387,87,413798,29100,485910,491713,5803
1389,86,413926,25100,488015,492154,4139
1389,86,413926,23600,489610,492296,2686
1390,87,414177,24150,491510,492321,811
1391,80,414221,22900,492010,472927,-19083
1392,89,414973,24250,495065,492654,-2411
1393,86,415608,22300,499875,479653,-20222
1394,86,415705,24100,500405,481903,-18502
1395,81,416232,19350,502655,483477,-19178
1396,86,416318,25000,503078,486103,-16975
1397,80,416670,22000,504228,489227,-15001
1399,80,417074,28300,505505,493153,-12352
1399,80,417074,21050,505055,494927,-10128
1400,80,417161,24250,507160,496953,-10207
1401,88,417249,25100,509365,470454,-38911
1402,85,417484,22250,514615,471093,-43522
1403,87,417499,24150,514665,472554,-42111
1404,88,417778,25100,516815,473804,-43011
1405,81,417831,18450,516360,474943,-41417
1406,90,418461,27900,481924,476633,-5291
1407,80,418639,22900,482861,476883,-5978
1408,80,418732,22450,482509,477341,-5168
1410,82,418864,21650,483059,477834,-5225
1410,82,418864,22950,483263,478233,-5030
1411,84,418940,22650,483074,478834,-4240
1412,84,419916,19050,484279,479641,-4638
1413,83,420185,20350,485598,479924,-5674
1414,87,420773,26850,488411,480424,-7987
1415,89,420844,24250,488698,481191,-7507
1416,87,421055,24150,489338,481524,-7814
1418,85,421720,22600,490298,481933,-8365
1418,85,421720,22650,490561,482334,-8227
1419,85,422274,22250,491738,482583,-9155
1420,88,423179,26450,493329,483583,-9746
1421,83,423683,23050,496229,484228,-12001
1422,90,423702,21150,496298,486194,-10104
1423,81,423785,21600,496998,487528,-9470
1424,81,424605,22500,498329,488894,-9435
1425,80,425540,18850,498998,490544,-8454
1426,88,426162,26450,501711,492878,-8833
1427,89,426314,26500,502188,495015,-7173
1428,85,426367,24500,502294,496878,-5416
1429,81,427831,22050,503648,498163,-5485
1430,88,428267,24650,504029,499965,-4064
1431,88,428753,29150,504994,501715,-3279
1432,86,429135,20950,506538,503413,-3125
1433,83,429167,22600,506598,505102,-1496
1434,88,429172,22400,506411,507363,952
1436,86,430043,22050,507994,509052,1058
1436,86,430043,24500,508188,510615,2427
1437,86,430316,25000,509061,512113,3052
1438,88,430851,24200,510194,513863,3669
1439,90,431117,23850,510738,514863,4125
1440,87,431636,20550,511794,516278,4484
1442,84,432378,20100,513548,516465,2917
1442,84,432378,24850,513888,492483,-21405
1443,87,432516,22350,514511,493083,-21428
1444,87,433227,25050,516061,493570,-22491
1445,80,433965,17050,517398,494009,-23389
1446,90,434243,23400,518838,494733,-24105
1447,85,434339,20000,519548,495187,-24361
1448,85,434371,26300,519838,495320,-24518
1449,89,435940,22000,521379,495759,-25620
1450,80,436144,22900,522694,496570,-26124
1451,82,436406,20300,523429,496983,-26446
1452,90,436636,21150,524398,497339,-27059
1453,85,437265,21350,524794,498000,-26794
1454,86,437663,26800,511775,501644,-10131
1455,88,437889,22850,511978,504844,-7134
1456,89,438451,22450,512425,507400,-5025
1457,86,439045,25450,512455,511700,-755
1458,85,439121,20000,512625,513550,925
1459,80,439306,21100,513628,516650,3022
1461,84,439333,20750,513505,518944,5439
1461,84,439333,27550,513125,521650,8525
1462,80,439409,21100,513344,524450,11106
1463,87,439484,21000,513675,525744,12069
1464,89,439746,23350,513844,527894,14050
1465,87,439896,23250,512908,529044,16136
1466,90,440160,27450,515417,531950,16533
1467,82,441115,23450,517358,534744,17386
1468,81,441250,22500,518667,536994,18327
1469,87,441486,21000,521717,539494,17777
1470,83,441617,20800,521608,541215,19607
1471,90,441815,24300,522108,541878,19770
1472,84,442156,23100,524567,542265,17698
1473,80,442212,23800,525617,542696,17079
1474,89,442423,29650,526717,543715,16998
1476,82,442613,24300,527417,544028,16611
1476,82,442613,22950,528467,544615,16148
1477,87,443309,23700,529467,545115,15648
1478,80,443496,24250,529808,545615,15807
1479,89,444200,24700,532608,543500,10892
1482,83,444424,24200,534017,545750,11733
1481,81,444423,20700,534608,546052,11444
1482,83,444424,21650,535067,546615,11548
1483,88,444497,26000,535208,547552,12344
1484,89,444862,22900,536258,548165,11907
1485,87,446363,24150,537540,547780,10240
1487,84,446886,23550,538313,547800,9487
1487,84,446886,23050,539090,548665,9575
1489,83,448053,22500,540348,548844,8496
1489,83,448053,22100,540379,549152,8773
1490,89,448785,22900,540879,525931,-14948
1491,86,449455,25900,542048,526507,-15541
1493,86,449619,19600,542790,527107,-15683
1494,80,449708,22300,543048,527317,-15731
1494,80,449708,24650,543263,504459,-38804
1495,87,451026,25500,543863,504739,-39124
1496,85,451118,23600,544290,504870,-39420
1497,90,451480,26550,544648,505239,-39409
1498,82,451597,20300,544963,505470,-39493
1499,80,451676,22000,545179,505509,-39670
1500,80,452385,22450,545613,505789,-39824
1501,82,452953,23900,545944,506009,-39935
1502,88,453334,25100,546290,506287,-40003
1504,83,455242,22700,546790,505335,-41455
1504,83,455242,18500,547290,505935,-41355
1505,85,455546,23600,548363,506933,-41430
1506,83,455563,21250,548794,507647,-41147
1507,82,455613,23900,548863,509697,-39166
1508,81,456729,22050,549040,511247,-37793
1509,83,457171,20800,549913,513524,-36389
1510,88,457407,20150,549690,515147,-34543
1512,86,458064,22300,550390,516897,-33493
1512,86,458064,21800,550729,519347,-31382
1552,86,469368,26150,538467,520874,-17593
1552,86,469368,23400,540217,521747,-18470
1553,89,469583,21200,541458,523624,-17834
1553,89,469583,24850,542267,524947,-17320
1554,85,470131,22600,542558,525447,-17111
1554,85,470131,31050,544317,527047,-17270
1554,85,470131,19050,545367,527566,-17801
1554,85,470131,22150,546858,528107,-18751
1554,85,470131,23450,546567,528567,-18000
1554,85,470131,21100,547167,528816,-18351
1555,81,470424,26500,547767,529816,-17951
1555,81,470424,22100,547217,530524,-16693
1555,81,470424,23050,547508,530767,-16741
1555,81,470424,23850,548767,530916,-17851
1557,80,470580,22600,549317,531274,-18043
1555,81,470424,24750,550367,531983,-18384
1556,84,470462,26800,550658,532516,-18142
1559,90,470724,25300,550890,533066,-17824
1556,84,470462,22800,551279,534007,-17272
1557,80,470580,27400,551413,534166,-17247
1557,80,470580,26000,551390,532326,-19064
1559,90,470724,24800,551548,535288,-16260
1559,90,470724,22400,551496,537176,-14320
1560,88,470784,24800,551913,540288,-11625
1561,85,470814,21650,552540,541988,-10552
1561,85,470814,22500,552963,544638,-8325
1562,83,470866,24050,552598,549326,-3272
1561,85,470814,24550,553040,551976,-1064
1558,88,470712,25900,553429,555738,2309
1562,83,470866,22800,553096,558888,5792
1562,83,470866,24450,553563,562526,8963
1559,90,470724,21650,553646,564289,10643
1562,83,470866,23550,553929,565642,11713
1561,85,470814,26950,554146,567316,13170
1558,88,470712,22950,554613,568139,13526
1561,85,470814,27500,554929,569416,14487
1561,85,470814,25250,555146,571079,15933
1560,88,470784,21500,554763,571966,17203
1562,83,470866,20750,553358,572383,19025
1559,90,470724,23600,553017,573366,20349
1561,85,470814,22400,553067,574542,21475
1561,85,470814,22900,553567,575766,22199
1560,88,470784,17350,553882,576842,22960
1560,88,470784,22150,554382,565226,10844
1561,85,470814,19200,554562,567838,13276
1562,83,470866,28200,554932,571676,16744
1562,83,470866,21850,554662,574526,19864
1563,81,471393,24050,555162,577629,22467
1563,81,471393,25000,555212,578383,23171
1563,81,471393,21400,555432,579192,23760
1563,81,471393,18750,528314,580129,51815
1565,88,471762,23850,555262,581129,25867
1565,88,471762,21000,524689,581933,57244
1566,90,472963,23850,526062,579276,53214
1567,82,473377,17600,527777,581076,53299
1568,81,473632,21150,529212,582468,53256
1570,90,473698,25250,529930,583292,53362
1570,90,473698,24700,530212,583792,53580
1571,83,474331,21700,532282,584288,52006
1572,85,474404,22700,532527,537484,4957
1573,85,475168,20900,534530,540089,5559
1574,81,475325,24300,536627,543684,7057
1575,81,475511,21600,537732,546989,9257
1576,81,475538,21150,538212,548784,10572
1577,82,475742,19850,540032,550739,10707
1579,85,475936,20000,541877,552434,10557
1580,88,475952,22250,541830,555289,13459
1580,88,475952,26400,542212,559334,17122
1581,80,476134,21100,542439,561989,19550
1582,89,476460,26500,545580,565539,19959
1583,88,476692,24200,548130,568934,20804
1585,83,476745,25900,548630,572689,24059
1585,83,476745,23450,548539,575889,27350
1586,89,477536,23800,549932,578939,29007
1587,82,477810,22550,551430,582189,30759
1588,87,478016,18300,555750,582584,26834
1589,90,478794,22950,555763,541611,-14152
1590,90,478911,28800,555796,542372,-13424
1591,89,479132,23800,556029,543311,-12718
1592,82,479480,23450,556250,545122,-11128
1593,83,479922,23500,555312,546322,-8990
1594,87,480061,20100,555812,546822,-8990
1595,89,480847,23800,556312,547472,-8840
1596,89,480960,25150,540233,548711,8478
1597,89,481096,25150,540719,549717,8998
1598,84,481126,23550,556032,549750,-6282
1599,81,481536,22500,556532,550517,-6015
1601,83,481829,25600,553667,551017,-2650
1601,83,481829,22100,553958,551417,-2541
1603,87,482309,26800,554267,552117,-2150
1603,87,482309,20950,549607,552717,3110
1604,80,482364,20200,550540,552517,1977
1605,82,482533,22100,554817,553217,-1600
1606,90,482654,24750,554317,553550,-767
1607,86,482760,20050,554006,553767,-239
1608,87,483006,24150,556013,554068,-1945
1609,85,483260,22700,557117,555833,-1284
1610,84,483459,20400,557913,557598,-315
1611,84,484756,21300,560640,559344,-1296
1612,90,484914,24300,561617,561068,-549
1614,82,485384,24750,565290,562744,-2546
1614,82,485384,21600,566940,563418,-3522
1615,90,485563,24300,568856,559452,-9404
1616,81,485658,27900,570646,561070,-9576
1618,87,485895,23850,572840,562570,-10270
1618,87,485895,23200,572856,563720,-9136
1619,80,486296,19300,574440,564852,-9588
1620,80,487864,21550,576346,565457,-10889
1622,80,488834,23950,581967,566420,-15547
1622,80,488834,18350,582163,567191,-14972
1623,87,488939,23250,583090,568304,-14786
1624,90,489147,27450,585356,569720,-15636
1625,83,489493,23500,589067,570807,-18260
1626,85,489497,26300,588017,572091,-15926
1627,83,489682,25300,590363,573002,-17361
1628,89,490568,24700,592217,574202,-18015
1629,82,490981,21650,594906,575107,-19799
1630,85,491088,24950,595490,576402,-19088
1631,83,491563,24400,598896,577807,-21089
1632,86,491716,29500,600490,578854,-21636
1633,81,492004,25200,601667,579720,-21947
1634,84,492267,22200,604346,579991,-24355
1635,80,492434,20200,606163,580541,-25622
1636,80,492447,24700,606446,581152,-25294
1637,88,493495,26000,607996,581820,-26176
1638,84,493788,21750,609356,582252,-27104
1639,88,494128,24650,612490,583204,-29286
1640,81,494166,23400,612613,583757,-28856
1641,90,495205,31050,614767,584491,-30276
1642,81,495504,19350,616967,585041,-31926
1643,84,495809,20400,617517,585454,-32063
1644,80,495837,24700,617390,585752,-31638
1645,84,496141,22650,560981,586641,25660
1646,89,496315,26500,563631,587191,23560
1647,84,496785,21300,569014,587807,18793
1648,88,496962,26450,574214,588502,14288
1649,87,497038,21000,576781,588907,12126
1651,87,497098,23000,577281,556125,-21156
1651,87,497098,23650,577781,556775,-21006
1652,89,497311,25600,582564,557825,-24739
1654,88,497404,21450,584214,559292,-24922
1654,88,497404,25050,583114,560925,-22189
1656,82,497755,25000,587423,562025,-25398
1656,82,497755,22950,587983,562792,-25191
1657,88,498081,23300,589583,563625,-25958
1658,81,498215,22500,594471,564992,-29479
1659,84,498295,23550,597190,566475,-30715
1660,84,498305,22200,597071,568075,-28996
1661,89,499989,23350,601371,569842,-31529
1662,90,500150,22950,603171,571742,-31429
1663,81,500463,22500,607390,573575,-33815
1664,88,500676,25550,613140,574792,-38348
1665,82,500784,23000,614790,576325,-38465
1666,90,500957,29250,617821,577942,-39879
1667,86,501139,21400,620990,578592,-42398
1668,82,501157,24800,621071,580592,-40479
1670,84,501717,21950,624840,581642,-43198
1670,84,501717,19000,625071,582642,-42429
1671,84,502761,24450,628690,584884,-43806
1672,86,503541,29500,635090,586991,-48099
1673,80,503601,21550,636571,588041,-48530
1674,84,503799,24450,640292,589304,-50988
1675,89,503964,26050,641990,589804,-52186
1676,83,504143,22150,641871,590093,-51778
1677,86,504400,21850,642471,590120,-52351
1678,81,506229,24300,562080,590593,28513
1679,88,506329,22850,562527,591093,28566
1680,82,506380,18050,562132,591643,29511
1681,90,506634,25200,562232,591702,29470
1683,89,506911,24850,562730,592202,29472
1683,89,506911,26000,562291,592607,30316
1684,88,506980,19700,562782,593054,30272
1686,86,507233,23800,562319,593657,31338
1686,86,507233,24500,562662,593252,30590
1687,89,507551,26950,563848,593720,29872
1688,86,507623,19600,566053,591134,25081
1689,85,507893,21350,570748,591634,20886
1690,89,507961,24700,571653,592184,20531
1691,90,508240,27000,575498,592891,17393
1692,88,508419,25100,576598,593184,16586
1693,83,508953,20350,578148,593591,15443
1694,81,509636,17550,581953,593754,11801
1695,87,509689,26850,582598,594157,11559
1696,85,510598,22700,584748,594254,9506
1698,81,510897,23900,589153,594793,5640
1698,81,510897,22000,588653,595054,6401
1699,88,511587,26000,596048,595320,-728
1700,81,511593,24300,596598,595404,-1194
1701,87,511729,22800,597453,595833,-1620
1702,81,512241,25200,601598,596468,-5130
1703,81,512250,23400,601653,596833,-4820
1704,84,512539,21300,603398,597383,-6015
1705,87,513036,23250,604753,598068,-6685
1706,83,513528,23950,608753,598359,-10394
1707,88,513540,26000,609348,598698,-10650
1708,80,513719,24250,610803,599568,-11235
1709,90,514144,23850,612803,600168,-12635
1710,86,514431,24550,616198,600898,-15300
1711,89,514482,24700,616748,601318,-15430
1712,80,514632,22000,617103,601559,-15544
1713,86,514793,19600,617698,602318,-15380
1714,85,514970,21350,618540,602659,-15881
1715,86,515027,26350,618748,603348,-15400
1716,82,515080,23450,619140,603983,-15157
1717,82,515608,23900,619613,604348,-15265
1718,89,515859,25150,620213,604709,-15504
1719,80,516022,22450,620167,605083,-15084
1720,88,516523,22850,620713,605548,-15165
1721,83,516668,22150,621140,605759,-15381
1722,85,517139,24500,621640,606168,-15472
1723,88,517367,26450,621917,606668,-15249
1724,80,517779,23800,622056,607148,-14908
1725,87,518093,21900,622290,607933,-14357
1726,83,518153,23050,622548,608559,-13989
1727,80,519051,20200,622667,608968,-13699
1728,83,519407,22600,623048,609483,-13565
1729,86,519461,23200,622813,609118,-13695
1730,89,519571,23800,623317,594192,-29125
1731,87,519805,25050,623548,594675,-28873
1732,86,521005,26800,624048,595175,-28873
1733,82,521276,23450,624363,595242,-29121
1734,89,521337,22900,624548,595275,-29273
1735,86,521430,20950,624856,595775,-29081
1736,82,521730,24350,625163,596833,-28330
1737,89,522015,23350,625548,597370,-28178
1738,88,522088,25100,625540,597754,-27786
1739,80,522155,19750,626040,598583,-27457
1741,90,522381,20400,626367,599256,-27111
1741,90,522381,22900,626540,600267,-26273
1742,85,522802,26750,626148,601433,-24715
1743,89,523431,23800,626713,602904,-23809
1744,87,523537,19200,626856,603470,-23386
1745,82,524009,19850,627198,603970,-23228
1746,80,524473,24700,627213,606089,-21124
1747,84,524607,25350,627367,610339,-17028
1748,85,524762,20450,627748,613153,-14595
1749,90,525350,27450,628440,618339,-10101
1750,87,525397,21900,628617,621939,-6678
1751,87,525497,24150,628348,628039,-309
1752,82,525675,23000,629463,632489,3026
1753,84,525970,21750,630290,636189,5899
1755,86,526339,25050,631290,639589,8299
1755,86,526339,24050,631613,613167,-18446
1768,80,529024,26000,632213,614033,-18180
1768,80,529024,25750,633017,615083,-17934
1768,80,529024,27000,635298,615867,-19431
1770,83,530434,21350,635306,616656,-18650
1770,83,530434,23650,636790,616320,-20470
1770,83,530434,23350,636813,612692,-24121
1770,83,530434,23800,637313,613938,-23375
1771,87,530508,22200,638813,615745,-23068
1770,83,530434,25350,639898,616845,-23053
1771,87,530508,25250,640056,617938,-22118
1770,83,530434,22300,640067,619595,-20472
1771,87,530508,20800,620253,621188,935
1770,83,530434,18300,624198,622092,-2106
1771,87,530508,23450,624253,623293,-960
1771,87,530508,22300,624803,624338,-465
1771,87,530508,20300,625848,624993,-855
1772,88,531264,24200,626348,626342,-6
1773,85,531941,23150,627348,627392,44
1774,80,532260,23800,627703,628785,1082
1775,90,532346,25200,628848,630443,1595
1776,84,532445,22200,628353,630088,1735
1777,83,532706,26650,629003,621433,-7570
1778,86,532808,23650,630053,622217,-7836
1779,89,532892,23350,630553,622506,-8047
1780,81,533024,21150,631548,620143,-11405
1781,82,533352,21650,632803,621793,-11010
1782,88,533579,23300,634248,623006,-11242
1783,88,533629,21500,633748,623735,-10013
1784,86,533772,20950,633453,624117,-9336
1785,88,533901,21050,635248,624608,-10640
1787,87,534542,21650,637948,608920,-29028
1787,87,534542,25000,636803,610391,-26412
1788,81,534630,21150,638003,612098,-25905
1789,82,534886,23000,638548,613859,-24689
1790,80,534944,22000,638153,615491,-22662
1791,85,535840,19550,639648,617191,-22457
1792,82,536159,24350,640203,619098,-21105
1793,86,536632,24100,640698,620859,-19839
1794,90,537491,25650,641067,623097,-17970
1795,90,537750,24300,640856,624748,-16108
1796,82,538627,26150,642465,626470,-15995
1797,83,538777,21700,642798,628670,-14128
1798,86,538799,25450,642298,630391,-11907
1799,90,538806,24750,642956,632597,-10359
1800,85,538829,25400,642965,634670,-8295
1801,90,539023,26100,643398,636297,-7101
1802,88,539322,23750,643456,638097,-5359
1803,85,539563,27200,644498,641411,-3087
1804,89,539625,27400,644367,644611,244
1805,86,539799,20950,644215,646726,2511
1806,84,540061,23100,644998,649526,4528
1807,81,540063,27450,644815,607905,-36910
1808,88,540700,27800,645648,608622,-37026
1809,87,540713,24150,645467,609122,-36345
1810,84,540964,25350,647218,610172,-37046
1811,89,541155,22000,653270,610705,-42565
1812,80,541277,22450,654468,611205,-43263
1813,84,541644,19950,657370,610872,-46498
1814,83,542354,22600,665270,612761,-52509
1815,84,542559,31200,673118,620296,-52822
1816,80,542570,23800,672618,623161,-49457
1817,83,542864,22150,676320,626896,-49424
1818,90,543317,22950,679768,631196,-48572
1819,90,544000,22500,682470,635746,-46724
1820,81,545270,22500,682768,640106,-42662
1821,90,545362,27900,642521,643839,1318
1822,88,545454,26450,643021,647506,4485
1823,89,545750,26950,644593,651439,6846
1824,82,545852,22100,646171,654239,8068
1825,80,546007,22900,648193,657756,9563
1826,85,546012,25400,647821,660241,12420
1827,86,546295,26350,649571,661248,11677
1828,81,546311,21150,648243,662222,13979
1829,87,546417,26400,650221,663648,13427
1830,90,546748,23400,650721,665048,14327
1831,85,547295,26300,650843,666798,15955
1832,87,547720,25500,643498,668341,24843
1833,85,549331,24500,644003,669548,25545
1834,90,549689,23850,644998,670991,25993
1835,84,550334,22650,646353,671649,25296
1836,81,550535,25650,646598,672591,25993
1837,87,550756,25050,646953,662389,15436
1838,81,550844,20700,647494,665139,17645
1839,82,550851,23000,647248,668839,21591
1840,81,551100,25650,647606,671539,23933
1841,87,551714,22350,647217,674961,27744
1842,87,552132,25500,632969,676341,43372
1843,85,552367,23150,647717,677024,29307
1844,86,552462,22300,637319,677699,40380
1845,88,552637,21500,647748,678541,30793
1846,88,553017,25550,639216,678249,39033
1847,82,553058,24800,647900,678749,30849
1848,89,554691,26500,647917,678824,30907
1849,84,554882,17700,647994,679399,31405
1850,80,555080,19300,644329,679715,35386
1851,87,555303,25050,647953,680326,32373
1852,83,555362,24400,647680,649693,2013
1853,83,555378,23500,647800,650690,2890
1854,81,556050,23400,649450,651095,1645
1855,86,556274,24550,650600,651642,1042
1856,82,556422,21650,651250,651840,590
1857,88,556843,28250,653917,652643,-1274
1858,85,556859,22700,654050,653292,-758
1859,89,557258,22450,655800,654540,-1260
1860,87,557456,25500,656729,655543,-1186
1861,86,558231,21850,657867,656442,-1425
1862,88,558428,21950,658917,656992,-1925
1863,82,558783,21650,659807,657695,-2112
1864,81,559213,25200,662657,658940,-3717
1865,88,559311,26450,663579,660043,-3536
1866,90,559354,27000,663700,660845,-2855
1867,90,559984,23400,664679,661743,-2936
1868,81,560415,22950,666417,662393,-4024
1869,84,560793,22650,668357,663090,-5267
1870,90,560916,24300,669357,664035,-5322
1871,90,561046,25200,669830,664643,-5187
1872,83,561315,23500,670129,665545,-4584
1873,87,561865,24600,629547,666542,36995
1874,83,561949,20800,630047,667340,37293
1875,86,562008,21850,630543,667785,37242
1876,81,562129,23850,630647,668990,38343
1877,90,562476,25200,635147,669785,34638
1878,83,562522,19000,635443,670335,34892
1879,84,563076,19950,637043,671095,34052
1880,87,563463,24600,639393,672143,32750
1881,90,563786,24750,643143,673635,30492
1882,82,563902,26600,644047,674140,30093
1883,81,564375,21600,645843,675235,29392
1884,88,564845,21500,647143,676043,28900
1885,84,565069,23550,648793,675595,26802
1886,82,565483,22100,651758,676145,24387
1887,83,565873,24400,658914,676795,17881
1888,83,566009,25750,663564,677295,13731
1889,85,566019,20450,663014,677940,14926
1890,82,566067,22100,663658,678543,14885
1891,89,566575,22450,668008,679395,11387
1892,80,566851,22000,671129,679585,8456
1893,84,567159,22200,671857,680192,8335
1894,87,568236,25050,672280,680692,8412
1895,85,568485,23600,673380,681140,7760
1896,86,568750,23650,673880,681640,7760
1897,82,568954,20750,674880,681842,6962
1898,90,569608,24750,675652,647861,-27791
1900,86,570180,27700,677279,647996,-29283
1900,86,570180,24050,677580,648361,-29219
1901,84,570445,23100,677802,648911,-28891
1902,89,570955,26500,679680,649746,-29934
1903,90,571098,27900,679917,650246,-29671
1904,87,572008,24150,680979,650746,-30233
1905,88,572114,26000,681417,651346,-30071
1906,89,572234,27400,681857,652211,-29646
1907,82,572324,21200,682080,652696,-29384
1908,82,572722,23000,682579,653196,-29383
1909,83,573126,22600,683517,653361,-30156
1910,90,573170,24300,683680,654361,-29319
1911,83,574337,27100,684780,654911,-29869
1912,82,574420,23000,684829,655346,-29483
1913,87,574596,18750,685379,655846,-29533
1914,83,574934,20800,685652,656896,-28756
1916,81,575358,20350,685867,657896,-27971
1917,87,575364,22500,686080,657511,-28569
1917,87,575364,20050,685852,658496,-27356
1918,83,575640,24400,686352,658661,-27691
1919,88,576516,23750,686529,659696,-26833
1920,88,577875,24650,687017,659761,-27256
1921,84,578012,24900,687229,660196,-27033
1922,85,578141,21800,687552,661763,-25789
1923,83,578389,22600,687857,662276,-25581
1924,88,578992,26450,687429,663513,-23916
1925,80,579477,22000,687529,664076,-23453
1926,85,579942,22250,688617,665163,-23454
1927,89,580037,27850,689117,666663,-22454
1928,87,580112,25950,689280,667763,-21517
1929,81,580144,22050,688852,669813,-19039
1930,86,580416,21850,689529,670913,-18616
1931,81,580621,26550,689957,672076,-17881
1932,90,580729,25650,690402,673626,-16776
1933,87,581008,18750,690952,674813,-16139
1934,84,581049,20400,691030,675926,-15104
1935,89,581134,26950,691129,677563,-13566
1936,82,581303,21200,691679,679713,-11966
1937,89,581400,25150,691680,681413,-10267
1938,89,581840,23800,692267,682442,-9825
1939,83,582697,21700,692557,682942,-9615
1940,80,582713,21550,692679,683535,-9144
1941,89,583172,26500,692817,684035,-8782
1942,88,583342,21500,693317,684635,-8682
1943,90,583452,27000,693867,685242,-8625
1944,88,583596,24200,693807,685295,-8512
1945,87,584049,19650,694307,685685,-8622
1946,80,584187,22900,694467,685840,-8627
1948,83,584371,24900,694680,685995,-8685
1948,83,584371,25700,694967,686994,-7973
1949,90,584687,27000,695280,688985,-6295
1950,80,584945,20200,696418,690739,-5679
1951,84,585585,24900,700268,692644,-7624
1952,84,586539,21300,703638,694089,-9549
1954,86,587656,21250,713454,695238,-18216
1954,86,587656,26750,713750,697462,-16288
1955,84,588487,18600,716504,699238,-17266
1956,89,588521,25150,716842,700738,-16104
1957,89,589205,26950,720700,702785,-17915
1958,88,589223,23750,721242,704238,-17004
1959,87,589329,22800,721750,705389,-16361
1960,90,589815,25650,723300,706639,-16661
1961,90,590178,24300,725350,707739,-17611
1962,84,590631,22650,729600,708988,-20612
1963,86,590739,20500,730292,710644,-19648
1964,84,590786,24000,730183,711194,-18989
1965,80,590997,18850,730517,687226,-43291
1966,88,591153,25100,722418,688850,-33568
1967,81,591419,18450,725218,690660,-34558
1968,83,591433,21700,725768,695350,-30418
1970,87,591850,23950,731392,698850,-32542
1970,87,591850,25900,731156,703460,-27696
1971,84,592344,21750,733992,705860,-28132
1972,81,592436,23850,734467,709560,-24907
1973,84,593482,24000,735667,711839,-23828
1974,81,593548,22050,736568,713790,-22778
1975,87,593649,27750,740618,715485,-25133
1976,89,593729,26050,742218,717439,-24779
1977,81,593783,26550,742288,718694,-23594
1978,85,594447,24500,744388,720194,-24194
1979,80,594465,20200,744018,721344,-22674
1980,82,594703,20300,685468,721612,36144
1981,90,594794,25650,685968,716260,30292
1982,81,594932,21150,686468,719510,33042
1983,82,595400,24350,687618,722490,34872
1984,86,595450,24550,673535,723894,50359
1985,89,595503,23800,688668,724712,36044
1986,90,595552,26550,688523,725044,36521
1987,88,595672,25100,689168,726050,36882
1988,87,596166,24600,689668,680669,-8999
1989,81,596670,24300,690523,681670,-8853
1990,85,597622,24050,690218,682428,-7790
1991,80,597906,22000,679285,683219,3934
1992,82,597948,19850,690818,684320,-6498
1993,81,598192,22050,691318,684719,-6599
1994,84,598355,18600,691073,685141,-5932
1996,85,598450,18950,691368,685628,-5740
1996,85,598450,19050,691968,686020,-5948
1997,83,598478,20350,691418,686341,-5077
1998,87,598934,25500,682906,687228,4322
1999,83,599197,19900,692123,687720,-4403
2000,90,599807,22050,692518,688741,-3777
2001,87,599866,22800,692018,688870,-3148
2003,80,600203,20750,692173,689741,-2432
2003,80,600203,21500,684734,689920,5186
2004,90,600897,25200,693173,690420,-2753
2005,83,601599,24400,693518,690115,-3403
2006,82,601952,27050,693723,691165,-2558
2007,88,602054,26900,686934,691578,4644
2009,85,602229,25650,693618,692578,-1040
2009,85,602229,22200,693668,692669,-999
2010,89,602582,24250,694223,693241,-982
2012,90,603403,23650,693918,693915,-3
2012,90,603403,28750,694418,694241,-177
2013,85,603984,22250,694773,694728,-45
2014,83,604388,22600,694918,694970,52
2015,88,604591,19700,695468,695719,251
2017,84,604766,25650,695773,696015,242
2017,84,604766,23050,696068,696769,701
2018,82,604854,23450,692937,697220,4283
2019,86,605129,24100,697118,697565,447
2020,84,605220,25800,696773,686304,-10469
2021,85,605262,22250,696823,697770,947
2022,88,605472,24200,693885,698291,4406
2023,83,605593,25750,694755,698565,3810
2024,90,605682,22950,697323,699115,1792
2025,90,605846,24750,695350,699615,4265
2026,85,606312,22700,696135,700070,3935
2027,80,606883,21550,697823,700570,2747
2028,87,607070,19650,698523,700715,2192
2029,83,607301,22150,699023,701265,2242
2030,88,607519,27800,700073,701728,1655
2031,83,607799,25750,700409,702415,2006
2033,89,608136,26400,700681,702728,2047
2033,89,608136,26450,701030,703219,2189
2035,82,608975,22400,701635,703791,2156
2035,82,608975,21600,702400,704291,1891
2038,88,609511,22550,702556,704969,2413
2040,86,609649,25050,704706,705165,459
2041,82,609665,23750,706084,705519,-565
2040,86,609649,22800,706855,706020,-835
2042,81,610430,20450,707050,706441,-609
2042,81,610430,27500,706956,706941,-15
2042,81,610430,22400,708284,692063,-16221
2043,81,610718,23400,709500,688654,-20846
2044,80,610846,19750,710434,688993,-21441
2045,86,611798,25000,711735,674924,-36811
2046,90,611922,24750,712335,688754,-23581
2047,83,612201,23950,713335,689254,-24081
2049,87,612530,25900,713356,689543,-23813
2049,87,612530,22300,713784,689854,-23930
2050,81,612911,21600,704402,680948,-23454
2051,89,613147,19750,704417,690043,-14374
2052,85,613870,22700,705150,690543,-14607
2054,84,614127,19600,706167,691043,-15124
2054,84,614127,22150,705567,685124,-20443
2055,90,614261,22950,706142,686124,-20018
2056,87,614666,27750,706383,687274,-19109
2057,80,614955,22450,706752,688153,-18599
2058,84,615836,24900,707350,689739,-17611
2059,80,615982,26500,707852,691648,-16204
2060,87,616394,21900,708450,692737,-15713
2063,81,617039,23300,708633,693689,-14944
2063,81,617039,23200,709602,694508,-15094
2064,90,618562,22000,709867,695898,-13969
2065,90,618684,23400,711150,697236,-13914
2065,90,618684,25150,711667,698236,-13431
2068,90,618859,22750,712283,700008,-12275
2069,86,620183,21300,712642,701586,-11056
2069,86,620183,24300,712167,703358,-8809
2069,86,620183,22650,713333,705486,-7847
2071,86,620792,22500,713267,706536,-6731
2075,84,622402,21400,715484,707608,-7876
2075,84,622402,26850,715731,709636,-6095
2075,84,622402,24250,716566,710508,-6058
2076,85,622436,22250,718795,712108,-6687
2076,85,622436,24800,720384,713258,-7126
2076,85,622436,27100,720466,714186,-6280
2078,82,623229,23250,720695,715336,-5359
2079,86,624418,23450,722116,717386,-4730
2079,86,624418,23150,723981,717608,-6373
2080,87,624758,27750,725595,718108,-7487
2081,83,624758,24400,725631,719486,-6145
2082,90,625166,23400,727466,719708,-7758
2083,80,625812,22000,728786,720208,-8578
2084,81,625963,22500,729166,720486,-8680
2085,82,626611,18500,730986,720358,-10628
2086,89,626908,25150,731781,720458,-11323
2087,86,628291,21850,734481,721008,-13473
2088,87,628346,26400,734884,721163,-13721
2089,87,628413,21450,735086,721756,-13330
2090,89,628903,20650,736116,721236,-14880
2091,87,629183,21450,737384,721786,-15598
2092,90,629510,23400,738831,718403,-20428
2093,86,629661,25450,739431,721758,-17673
2094,82,630010,21650,742445,722286,-20159
2095,85,630037,24950,742945,722458,-20487
2096,82,630291,23450,745545,722386,-23159
2097,80,630350,21100,745634,722203,-23431
2098,88,630482,27350,746184,723253,-22931
2099,82,631026,21200,748566,723998,-24568
2100,83,631047,23050,748384,724587,-23797
2101,83,631676,24850,749781,725524,-24257
2102,81,632415,20250,752495,726503,-25992
2103,90,632509,27900,752316,726837,-25479
2104,86,632728,26350,752431,727574,-24857
2105,88,633612,24650,737483,728553,-8930
2106,80,633853,21100,740591,729924,-10667
2107,89,633861,26050,740533,730937,-9596
2108,85,633984,20000,741641,731587,-10054
2109,81,634264,22950,742887,732739,-10148
2110,89,634265,23350,742511,733624,-8887
2112,90,634638,30400,741092,734398,-6694
2112,90,634638,24250,741602,734898,-6704
2113,80,634657,21550,742202,735224,-6978
2114,86,634741,22300,743217,721194,-22023
2115,84,634878,24450,744156,726264,-17892
2118,82,635054,21700,743902,726537,-17365
2118,82,635054,21900,745206,726596,-18610
2118,82,635054,23350,745342,726690,-18652
2119,81,635337,19350,746442,726814,-19628
2120,89,635438,22450,746756,729243,-17513
2121,82,636025,27050,748856,730243,-18613
2122,83,636122,19000,748956,727190,-21766
2123,88,636275,25550,751006,726746,-24260
2124,90,636304,27000,751192,727241,-23951
2125,83,636538,20350,751942,727314,-24628
2126,85,636655,24950,752883,722127,-30756
2127,83,636968,21250,753852,727587,-26265
2129,83,637100,25250,754267,727290,-26977
2129,83,637100,25250,755439,727746,-27693
2130,83,637541,18100,757830,727790,-30040
2131,85,638768,21350,764289,727414,-36875
2132,84,638854,23550,765330,701128,-64202
2133,86,639201,23650,768230,728087,-40143
2135,84,639683,24800,776180,728241,-47939
2135,84,639683,23050,776680,727796,-48884
2136,81,640300,22050,779897,728587,-51310
2138,80,640331,23300,779885,728964,-50921
2139,82,640421,22900,780038,729464,-50574
2139,82,640421,22050,780320,729687,-50633
2140,81,641155,22050,786020,730341,-55679
2141,81,641279,22050,787587,730841,-56746
2142,85,641449,20450,789087,731164,-57923
2143,90,642070,22950,793287,731337,-61950
2144,83,642663,23050,797687,731714,-65973
2145,88,642773,26450,798787,732091,-66696
2146,88,643052,21950,800820,732814,-68006
2147,82,643518,20300,803720,733090,-70630
2148,80,644528,23350,808937,733437,-75500
2149,88,645244,24650,811987,734196,-77791
2151,81,645824,22550,818821,736596,-82225
2151,81,645824,22900,818943,737828,-81115
2152,83,646024,22600,822920,740028,-82892
2153,87,646097,22350,823470,741896,-81574
2155,80,646236,23050,824987,744946,-80041
2155,80,646236,20600,824820,746978,-77842
2156,86,647178,21850,755142,748628,-6514
2158,87,647643,21850,701806,750046,48240
2159,80,647686,24600,754867,752228,-2639
2159,80,647686,24650,755367,752646,-2721
2160,80,647895,22000,755004,747078,-7926
2161,84,648353,26700,754438,748163,-6275
2162,87,648521,27750,754971,749412,-5559
2163,83,648634,22150,754538,750512,-4026
2164,90,649177,25200,754588,752056,-2532
2165,82,649771,23450,755088,753561,-1527
2167,82,649906,24000,711874,754606,42732
2167,82,649906,23400,755638,755711,73
2168,88,650141,23300,755971,756863,892
2169,84,650663,24000,756658,758363,1705
2170,82,650961,23450,756671,759478,2807
2171,85,651034,27200,756238,761163,4925
2173,84,651140,23700,745567,762806,17239
2173,84,651140,20350,745258,763806,18548
2174,82,651488,24800,745808,765678,19870
2178,88,652655,23050,746308,766506,20198
2177,84,652607,23450,747367,767162,19795
2179,81,653182,20400,748358,768813,20455
2179,81,653182,25550,748858,770011,21153
2179,81,653182,21050,749017,771928,22911
2181,88,654008,27050,730012,773362,43350
2181,88,654008,27300,731319,774928,43609
2182,84,654299,23550,732419,775662,43243
2183,90,654755,25200,748908,776863,27955
2185,81,654829,23500,750067,777611,27544
2185,81,654829,24250,749517,778713,29196
2186,81,655025,21150,750458,779712,29254
2187,86,655683,23650,743563,781213,37650
2188,85,655822,22250,750167,782713,32546
2189,81,656098,23400,745763,783956,38193
2190,89,656338,22000,750217,784912,34695
2191,85,656365,19550,750717,785928,35211
2192,85,656596,21350,750508,787806,37298
2194,80,656864,23000,749113,788563,39450
2194,80,656864,24650,751008,790204,39196
2195,85,657072,20900,749371,791796,42425
2196,90,657446,23400,750787,793454,42667
2197,81,657568,25650,751141,795348,44207
2198,82,657575,25250,751937,797715,45778
2199,83,657828,21250,752537,798996,46459
2200,83,658013,24850,754483,800546,46063
2201,81,658071,23400,755013,802446,47433
2202,80,658232,22450,755741,803848,48107
2203,90,658339,28350,756063,805604,49541
2204,87,658828,23250,757521,807696,50175
2205,83,659014,24400,758021,809374,51353
2206,86,660429,24550,758521,811115,52594
2207,85,660684,24500,759387,813354,53967
2208,89,660742,26500,759033,816054,57021
2209,89,661298,25600,760937,817848,56911
2210,81,661340,24300,760591,819565,58974
2211,87,661794,21900,762333,821654,59321
2212,90,662001,24300,762791,823746,60955
2213,81,662007,21600,762571,825098,62527
2214,85,662028,21800,763263,826646,63383
2215,80,662383,21100,763941,827974,64033
2216,81,662454,22500,764621,829565,64944
2217,87,662510,19650,764787,830604,65817
2218,88,662933,25100,765287,832665,67378
2219,84,663041,22200,765787,834854,69067
2220,84,663325,23100,766041,784943,18902
2221,90,663579,27450,766641,787093,20452
2222,89,663875,22000,766837,788697,21860
2223,81,664012,23400,767813,790993,23180
2224,80,664222,23800,768071,792728,24657
2225,80,664310,24250,769071,793508,24437
2226,88,664588,23750,769241,794012,24771
2227,81,664919,21600,769863,795311,25448
2228,89,665279,26050,770937,795528,24591
2229,83,665322,23050,770433,796112,25679
2231,88,665558,21150,771483,796813,25330
2232,87,665621,21500,772013,793093,21080
2232,87,665621,24550,771641,795847,24206
2233,87,666305,24150,772191,798793,26602
2234,89,666651,24700,773191,800278,27087
2235,80,666924,20650,773741,800512,26771
2236,85,667206,23150,774121,800914,26793
2237,87,667619,23700,774737,784089,9352
2238,80,667652,23350,774733,787862,13129
2239,82,667917,23450,775341,792762,17421
2241,83,669217,25050,776237,795889,19652
2241,83,669217,20750,776483,800112,23629
2242,90,669591,24750,776983,804189,27206
2243,85,670160,24050,777613,805739,28126
2244,88,670490,23750,778271,809812,31541
2245,83,670859,23050,778821,813212,34391
2246,87,671240,21450,780541,816912,36371
2247,82,671353,21650,780821,819689,38868
2248,90,671457,20250,781283,823239,41956
2249,84,672849,23550,782337,826912,44575
2250,80,673241,17950,783813,828889,45076
2251,80,673384,19750,784641,832239,47598
2252,85,673492,21350,784963,835315,50352
2253,81,673776,20700,785613,836504,50891
2254,82,674253,26600,786687,837648,50961
2255,86,674495,24100,787821,838565,50744
2256,80,674682,19300,788871,839348,50477
2257,86,674893,24550,789521,840398,50877
2258,86,675033,23200,789937,840062,50125
2259,85,675380,20000,790771,840950,50179
2260,83,675548,24400,791263,841854,50591
2261,88,676094,23300,791987,843262,51275
2262,86,676258,23200,792283,845512,53229
2264,88,676878,24150,794213,769780,-24433
2265,87,676920,25100,794713,770830,-23883
2265,87,676920,24550,794641,771930,-22711
2266,88,677321,26000,795787,774480,-21307
2267,83,677412,25300,796183,775746,-20437
2268,89,677466,24700,796071,778630,-17441
2269,81,678124,19800,796787,779380,-17407
2270,89,678693,25150,797183,782046,-15137
2272,85,678920,23550,797621,783646,-13975
2272,85,678920,22200,784846,785246,400
2273,89,679128,18850,785396,787430,2034
2274,82,679303,23000,766131,788996,22865
2275,84,679368,22650,766195,791096,24901
2276,87,679689,17850,766795,792380,25585
2278,90,679788,22450,767231,793380,26149
2278,90,679788,23800,766845,795530,28685
2279,90,679915,23850,766866,796446,29580
2281,84,680319,25300,767366,797680,30314
2281,84,680319,22600,767636,798680,31044
2282,88,680809,27350,768336,799780,31444
2283,86,680822,25450,767866,800246,32380
2284,89,681049,19300,768802,801346,32544
2285,87,681409,25050,777134,803396,26262
2286,82,681464,20750,779152,804180,25028
2287,85,681540,24050,779934,805696,25762
2288,88,681639,26450,780952,806330,25378
2289,81,682791,24750,784002,807380,23378
2291,81,683123,19800,794202,808496,14294
2291,81,683123,26950,794902,810480,15578
2292,86,683210,21850,795984,811696,15712
2293,89,683301,22900,796484,813280,16796
2294,89,683865,24250,799902,813996,14094
2295,80,684214,21100,803902,815130,11228
2296,90,684548,27450,810902,816380,5478
2297,90,684592,25200,810684,818030,7346
2298,88,684786,21950,815034,819080,4046
2299,84,684930,23550,818184,820630,2446
2300,80,685149,19300,819884,821180,1296
2301,87,685834,19200,822002,821830,-172
2302,86,685903,22300,822834,823930,1096
2303,84,686212,20850,793521,824430,30909
2304,84,687194,23100,795221,809672,14451
2305,87,687592,21000,797446,811522,14076
2306,83,687835,23950,798708,814555,15847
2307,87,688393,28650,800321,817355,17034
2308,81,688918,22950,803571,818572,15001
2309,89,688976,29650,803908,821055,17147
2310,80,690087,26050,807521,822222,14701
2311,82,690205,21200,809658,824422,14764
2312,89,690411,27850,811508,826955,15447
2313,90,690621,26550,813146,829655,16509
2314,88,691093,26000,816296,830722,14426
2315,84,691154,24450,816508,831355,14847
2316,82,691675,23900,818558,832922,14364
2317,89,691931,26050,820108,834422,14314
2318,87,693703,24150,825321,835255,9934
2319,88,693703,26000,825296,836805,11509
2320,83,693831,23050,826946,838305,11359
2321,87,693942,22350,827058,839955,12897
2322,86,694858,26350,829208,842174,12966
2323,80,695325,24250,834221,842502,8281
2324,88,695420,25550,836246,843174,6928
2325,84,695470,22200,836471,843554,7083
2326,85,695523,20450,836796,843615,6819
2327,81,696990,23850,839508,844224,4716
2328,87,697126,25950,840071,845048,4977
2329,87,697723,26850,843958,845952,1994
2330,87,697903,22350,846658,846452,-206
2331,86,697934,24100,847046,846952,-94
2332,82,698043,23450,847608,847424,-184
2333,87,698713,26400,849721,847565,-2156
2334,81,699233,21150,854408,847848,-6560
2335,81,699289,27000,856321,848052,-8269
2336,81,699341,21600,856908,848552,-8356
2337,89,699567,25600,858796,849574,-9222
2338,83,699735,23050,859721,850454,-9267
2339,81,700129,19350,863621,850898,-12723
2340,87,700211,21900,863858,851152,-12706
2341,86,700328,20500,864346,852104,-12242
2342,88,700650,21050,865008,852604,-12404
2343,81,701506,25200,812121,853148,41027
2344,90,701641,24300,812741,853824,41083
2345,80,701832,23800,813241,854648,41407
2346,87,701837,25050,813137,854874,41737
2347,83,702123,25300,813741,855424,41683
2348,89,702600,23350,814171,855974,41803
2349,84,702738,24900,814235,856304,42069
2350,90,703005,26550,814637,856752,42115
2351,84,704385,23100,818729,857574,38845
2352,83,704435,19900,820396,858224,37828
2353,82,704476,24350,821996,859065,37069
2354,81,704593,22500,824096,859648,35552
2355,90,704690,24300,824596,860148,35552
2356,90,705118,25200,830596,860798,30202
2357,84,705188,25800,830729,861502,30773
2358,88,705634,23300,838246,861715,23469
2359,84,705661,24900,839246,862054,22808
2360,84,705810,23100,839879,862602,22723
2361,82,706493,22100,843329,863174,19845
2362,83,706764,23500,845346,863598,18252
2363,84,706830,23550,846579,864148,17569
2364,82,707143,23000,850146,864902,14756
2365,89,707147,26050,850096,865004,14908
2366,86,707327,26350,850646,865952,15306
2367,80,707778,20650,853079,866315,13236
2368,86,708007,23200,855246,866604,11358
2369,80,708052,22000,855579,867104,11525
2370,80,708284,24700,856396,867602,11206
2371,82,708412,22100,857446,868024,10578
2372,82,708697,17600,857879,868348,10469
2373,81,708736,22950,857696,869115,11419
2374,81,708943,23850,859429,869702,10273
2375,86,709028,23200,859396,870665,11269
2376,81,709748,25650,860629,870974,10345
2377,84,710070,24900,864446,871498,7052
2378,89,710253,22900,866129,871902,5773
2379,89,710335,27850,867496,872854,5358
2380,86,710336,20500,866996,873274,6278
2381,81,710464,20250,868546,873748,5202
2382,80,711244,22000,870708,874398,3690
2384,87,711367,21750,871523,874552,3029
2384,87,711367,25450,871523,875504,3981
2385,84,711570,24900,872023,876004,3981
2386,86,712568,24100,872808,876604,3796
2387,87,712709,25950,873596,877104,3508
2388,84,712952,23550,874408,877615,3207
2389,82,712968,23000,875008,877702,2694
2390,84,713065,22650,875146,878165,3019
2392,84,713250,22250,875646,878648,3002
2392,84,713250,22600,876158,879252,3094
2393,89,713289,21550,876146,879952,3806
2394,87,713588,21450,872879,880452,7573
2395,89,713663,23350,873446,881204,7758
2396,85,714237,24500,874546,882052,7506
2397,87,714352,26400,874629,882498,7869
2398,81,714581,24300,875975,883254,7279
2399,89,714784,26050,876708,883598,6890
2400,84,715171,25800,877208,883974,6766
2401,81,715203,19800,877258,884474,7216
2402,83,715566,20800,877196,842722,-34474
2403,83,716016,22150,877529,843322,-34207
2404,90,716328,23400,878346,844922,-33424
2405,88,717053,26000,878466,846391,-32075
2406,82,717116,21650,836865,847491,10626
2407,81,717326,24300,837415,849212,11797
2408,85,717501,21800,837880,850912,13032
2409,87,718542,24600,838786,851512,12726
2410,82,718988,18950,839565,852112,12547
2411,80,719577,20200,842215,852812,10597
2413,82,719671,23600,843665,853462,9797
2414,88,719671,24350,843627,854941,11314
2414,88,719671,25950,843365,857041,13676
2415,83,719767,24850,844130,857712,13582
2416,90,719814,27450,844415,860191,15776
2417,89,720164,24250,845817,860791,14974
2418,81,720526,20700,847649,861891,14242
2419,80,720676,19300,848243,862941,14698
2420,83,721010,23500,849467,864462,14995
2421,86,721617,20050,850659,865241,14582
2422,80,721943,20650,851265,865912,14647
2423,85,722186,23600,852859,867612,14753
2424,89,722442,21550,853965,869212,15247
2425,85,722588,25850,854267,870541,16274
2426,81,722598,23400,854409,871212,16803
2427,81,722720,20700,820971,872641,51670
2428,84,722890,24900,820885,873462,52577
2429,80,722890,24250,821435,874012,52577
2430,88,722899,25100,821463,874941,53478
2431,90,722997,26100,821471,875941,54470
2432,84,723557,23550,821139,876991,55852
2433,84,723649,24450,821639,877612,55973
2434,84,723735,23550,821193,878112,56919
2435,90,725002,25200,821935,879612,57677
2436,87,725057,22800,821693,880641,58948
2437,80,725173,25150,819298,881191,61893
2438,86,726075,20500,819453,881262,61809
2439,82,726255,25700,821603,882741,61138
2440,82,726321,23900,822203,883241,61038
2441,89,727281,26500,823948,883912,59964
2442,86,727394,22750,823998,884491,60493
2443,84,727515,24450,824703,884804,60101
2444,82,728235,15800,825303,884500,59197
2446,87,728460,27350,825698,884952,59254
2446,87,728460,22300,825853,885065,59212
2447,87,728994,23250,826748,885304,58556
2448,80,729166,24700,827203,885565,58362
2449,87,730089,25500,828369,885804,57435
2450,82,730293,21650,829419,886150,56731
2451,89,731224,25150,835174,886354,51180
2452,81,731275,22950,836069,886452,50383
2453,83,731345,21250,838769,886724,47955
2454,87,731409,24600,838919,885962,47043
2455,84,731504,23100,840374,885691,45317
2456,88,731623,22850,840974,886691,45717
2457,88,731966,27800,843319,887241,43922
2458,83,732254,20800,847319,887741,40422
2459,86,732395,20050,849369,888291,38922
2460,87,732430,24600,849674,888865,39191
2461,80,732861,25150,853169,888954,35785
2462,88,732890,23750,853669,888712,35043
2463,82,733809,22100,857824,846722,-11102
2464,82,733936,24350,859119,846905,-12214
2465,84,734015,24000,860774,847905,-12869
2466,89,734235,26050,866274,848955,-17319
2467,85,734374,21350,867469,848722,-18747
2468,85,734672,25850,870569,849505,-21064
2469,80,734984,21550,877369,850322,-27047
2470,89,735017,27400,877869,851922,-25947
2471,81,735228,21150,880669,852572,-28097
2472,89,735293,27400,881624,853672,-27952
2473,88,735321,21950,881869,854555,-27314
2474,86,735750,21850,883619,854922,-28697
2475,86,736536,20500,887374,855655,-31719
2476,81,736693,21600,887669,856566,-31103
2477,83,736838,20350,890869,860290,-30579
2478,87,736955,22800,891369,862890,-28479
2479,85,737330,25400,891374,867166,-24208
2480,86,737768,22300,847936,868916,20980
2482,81,737871,22700,848586,872890,24304
2482,81,737871,22000,848715,875916,27201
2483,85,737921,21350,849165,877866,28701
2484,83,738397,24850,849765,880516,30751
2485,83,738568,26200,850315,883440,33125
2486,87,739222,25950,851436,888016,36580
2488,87,739311,27400,851415,889940,38525
2488,87,739311,26350,851932,892816,40884
2489,87,739628,22350,852515,895490,42975
2490,90,739798,29700,853704,899466,45762
2491,82,739911,23450,854835,901490,46655
2492,85,740021,23150,856885,902816,45931
2493,82,740193,20750,858161,904666,46505
2494,90,740225,26100,858435,908866,50431
2495,81,740659,22500,860311,911666,51355
2496,81,740758,23400,860032,915016,54984
2497,85,740920,26750,860304,917766,57462
2498,89,741314,23350,856598,920840,64242
2499,88,741725,26450,857703,923748,66045
2500,82,742483,25250,858748,925199,66451
2501,86,742567,21400,858453,925398,66945
2502,90,742676,29250,859298,926848,67550
2503,89,743213,26500,859653,927947,68294
2504,80,743230,22900,860153,929497,69344
2505,87,743507,25050,861948,931147,69199
2506,81,743541,19350,862303,931798,69495
2508,84,743688,26400,863353,926640,63287
2508,84,743688,22600,863148,930666,67518
2509,87,744017,23700,864503,932898,68395
2510,84,745010,20850,865708,933897,68189
2511,86,745122,24100,865821,937866,72045
2512,84,745164,21300,866223,938340,72117
2513,81,745169,19800,864996,879505,14509
2514,83,745263,21700,866321,879555,13234
2516,88,745364,23700,866558,880605,14047
2516,88,745364,26850,866096,881155,15059
2517,84,745995,25350,867021,882272,15251
2518,82,746008,25700,867146,883322,16176
2519,81,746430,25650,867408,883855,16447
2520,83,746495,22150,867558,884422,16864
2521,90,746672,26100,867796,885105,17309
2522,87,747462,26850,868008,885705,17697
2523,85,747973,24500,871605,886205,14600
2524,90,748017,26100,871234,886854,15620
2525,86,748082,21850,873655,887354,13699
2526,82,748083,23000,872105,887724,15619
2527,85,748186,21800,873155,887815,14660
2528,87,748406,22800,876384,887904,11520
2529,90,748496,24300,876855,888404,11549
2530,87,748764,23250,877484,888052,10568
2531,83,748948,25300,877505,888255,10750
2532,84,749050,22200,873982,887922,13940
2533,87,749385,25500,875304,888072,12768
2534,88,750635,23750,876537,888172,11635
2535,82,750963,18950,877611,889256,11645
2536,82,751789,24800,878625,888915,10290
2537,84,752141,23100,879775,858254,-21521
2538,85,753120,20000,881511,859843,-21668
2539,81,753221,19350,882011,862993,-19018
2540,90,754281,27900,883475,866954,-16521
2541,81,754996,21600,884587,868004,-16583
2542,89,755639,24700,885587,870543,-15044
2543,84,756525,26250,885804,873804,-12000
2544,90,757061,24750,886325,874757,-11568
2545,87,757678,24600,887137,875847,-11290
2546,89,758902,25150,887304,876498,-10806
2547,82,759513,24800,888825,877607,-11218
2548,89,759554,24250,888687,878757,-9930
2550,80,760372,22500,889804,879397,-10407
2550,80,760372,21500,889582,880247,-9335
2551,85,760583,21350,889561,881007,-8554
2552,81,762079,19800,878745,881507,2762
2553,86,762099,20500,878299,881948,3649
2554,90,762602,27900,879867,883297,3430
2555,88,762765,21500,879999,884447,4448
2556,86,763132,24550,882345,885148,2803
2557,86,763270,24550,883665,886148,2483
2559,85,763313,25250,884117,886907,2790
2559,85,763313,24900,883959,887648,3689
2560,87,763758,26850,887159,888547,1388
2561,88,763764,23300,887165,889347,2182
2562,85,763861,21800,887245,889957,2712
2563,87,764692,23250,887817,890547,2730
2564,90,765003,25650,889099,891398,2299
2565,89,765080,25150,889345,892247,2902
2566,87,765671,22350,889945,892947,3002
2567,88,765864,22400,891467,892998,1531
2568,85,766056,24050,893099,893947,848
2569,89,766056,23800,893067,894057,990
2570,85,766147,25850,893567,894548,981
2571,81,766410,20250,894495,894998,503
2572,88,766477,22850,894799,895498,699
2573,89,766840,27400,896456,895807,-649
2574,80,767666,21550,908195,896597,-11598
2575,83,767693,23050,908556,897407,-11149
2576,84,767701,23100,908745,897797,-10948
2577,86,767867,23650,909795,898347,-11448
2578,82,768241,22100,913445,898748,-14697
2579,81,768812,21150,916595,899047,-17548
2580,80,769736,17950,922006,899297,-22709
2581,80,769795,20200,924345,899697,-24648
2582,83,769875,25300,925906,900197,-25709
2583,86,770105,23650,927206,900948,-26258
2584,81,770298,20250,928395,901048,-27347
2585,83,770776,22600,932356,901498,-30858
2586,84,771272,19500,932906,902047,-30859
2587,90,771283,23400,933456,902598,-30858
2588,88,771896,24650,907417,903398,-4019
2589,85,772561,24050,907673,903997,-3676
2590,86,773383,23650,909023,904548,-4475
2591,87,773389,22800,909523,904897,-4626
2592,90,774422,25650,913029,905897,-7132
2593,89,774571,24250,913373,906298,-7075
2594,81,774649,24300,914129,906747,-7382
2595,89,774684,23800,915129,907348,-7781
2596,83,774700,23500,913923,907547,-6376
2597,89,774950,27400,916123,907898,-8225
2598,81,775415,25650,920479,908407,-12072
2599,80,775433,23350,919429,908948,-10481
2600,88,775557,23300,921523,909797,-11726
2601,81,775989,18000,922179,910048,-12131
2602,83,776566,23950,923473,910598,-12875
2603,85,777220,23600,924523,911198,-13325
2604,81,777794,20250,926673,911598,-15075
2605,89,778121,25150,888462,912557,24095
2606,82,778576,23000,890383,913547,23164
2607,90,778914,21150,892971,914698,21727
2608,80,779085,23800,895674,915797,20123
2609,85,779227,22700,896724,916947,20223
2610,89,779298,21100,898121,917557,19436
2611,88,779499,26000,899324,917748,18424
2612,83,780195,25300,901424,918447,17023
2613,80,780413,22450,901771,919207,17436
2614,90,780692,24300,903771,919548,15777
2615,84,780956,25800,904271,920448,16177
2616,84,781354,23550,905524,921247,15723
2617,89,782629,25150,908621,922007,13386
2618,83,782647,23950,908374,923248,14874
2620,85,782917,20950,911321,923447,12126
2620,85,782917,24450,911724,913165,1441
2621,80,783246,26500,914374,914815,441
2622,84,783293,25350,915249,915915,666
2623,90,783365,25200,915397,917345,1948
2624,90,783650,27450,915897,918565,2668
2625,83,784179,17200,916109,919124,3015
2626,81,784557,20250,916609,920177,3568
2627,80,784557,21100,916249,921324,5075
2628,84,785319,26250,916997,922995,5998
2629,90,785539,24300,917497,924474,6977
2630,82,786081,21200,917917,925695,7778
2631,84,787184,19500,917547,926974,9427
2632,89,787532,19750,918297,928015,9718
2633,84,787611,25800,918367,929115,10748
2634,85,788801,25850,918609,931345,12736
2635,82,788975,22100,918867,932945,14078
2636,80,789457,23800,919367,934627,15260
2637,84,789587,25800,919517,936045,16528
2638,88,789907,23300,919867,937124,17257
2639,89,790266,21100,920097,938724,18627
2640,90,791135,27000,920417,939915,19498
2641,83,791164,22150,920597,940932,20335
2642,89,791680,25600,920759,942477,21718
2643,80,791914,23800,915974,943824,27850
2644,84,792156,22650,916974,945324,28350
2646,80,792718,25200,919521,946674,27153
2646,80,792718,21050,919021,948127,29106
2647,86,792959,25000,919274,949232,29958
2649,84,793789,23800,920021,950315,30294
2649,84,793789,21700,919374,950382,31008
2650,86,794012,26350,921521,935152,13631
2651,82,794282,25250,922461,936152,13691
2652,81,794344,20250,922124,937448,15324
2653,83,795410,21700,922647,938057,15410
2654,86,796472,23200,923119,938802,15683
2655,88,796530,24650,923449,939707,16258
2656,80,796564,21100,924011,940049,16038
2657,82,796773,20750,924017,941099,17082
2658,86,796852,22750,924056,941797,17741
2659,86,797136,23650,925786,942897,17111
2661,86,797267,23750,926206,943397,17191
2661,86,797267,22700,926286,944147,17861
2662,86,797595,22300,926911,945002,18091
2663,85,798167,24500,927886,945797,17911
2665,80,798702,22500,929852,946498,16646
2665,80,798702,21500,929541,946897,17356
2666,86,799115,28600,930286,936704,6418
2667,82,799166,22100,930656,939340,8684
2668,86,799812,20050,931702,941140,9438
2669,81,800242,19800,932641,943169,10528
2670,88,800890,22850,935006,944169,9163
2671,83,800959,22600,934752,945319,10567
2672,86,801207,26350,935886,947102,11216
2673,83,801292,20350,936056,947650,11594
2674,82,801750,19850,936556,947557,11001
2676,90,802220,23900,937802,948102,10300
2676,90,802220,22900,938086,948707,10621
2677,85,803347,24950,939352,938854,-498
2678,86,804006,23200,941106,939493,-1613
2679,81,804061,21600,940911,940104,-807
2680,82,804820,18050,942656,940143,-2513
2681,84,804910,23550,943156,942583,-573
2682,84,804917,24000,943286,944383,1097
2683,86,805630,21850,944411,945663,1252
2684,84,805798,18600,945852,947413,1561
2686,80,805992,22650,946561,949983,3422
2687,86,806096,19300,947061,951277,4216
2687,86,806096,22250,947561,951976,4415
2688,80,806236,22900,948306,952765,4459
2689,81,806440,22050,948802,953865,5063
2690,80,806817,21100,949711,954332,4621
2692,81,807135,22700,951911,954795,2884
2692,81,807135,21550,952391,950713,-1678
2693,89,807234,23350,952991,951783,-1208
2694,82,807282,25250,953186,953383,197
2695,85,807495,21800,954061,955313,1252
2696,82,807953,21200,954836,956513,1677
2697,90,808552,22950,955556,957713,2157
2699,82,808970,22850,957161,958213,1052
2699,82,808970,22500,957191,958683,1492
2700,81,810998,23850,959291,960763,1472
2701,83,811034,23950,959602,961333,1731
2702,87,811229,22350,959791,951147,-8644
2703,80,811959,24250,962506,947893,-14613
2704,89,812023,27400,962341,866680,-95661
2705,83,812332,20800,963036,948201,-14835
2706,82,812716,19400,964086,948202,-15884
2707,81,812929,19350,964441,948157,-16284
2708,88,813080,25100,964506,873033,-91473
2709,85,813114,22250,964811,948202,-16609
2710,89,813163,24700,964541,948701,-15840
2711,84,813408,22650,925232,948702,23470
2712,88,813628,22400,925704,948252,22548
2713,87,813774,25950,925837,879610,-46227
2714,81,814235,22050,926411,948354,21943
2715,80,814370,25600,927037,884910,-42127
2716,81,814583,20250,927587,886710,-40877
2717,88,814734,26900,928482,948443,19961
2718,88,814824,24200,928587,892260,-36327
2719,87,816603,24600,929561,895660,-33901
2720,89,816883,26500,929677,899060,-30617
2721,88,817287,24200,930227,901123,-29104
2722,81,818097,23400,930777,948792,18015
2723,82,818585,22550,932454,948804,16350
2725,85,818672,25600,932637,948919,16282
2725,85,818672,19500,932861,913660,-19201
2727,80,818940,21900,932954,948854,15900
2727,80,818940,21950,932482,949201,16719
2728,82,820142,24800,920589,922060,1471
2729,89,820153,24250,920964,924673,3709
2730,90,820440,24750,921789,927810,6021
2732,85,820865,22700,924621,929873,5252
2732,85,820865,23100,925639,932573,6934
2733,83,820926,19900,927197,934473,7276
2735,83,821237,21350,929057,936723,7666
2735,83,821237,24800,930307,940523,10216
2736,88,821312,21500,930457,943323,12866
2738,88,821844,20150,934898,945610,10712
2738,88,821844,23700,938256,949373,11117
2740,83,821993,26200,939898,951496,11598
2741,80,822100,22600,939406,952697,13291
2741,80,822100,19250,940456,953747,13291
2742,82,822159,22100,940598,954608,14010
2743,85,822521,24500,945098,955946,10848
2745,81,822706,23950,946856,957358,10502
2745,81,822706,23800,947506,958800,11294
2746,85,823013,23600,950156,959358,9202
2748,90,823693,23150,952756,956610,3854
2750,86,824084,23400,954956,959173,4217
2750,86,824084,19300,958756,960050,1294
2750,86,824084,23100,960256,960796,540
2837,82,854272,23500,959756,961647,1891
2838,89,855216,20800,960998,962008,1010
2839,85,855218,23950,962156,962523,367
2838,89,855216,23250,962798,965573,2775
2839,85,855218,22700,963806,966610,2804
2838,89,855216,25600,964948,932533,-32415
2839,85,855218,25100,965448,934230,-31218
2957,83,891194,23450,966698,935683,-31015
3013,88,906694,24700,967948,936883,-31065
3014,90,906742,21250,969498,936933,-32565
3013,88,906694,17550,969456,937530,-31926
3013,88,906694,22600,972298,938033,-34265
3016,87,907609,27050,972948,938530,-34418
3016,87,907609,23000,973506,939033,-34473
3017,85,907920,24150,974556,939533,-35023
3017,85,907920,20750,976956,939730,-37226
3019,89,908500,25800,978056,940780,-37276
3019,89,908500,24700,980298,941633,-38665
3020,88,908948,19950,981406,942233,-39173
3020,88,908948,21850,981898,943430,-38468
3021,87,909327,27300,983754,943980,-39774
3021,87,909327,19800,984286,944583,-39703
3022,83,909495,26150,984508,945130,-39378
3024,85,910423,23050,985543,945630,-39913
3025,81,910661,26800,985454,945680,-39774
3026,87,910831,20950,985913,946730,-39183
3030,82,911284,24800,986058,947333,-38725
3031,85,911364,21600,986608,947380,-39228
3031,85,911364,24650,987013,948030,-38983
3030,82,911284,22100,987158,926872,-60286
3032,81,911449,25750,987636,948383,-39253
3033,90,911546,21350,988663,948883,-39780
3036,80,912487,19350,989693,950280,-39413
3038,86,912866,30200,989663,951483,-38180
3038,86,912866,22500,989554,952380,-37174
3038,86,912866,23300,990158,952283,-37875
3038,86,912866,23900,989793,952930,-36863
3039,88,913295,23750,991336,953530,-37806
3040,90,913478,21700,991258,954580,-36678
3042,86,913697,20650,991313,954934,-36379
3045,83,914162,25200,991604,955127,-36477
3057,81,920358,27100,992808,955395,-37413
3057,81,920358,22200,993254,955484,-37770
3058,83,920378,22750,984806,955627,-29179
3057,81,920358,24400,985906,956127,-29779
3058,83,920378,22050,986156,956376,-29780
3058,83,920378,22950,989456,956465,-32991
3057,81,920358,23650,988306,956584,-31722
3058,83,920378,25650,990448,956777,-33671
3058,83,920378,22950,991598,956995,-34603
3057,81,920358,21600,993748,957277,-36471
3059,88,921094,25950,994298,957465,-36833
3059,88,921094,25550,994798,959108,-35690
3059,88,921094,26250,996398,961358,-35040
3059,88,921094,18900,998056,962197,-35859
3059,88,921094,26500,999706,962697,-37009
3059,88,921094,21950,999748,963375,-36373
3060,85,921180,18950,999698,964150,-35548
3060,85,921180,17900,941442,964858,23416
3059,88,921094,16700,942578,965646,23068
3061,82,921184,24000,945695,967025,21330
3062,83,921216,17600,946142,967700,21558
3059,88,921094,22900,947057,968775,21718
3061,82,921184,22650,948198,969347,21149
3061,82,921184,25200,951478,970146,18668
3059,88,921094,25600,952348,971250,18902
3059,88,921094,21650,952057,971475,19418
3062,83,921216,23550,953107,972496,19389
3059,88,921094,21800,956498,973196,16698
3062,83,921216,24050,959142,974050,14908
3060,85,921180,23700,959057,975050,15993
3059,88,921094,26800,960328,975847,15519
3059,88,921094,19800,960892,976346,15454
3062,83,921216,20500,961028,977200,16172
3059,88,921094,24200,961307,977800,16493
3061,82,921184,22500,962528,978297,15769
3062,83,921216,21150,963557,978850,15293
3062,83,921216,23650,965792,980125,14333
3059,88,921094,26300,966292,981400,15108
3059,88,921094,22550,968557,982197,13640
3061,82,921184,23000,969378,983000,13622
3062,83,921216,24850,971195,983600,12405
3062,83,921216,23950,971942,984525,12583
3061,82,921184,22700,974042,985500,11458
3061,82,921184,22050,974542,985825,11283
3062,83,921216,23850,975507,986550,11043
3060,85,921180,20750,976795,987100,10305
3061,82,921184,22350,979779,988150,8371
3062,83,921216,19450,979751,988997,9246
3063,86,921664,23850,983166,990125,6959
3063,86,921664,21250,984697,990300,5603
3063,86,921664,26150,985071,991275,6204
3063,86,921664,23900,985347,992397,7050
3063,86,921664,24550,985821,993197,7376
3063,86,921664,25200,987264,994258,6994
3063,86,921664,22300,987378,995047,7669
3063,86,921664,22900,988995,995958,6963
3063,86,921664,27050,990442,997125,6683
3064,84,922311,25900,991595,998197,6602
3064,84,922311,29600,994078,999546,5468
3064,84,922311,24900,994448,999850,5402
3065,90,922388,24600,995778,987041,-8737
3065,90,922388,27250,998307,988541,-9766
3065,90,922388,24850,998857,988963,-9894
3065,90,922388,22100,999992,963215,-36777
3064,84,922311,20750,999942,963645,-36297
3066,82,922440,19250,999957,964077,-35880
3066,82,922440,16550,988179,964084,-24095
3065,90,922388,13250,990201,964577,-25624
3066,82,922440,16300,992851,964676,-28175
3067,85,922923,18650,995051,964745,-30306
3067,85,922923,15750,999851,964530,-35321
3068,88,922993,20600,999479,966325,-33154
3067,85,922923,18400,999801,968680,-31121
3067,85,922923,14450,975052,970330,-4722
3069,81,923161,8850,975311,971975,-3336
3067,85,922923,12550,975486,973371,-2115
3067,85,922923,12850,975591,974922,-669
3068,88,922993,16700,975658,976680,1022
3070,82,923182,13550,976158,979074,2916
3068,88,922993,16000,976536,981174,4638
3072,82,923315,15350,976858,982780,5922
3069,81,923161,14450,977141,983721,6580
3068,88,922993,16800,977358,985372,8014
3069,81,923161,19700,977561,987125,9564
3069,81,923161,16200,977711,987830,10119
3071,82,923272,21700,977752,989672,11920
3068,88,922993,19400,978043,991671,13628
3068,88,922993,19700,983645,993830,10185
3071,82,923272,15800,985123,995971,10848
3070,82,923182,18250,985471,997625,12154
3071,82,923272,19450,986043,999524,13481
3070,82,923182,16000,987571,999972,12401
3072,82,923315,17700,989795,988400,-1395
3069,81,923161,16450,992495,990191,-2304
3072,82,923315,21550,993423,991613,-1810
3071,82,923272,23300,996595,992778,-3817
3074,89,923408,22950,998645,993763,-4882
3071,82,923272,24200,999671,995102,-4569
3069,81,923161,17400,999921,996528,-3393
3074,89,923408,21750,999821,998178,-1643
3072,82,923315,24000,976007,999910,23903
3074,89,923408,23050,976607,999991,23384
3072,82,923315,22850,977157,965083,-12074
3070,82,923182,22550,978193,965965,-12228
3073,90,923331,25250,978236,966133,-12103
3070,82,923182,23950,978302,966665,-11637
3071,82,923272,23650,978693,967133,-11560
3072,82,923315,26550,981301,967215,-14086
3076,84,923594,24750,985638,991233,5595
3073,90,923331,26900,988488,993983,5495
3071,82,923272,23450,993338,996450,3112
3071,82,923272,22850,999601,999683,82
3073,90,923331,22400,999838,968526,-31312
3075,88,923561,22200,999501,968367,-31134
3074,89,923408,24100,999188,968867,-30321
3074,89,923408,17750,983608,968877,-14731
3073,90,923331,18800,985908,968233,-17675
3074,89,923408,15850,986008,968415,-17593
3074,89,923408,16550,987017,968833,-18184
3073,90,923331,20300,988058,969076,-18982
3076,84,923594,18050,998378,969345,-29033
3074,89,923408,12500,999893,969383,-30510
3075,88,923561,13800,999943,962330,-37613
3074,89,923408,12100,999993,962783,-37210
3075,88,923561,16850,993858,964960,-28898
3076,84,923594,13600,994417,967110,-27307
3076,84,923594,15400,994008,968560,-25448
3075,88,923561,15650,994917,971304,-23613
3076,84,923594,15450,994658,974504,-20154
3077,81,924088,14900,996017,977853,-18164
3077,81,924088,17600,996517,982704,-13813
3077,81,924088,14900,997614,987253,-10361
3077,81,924088,16600,997599,989903,-7696
3077,81,924088,19400,998021,993053,-4968
3077,81,924088,16700,998289,997703,-586
3078,85,924245,14200,998166,999954,1788
3077,81,924088,20250,998664,978058,-20606
3077,81,924088,16200,998789,979486,-19303
3078,85,924245,18250,999516,981208,-18308
3077,81,924088,13850,999339,982236,-17103
3078,85,924245,16200,999721,983436,-16285
3078,85,924245,17450,999889,985536,-14353
3077,81,924088,17650,999939,986308,-13631
3078,85,924245,13950,999989,988386,-11603
3078,85,924245,17000,982907,990386,7479
3078,85,924245,19300,929053,991808,62755
3078,85,924245,17650,982647,992508,9861
3077,81,924088,17650,983197,993008,9811
3077,81,924088,13050,982697,993508,10811
3077,81,924088,13400,983407,993886,10479
3078,85,924245,15250,983297,994658,11361
3079,88,924349,21200,983797,995564,11767
3077,81,924088,15000,983457,999864,16407
3079,88,924349,17850,983957,999753,15796
3079,88,924349,13350,984107,957475,-26632
3078,85,924245,17350,984347,996158,11811
3078,85,924245,12800,984157,996208,12051
3077,81,924088,15150,941755,958742,16987
3079,88,924349,13600,951245,959242,7997
3077,81,924088,21400,956295,996708,40413
3079,88,924349,24200,956795,997036,40241
3079,88,924349,19350,957955,996808,38853
3079,88,924349,15550,964305,997308,33003
3079,88,924349,18950,964089,959792,-4297
3077,81,924088,23050,965455,997686,32231
3079,88,924349,16550,972005,960675,-11330
3077,81,924088,18400,973739,997508,23769
3078,85,924245,18450,979489,997558,18069
3077,81,924088,19200,982739,998236,15497
3078,85,924245,17300,987933,998558,10625
3078,85,924245,16750,988455,962392,-26063
3079,88,924349,20100,994705,998736,4031
3078,85,924245,16450,999955,999258,-697
3078,85,924245,14650,999783,999758,-25
3079,88,924349,11150,999905,960342,-39563
3078,85,924245,10400,999889,958142,-41747
3079,88,924349,12000,973708,961225,-12483
3078,85,924245,11750,975458,960892,-14566
3077,81,924088,19000,976558,961392,-15166
3078,85,924245,17350,976058,958642,-17416
3079,88,924349,10900,977608,960175,-17433
3077,81,924088,15350,980408,959075,-21333
3079,88,924349,12000,980508,961275,-19233
3078,85,924245,14100,980745,961892,-18853
3078,85,924245,16200,981745,962942,-18803
3079,88,924349,14850,982345,963925,-18420
3079,88,924349,16700,982958,964642,-18316
3078,85,924245,23650,984145,965742,-18403
3078,85,924245,21300,985195,967225,-17970
3079,88,924349,25000,986658,969342,-17316
3079,88,924349,25600,988858,971892,-16966
3078,85,924245,20500,989695,973442,-16253
3079,88,924349,22850,991795,973725,-18070
3079,88,924349,19000,993345,974492,-18853
3079,88,924349,25500,994458,975325,-19133
3078,85,924245,25900,997495,976475,-21020
3078,85,924245,20850,998545,977075,-21470
3078,85,924245,22300,999908,977692,-22216
3079,88,924349,23800,999958,978075,-21883
3078,85,924245,18600,975219,978625,3406
3078,85,924245,17450,977362,979625,2263
3079,88,924349,20850,980919,981275,356
3079,88,924349,21600,984962,981775,-3187
3078,85,924245,21850,986219,982819,-3400
3078,85,924245,17450,988469,985147,-3322
3079,88,924349,17750,997219,988369,-8850
3079,88,924349,18850,997719,991047,-6672
3080,87,924665,19600,998512,993569,-4943
3080,87,924665,25850,998612,997219,-1393
3080,87,924665,18900,999919,999619,-300
3079,88,924349,14250,999419,987442,-11977
3080,87,924665,16850,951766,988375,36609
3079,88,924349,14900,952600,988492,35892
3080,87,924665,14750,952966,989542,36576
3080,87,924665,15800,955362,990075,34713
3080,87,924665,14750,956500,991142,34642
3079,88,924349,12200,958100,992292,34192
3080,87,924665,14850,959836,992842,33006
3080,87,924665,12700,962350,993392,31042
3080,87,924665,16550,962850,994392,31542
3080,87,924665,16800,965636,994375,28739
3080,87,924665,17150,968100,995425,27325
3080,87,924665,17300,968612,995525,26913
3080,87,924665,12700,970836,995992,25156
3080,87,924665,16150,972466,996325,23859
3080,87,924665,15700,973900,996692,22792
3080,87,924665,16850,976962,997192,20230
3080,87,924665,17950,978012,997242,19230
3080,87,924665,15100,980062,998442,18380
3080,87,924665,15500,982550,999375,16825
3080,87,924665,12650,983550,999875,16325
3080,87,924665,11750,984816,999975,15159
3080,87,924665,15500,986800,992345,5545
3080,87,924665,14050,989600,995768,6168
3080,87,924665,13850,992112,998395,6283
3080,87,924665,14400,993786,999968,6182
3080,87,924665,15800,994150,961373,-32777
3080,87,924665,12950,996486,961973,-34513
3080,87,924665,14900,999300,962439,-36861
3080,87,924665,14400,999962,962989,-36973
3080,87,924665,11450,999636,963639,-35997
3080,87,924665,14300,999912,964239,-35673
3080,87,924665,10100,999566,964739,-34827
3080,87,924665,5450,999017,965559,-33458
3080,87,924665,6150,999517,966609,-32908
3080,87,924665,5100,971086,967173,-3913
3080,87,924665,7850,970917,967939,-2978
3080,87,924665,6050,973067,969130,-3937
3080,87,924665,8150,974679,970409,-4270
3080,87,924665,9250,976586,971623,-4963
3080,87,924665,4500,976286,971739,-4547
3080,87,924665,7100,979536,966632,-12904
3081,84,925733,10000,981279,968682,-12597
3081,84,925733,7600,981286,970312,-10974
3081,84,925733,6750,984117,971921,-12196
3081,84,925733,5250,985336,973071,-12265
3081,84,925733,9050,985167,974401,-10766
3081,84,925733,6000,987036,975551,-11485
3081,84,925733,5550,987486,976662,-10824
3081,84,925733,7150,988286,978251,-10035
3081,84,925733,18200,991086,980021,-11065
3081,84,925733,16050,990917,981512,-9405
3081,84,925733,16600,992417,982882,-9535
3081,84,925733,12650,993529,983982,-9547
3081,84,925733,13900,994967,975954,-19013
3081,84,925733,16750,999279,976454,-22825
3081,84,925733,15150,999117,977808,-21309
3081,84,925733,9550,999779,979858,-19921
3082,86,925966,7250,999786,981278,-18508
3081,84,925733,7800,999967,982108,-17859
3081,84,925733,8100,999929,983208,-16721
3081,84,925733,6300,985303,984467,-836
3081,84,925733,7050,993703,985858,-7845
3081,84,925733,6850,995048,986858,-8190
3081,84,925733,7200,994903,988004,-6899
3081,84,925733,5050,999853,989154,-10699
3081,84,925733,2550,999098,990158,-8940
3081,84,925733,1400,998548,991704,-6844
3082,86,925966,1700,999903,992458,-7445
3081,84,925733,100,999953,993778,-6175
3081,84,925733,50,935953,995454,59501
3081,84,925733,50,936003,996167,60164
3081,84,925733,50,936019,998208,62189
3082,86,925966,500,936503,999858,63355
3081,84,925733,500,936519,999954,63435
3083,85,926032,50,936101,999971,63870
3081,84,925733,50,936111,999912,63801
3083,85,926032,50,936151,988193,52042
3082,86,925966,50,936161,989193,53032
3082,86,925966,1150,937861,990330,52469
3082,86,925966,10500,942211,991027,48816
3083,85,926032,10550,946864,992080,45216
3084,84,926085,7800,946914,992893,45979
3085,87,926245,11850,947508,994080,46572
3086,90,926278,8700,947408,994727,47319
3087,84,926435,8450,950276,995580,45304
3088,80,926441,8650,950674,996059,45385
3089,88,926463,7800,950124,997159,47035
3090,86,926535,9400,950174,998159,47985
3091,87,927332,9950,947558,998659,51101
3092,82,927429,9700,947964,999627,51663
3093,80,927683,6800,948058,999980,51922
3094,88,927990,10200,948514,975072,26558
3095,89,928296,8250,948253,975255,27002
3096,88,928358,7050,948769,969305,20536
3097,86,929030,8850,951269,975572,24303
3098,85,929261,9650,952251,975963,23712
3099,84,929718,10600,954769,978303,23534
3100,83,930020,7300,957313,980353,23040
3101,81,930153,10250,958953,981953,23000
3102,86,930229,8800,959453,983753,24300
3103,82,930606,9400,967324,986363,19039
3104,84,931119,17550,972074,988913,16839
3105,83,931451,16850,983613,990613,7000
3106,87,931467,13300,983713,991963,8250
3107,87,931575,15100,987174,993553,6379
3108,82,931614,15950,988974,996103,7129
3109,85,931636,17800,989113,998203,9090
3110,90,931837,15500,990963,998913,7950
3111,89,931915,16300,993163,999713,6550
3112,84,932233,11100,995974,976222,-19752
3113,89,932485,15400,998363,976272,-22091
3114,84,932798,13050,999974,971655,-28319
3116,86,932972,9250,999924,971272,-28652
3116,86,932972,7450,999874,971772,-28102
3117,85,933613,9050,987701,972155,-15546
3118,83,933662,11350,988103,972272,-15831
3119,81,933930,7550,990319,972655,-17664
3120,90,934101,8400,993869,972772,-21097
3121,85,934182,11100,994463,973155,-21308
3122,85,934308,9850,994353,972822,-21531
3123,82,934406,7750,994469,976322,-18147
3124,83,934502,9800,994519,976372,-18147
3125,87,934565,8450,954578,976855,22277
3126,82,935450,7050,964674,976872,12198
3127,84,935510,9350,966974,973322,6348
3128,87,935725,12450,971678,973755,2077
3129,87,935746,8600,972524,977355,4831
3130,90,936497,13600,979224,980472,1248
3131,83,936913,11600,984574,983705,-869
3132,85,937398,9750,993028,986322,-6706
3133,89,937415,12050,994124,988572,-5552
3134,87,937807,11450,997419,990805,-6614
3135,89,938015,10450,998469,993972,-4497
3136,85,938777,6300,999853,997205,-2648
3137,81,938865,2300,999963,999955,-8
3138,82,938930,2800,999519,983654,-15865
3139,86,939443,5050,997674,986221,-11453
3140,84,939518,6850,998578,987471,-11107
3141,85,939980,4800,999824,989904,-9920
3145,85,940759,1200,954786,992054,37268
3145,85,940759,2150,955363,993654,38291
3145,85,940759,3100,955204,995854,40650
3145,85,940759,2200,955279,997621,42342
3146,83,941270,8700,966162,999804,33642
3147,90,941312,13350,965583,999854,34271
3148,84,941402,9950,969433,996896,27463
3149,83,941463,6850,970533,999946,29413
3150,89,941641,8900,972662,971186,-1476
3151,82,942079,7300,977812,970717,-7095
3152,90,942229,13150,983812,970767,-13045
3153,88,942462,8800,987283,970817,-16466
3154,87,942640,12450,990983,970933,-20050
3155,88,943948,13300,998483,971317,-27166
3156,88,944191,6150,999912,969583,-30329
3282,84,983982,2750,984497,969230,-15267
3281,84,983954,3200,984547,969730,-14817
3283,80,984501,1900,984705,969633,-15072
3283,80,984501,1800,984800,969683,-15117
3283,80,984501,1800,984882,969733,-15149
3283,80,984501,3650,985333,970230,-15103
3284,86,984709,5800,985382,969783,-15599
3283,80,984501,7850,985383,969833,-15550
3284,86,984709,6650,985432,969883,-15549
3284,86,984709,6550,985433,969933,-15500
3285,83,984740,8250,985482,970433,-15049
3284,86,984709,10350,985483,970280,-15203
3285,83,984740,7850,985532,970780,-14752
3284,86,984709,6600,985533,970933,-14600
3285,83,984740,6700,985582,971228,-14354
3285,83,984740,7650,986033,971571,-14462
3287,82,985064,8600,985632,971677,-13955
3286,85,984877,12000,986132,971686,-14446
3286,85,984877,9850,986083,971728,-14355
3286,85,984877,9200,986133,971597,-14536
3286,85,984877,7100,986632,971621,-15011
3287,82,985064,12950,986633,972097,-14536
3287,82,985064,5750,987132,972121,-15011
3287,82,985064,8500,987133,972177,-14956
3287,82,985064,9650,987632,972546,-15086
3288,83,985787,10750,987633,971778,-15855
3288,83,985787,9350,988132,971828,-16304
3289,82,986445,9600,987683,971878,-15805
3289,82,986445,9200,987733,971928,-15805
3289,82,986445,8450,988233,972836,-15397
3289,82,986445,9600,988632,972886,-15746
3290,81,986793,7900,992678,973509,-19169
3291,85,986814,9450,994181,975559,-18622
3290,81,986793,11900,998778,978005,-20773
3290,81,986793,10700,999081,980155,-18926
3291,85,986814,11200,989682,982163,-7519
3290,81,986793,6900,989283,983355,-5928
3290,81,986793,8200,989783,985513,-4270
3292,85,987186,9150,990182,987613,-2569
3293,88,987308,9400,990283,989863,-420
3293,88,987308,8950,990232,991913,1681
3293,88,987308,10250,990732,993709,2977
3292,85,987186,6750,991504,994563,3059
3293,88,987308,8550,992054,973777,-18277
3292,85,987186,11950,997689,975330,-22359
3296,83,987774,11000,998238,980130,-18108
3294,80,987681,8650,999939,984780,-15159
3294,80,987681,4050,999731,988730,-11001
3294,80,987681,5950,999963,992346,-7617
3294,80,987681,500,991732,995563,3831
3294,80,987681,50,991533,997357,5824
3297,86,987879,50,991583,999513,7930
3294,80,987681,500,992083,999963,7880
3294,80,987681,500,992232,971380,-20852
3295,80,987702,500,992583,972697,-19886
3296,83,987774,50,992282,972736,-19546
3297,86,987879,50,992332,997096,4764
3298,88,988021,50,992382,999996,7614
3299,81,988021,50,992432,972777,-19655
3297,86,987879,500,992932,971433,-21499
3298,88,988021,500,993083,972786,-20297
3297,86,987879,500,993310,973277,-20033
3298,88,988021,50,992886,973578,-19308
3297,86,987879,500,993343,976443,-16900
3299,81,988021,500,993363,980004,-13359
3298,88,988021,500,993386,984904,-8482
3299,81,988021,500,993754,989443,-4311
3300,83,988383,50,993360,994843,1483
3300,83,988383,50,993393,999954,6561
3300,83,988383,50,993410,974178,-19232
3300,83,988383,500,993863,971817,-22046
3301,80,988845,50,993436,974247,-19189
3301,80,988845,500,993893,972035,-21858
3302,89,989320,50,993460,972317,-21143
3303,86,989449,500,993936,972535,-21401
3302,89,989320,50,992982,972817,-20165
3303,86,989449,50,993032,973035,-19997
3303,86,989449,50,993082,973817,-19265
3303,86,989449,50,993132,974685,-18447
3304,87,991326,500,993583,976477,-17106
3304,87,991326,5000,993632,978271,-15361
3304,87,991326,6650,993962,980038,-13924
3305,84,991964,8450,994564,981777,-12787
3305,84,991964,9150,999981,982671,-17310
3305,84,991964,5400,999481,980985,-18496
3305,84,991964,50,993943,987735,-6208
3305,84,991964,50,993986,988819,-5167
3305,84,991964,500,994443,981280,-13163
3306,86,993295,500,994083,984221,-9862
3306,86,993295,500,994132,985828,-8304
3306,86,993295,500,994464,987999,-6465
3306,86,993295,500,994486,990288,-4198
3307,81,993333,50,994354,992249,-2105
3307,81,993333,500,994854,993771,-1083
3307,81,993333,500,994863,995288,425
3306,86,993295,500,994943,997378,2435
3307,81,993333,50,994514,999538,5024
3306,86,993295,500,994986,999849,4863
3307,81,993333,500,995014,982983,-12031
3307,81,993333,500,995354,982880,-12474
3308,88,993409,500,995363,983380,-11983
3308,88,993409,500,995443,983033,-12410
3308,88,993409,500,995486,983083,-12403
3308,88,993409,50,995064,988130,-6934
3307,81,993333,500,995564,992837,-2727
3309,86,993416,50,995404,997437,2033
3309,86,993416,50,995413,999719,4306
3308,88,993409,50,995454,988833,-6621
3307,81,993333,500,995913,988883,-7030
3307,81,993333,500,995943,989380,-6563
3306,86,993295,500,995954,988933,-7021
3309,86,993416,500,995986,989433,-6553
3309,86,993416,500,996064,989880,-6184
3307,81,993333,500,996413,989933,-6480
3307,81,993333,500,996443,989930,-6513
3307,81,993333,500,996454,990430,-6024
3306,86,993295,50,996036,989983,-6053
3306,86,993295,50,996086,992783,-3303
3308,88,993409,50,996114,992830,-3284
3309,86,993416,500,996586,990483,-6103
3309,86,993416,50,996164,992833,-3331
3308,88,993409,500,996664,993330,-3334
3308,88,993409,1050,999608,990930,-8678
3308,88,993409,200,999764,997380,-2384
3309,86,993416,500,996954,997383,429
3306,86,993295,1050,999814,999880,66
