job_id,tasks_num_of_single_job,task_generation_time,total_time,complation_time,complation_time_ordered,shortened_completion_time
0,12,477,11000,6156,6156,0
1,100,1048,115000,8036,7595,441
3,31,1134,9000,9586,6166,3420
3,31,1134,25000,7645,12876,-5231
4,96,1328,98000,12626,11656,970
5,41,1503,30500,11656,12166,-510
6,80,1618,70000,13585,12346,1239
7,54,1937,52000,14585,12945,1640
8,51,2396,55500,17846,13556,4290
9,96,2676,103000,17126,18376,-1250
11,54,2929,45000,17986,17846,140
11,54,2929,46500,18626,18376,250
12,94,3209,102000,18886,19586,-700
13,13,3401,6500,17646,19846,-2200
14,13,3434,16500,18536,20346,-1810
15,29,3444,39500,23346,23876,-530
17,58,4533,37000,24126,23876,250
17,58,4533,73500,24046,24045,1
18,66,4566,73000,24036,23434,602
19,36,4726,38000,19906,21565,-1659
20,74,4904,77000,22906,23945,-1039
22,62,5476,22500,21836,23565,-1729
22,62,5476,60500,26356,45696,-19340
23,11,5946,15500,23985,46196,-22211
24,86,6547,78000,29406,47696,-18290
27,98,6999,33000,29126,48696,-19570
27,98,6999,18500,29856,50196,-20340
27,98,6999,98000,30036,51696,-21660
30,37,7573,63000,34346,53196,-18850
29,71,7513,90500,34985,55196,-20211
30,37,7573,43000,33656,57696,-24040
31,70,7968,70000,34085,59696,-25611
34,72,8565,15000,38085,60196,-22111
34,72,8565,69000,40485,61196,-20711
34,72,8565,80000,42196,63196,-21000
35,88,8575,79000,41106,64696,-23590
37,98,9116,17500,41585,65196,-23611
37,98,9116,98500,50585,69696,-19111
39,78,9284,42000,51196,71696,-20500
39,78,9284,88500,52696,72696,-20000
41,91,9569,59500,52585,75196,-22611
42,71,9594,95500,53696,74696,-21000
42,71,9594,70000,53585,76696,-23111
45,69,10365,29000,56085,79696,-23611
45,69,10365,28000,55585,79696,-24111
45,69,10365,53500,56696,80696,-24000
46,87,10545,83500,57346,83196,-25850
48,73,10904,37500,57626,84196,-26570
48,73,10904,61000,57126,86196,-29070
51,41,11393,17000,57145,90696,-33551
52,50,11422,79000,57336,91696,-34360
52,50,11422,50500,60756,91696,-30940
54,81,11679,54500,57836,93696,-35860
53,76,11627,83000,59706,94196,-34490
54,81,11679,95000,61336,92376,-31040
55,95,11871,117500,63336,96375,-33039
56,10,12070,10000,58516,96376,-37860
57,100,12237,85000,68356,99875,-31519
58,80,12324,65000,69206,102375,-33169
59,77,12594,63500,72336,104375,-32039
61,90,12692,8500,71706,98956,-27250
61,90,12692,84500,72836,106376,-33540
62,76,12918,73000,74206,109375,-35169
63,60,13483,50000,76336,111375,-35039
65,40,13762,52000,77336,111876,-34540
65,40,13762,39500,77706,112875,-35169
66,40,14177,20000,78206,113875,-35669
67,36,14967,33000,81706,115875,-34169
69,44,15206,32500,83336,116876,-33540
69,44,15206,46500,83836,118375,-34539
70,18,15769,24000,86336,118876,-32540
71,91,15824,85500,88206,121875,-33669
72,49,15984,39500,88836,122876,-34040
73,36,16518,28000,89336,84296,5040
74,88,16756,84000,91836,125875,-34039
75,34,16983,32000,92206,126876,-34670
78,24,17201,13500,90206,127376,-37170
78,24,17201,78500,92336,129876,-37540
78,24,17201,16000,92356,131376,-39020
80,24,17529,26000,128365,132376,-4011
81,79,17822,22000,129365,132876,-3511
81,79,17822,79000,130866,134375,-3509
83,90,18480,56000,134366,136875,-2509
83,90,18480,84500,137365,139375,-2010
85,72,18740,12000,133365,139875,-6510
86,16,18835,71000,140866,142876,-2010
87,95,19254,23000,140365,143375,-3010
88,88,19277,82500,147365,145876,1489
88,88,19277,88500,148366,156555,-8189
89,38,19316,34000,144365,158055,-13690
91,40,19776,13000,151365,158555,-7190
91,40,19776,54500,154365,158555,-4190
92,80,19885,75000,154865,162555,-7690
94,63,19932,54500,150366,163555,-13189
94,63,19932,66000,155365,166555,-11190
95,82,20012,81000,156865,168555,-11690
97,81,20136,34000,156366,169555,-13189
97,81,20136,110000,156365,170555,-14190
98,61,21268,65500,161366,172055,-10689
99,98,21390,89000,162366,174055,-11689
100,17,21404,13500,159865,174555,-14690
102,91,22384,23500,104826,176055,-71229
102,91,22384,115000,164866,178555,-13689
103,30,22808,15000,165366,179055,-13689
105,28,23493,6500,165866,180055,-14189
106,31,23730,24000,167866,180555,-12689
107,58,23757,50500,167366,108125,59241
107,58,23757,48500,168866,181555,-12689
108,72,24177,81000,169366,183555,-14189
109,16,24941,13000,169866,183555,-13689
111,75,25415,24000,174366,185055,-10689
111,75,25415,72000,175365,188055,-12690
112,86,25532,73000,176365,190055,-13690
113,60,26104,50000,176866,192055,-15189
114,50,26144,55000,177866,194055,-16189
115,86,26847,98000,182865,196055,-13190
116,38,26946,34000,183365,197055,-13690
117,74,27253,67000,184865,199555,-14690
118,55,27447,52500,183366,201055,-17689
119,40,27660,40000,185365,202055,-16690
120,95,27836,107500,186866,205555,-18689
121,25,28157,32500,186865,205555,-18690
122,50,28325,55000,188866,207555,-18689
123,54,28521,47000,190365,210055,-19690
124,53,28727,56500,190865,211555,-20690
125,25,28975,42500,190366,212055,-21689
126,84,29818,72000,193366,214555,-21189
127,15,30211,17500,193865,137265,56600
128,28,30461,34000,195366,215555,-20189
129,43,30960,56500,220945,215555,5390
130,49,31005,49500,224445,216555,7890
131,17,31097,8500,220945,217055,3890
132,65,31149,42500,225445,219055,6390
133,33,31613,26500,205366,219555,-14189
135,25,31642,87000,229945,221555,8390
135,25,31642,22000,226945,221555,5390
137,71,31970,38000,231445,223055,8390
137,71,31970,50000,233945,224055,9890
138,71,32220,75500,236945,237566,-621
139,56,32359,63000,239445,239566,-121
140,65,32382,82500,238445,240566,-2121
141,63,32482,66500,237945,242066,-4121
143,29,32606,17500,238945,243066,-4121
144,84,32688,24500,239945,243566,-3621
144,84,32688,101500,240445,245066,-4621
146,85,34006,52000,245445,247066,-1621
146,85,34006,67000,246445,248566,-2121
147,70,34076,70000,246945,249566,-2621
150,63,34618,5500,245445,250066,-4621
150,63,34618,13500,249945,251066,-1121
150,63,34618,55500,250445,252066,-1621
152,72,35045,34500,251445,253066,-1621
152,72,35045,60500,252445,254566,-2121
153,71,35563,65500,254445,257066,-2621
154,86,36044,108000,255445,257566,-2121
157,94,36526,6000,256945,258066,-1121
157,94,36526,21500,263445,258066,5379
157,94,36526,71000,266445,260566,5879
159,63,36772,48000,268445,261566,6879
160,78,36849,81500,265945,264066,1879
160,78,36849,98500,269445,266566,2879
162,59,36965,90000,269945,268566,1379
162,59,36965,64000,270945,269566,1379
165,91,37364,67000,272445,271066,1379
164,79,37343,74500,271945,274066,-2121
165,91,37364,90000,272945,275066,-2121
166,25,38004,27500,277945,275066,2879
168,29,38252,58500,280945,277066,3879
168,29,38252,34000,278445,279066,-621
169,96,38270,113000,282445,281566,879
170,74,38484,52000,282945,284066,-1121
171,61,38672,60500,285445,285066,379
174,72,38741,35000,283445,285055,-1610
174,72,38741,24500,285945,286066,-121
174,72,38741,90000,286445,288066,-1621
176,84,39359,30000,283445,288066,-4621
176,84,39359,96500,287445,290566,-3121
177,21,39803,25500,289945,291066,-1121
179,52,40127,26500,291445,292066,-621
179,52,40127,60500,290945,294566,-3621
180,11,40300,10500,289445,294566,-5121
181,88,40670,84000,294445,296566,-2121
182,26,40780,33000,294945,296566,-1621
184,47,41004,19500,179126,297566,-118440
184,47,41004,48000,297445,299566,-2121
186,85,41346,34000,300445,300566,-121
187,29,41418,77500,301445,303066,-1621
187,29,41418,24000,302445,303066,-621
188,60,41802,85000,303945,304066,-121
190,97,41960,42500,301945,305566,-3621
190,97,41960,123000,306445,308566,-2121
192,38,42183,110500,304945,310566,-5621
192,38,42183,43500,308945,312055,-3110
194,47,42581,94500,311945,314566,-2621
194,47,42581,48000,309445,315066,-5621
195,59,42758,54500,314445,317566,-3121
196,54,43050,62000,317945,318066,-121
197,89,43165,74500,319945,321566,-1621
198,40,43527,55000,322445,322566,-121
199,54,43591,47000,322945,324066,-1121
200,93,43595,116500,323445,327566,-4121
201,36,43997,28000,325445,328066,-2621
202,53,44247,41500,330945,330066,879
203,97,44386,78500,331445,333566,-2121
204,75,44557,57500,336445,336066,379
205,97,44767,83500,340445,342066,-1621
206,34,44831,47000,339945,343066,-3121
207,75,45018,102500,340945,345566,-4621
209,46,45654,15500,340945,346066,-5121
209,46,45654,42500,342945,348066,-5121
210,43,45758,46500,345445,349066,-3621
211,45,46140,22500,350945,351066,-121
212,33,46242,36500,351945,353066,-1121
213,87,46530,93500,359945,356566,3379
214,80,46624,75000,359945,358566,1379
215,79,46730,74500,362445,362066,379
217,50,46941,57500,359445,363566,-4121
217,50,46941,29500,365445,365566,-121
218,33,46961,41500,364445,366566,-2121
222,82,47197,25000,360445,367066,-6621
220,43,47102,41500,365945,368066,-2121
222,82,47197,15500,354945,257886,97059
222,82,47197,95000,367445,370566,-3121
223,42,47310,36000,368445,371566,-3121
224,54,47415,42000,369445,373066,-3621
225,23,47644,16500,368945,373566,-4621
227,54,48019,28000,370945,374566,-3621
227,54,48019,56500,371445,375566,-4121
228,23,48255,16500,373445,375566,-2121
229,37,48581,33500,372445,376566,-4121
230,78,48705,84000,375945,377566,-1621
231,39,48990,34500,376445,405746,-29301
232,29,50364,14500,378445,406746,-28301
233,89,50530,84500,382945,410245,-27300
235,62,50870,67500,380945,412745,-31800
236,69,50885,46000,384445,415245,-30800
237,90,51070,44500,385445,417245,-31800
237,90,51070,94500,387445,419246,-31801
238,86,51476,123000,389945,421745,-31800
240,45,51925,18000,390445,391066,-621
241,89,52361,42500,388445,422746,-34301
241,89,52361,84000,397945,425746,-27801
243,100,52522,23500,399945,426246,-26301
243,100,52522,114500,397445,428745,-31300
245,89,53048,13000,401445,429745,-28300
245,89,53048,84000,403945,432246,-28301
247,55,53270,15000,403945,404066,-121
248,35,53570,27500,406445,433746,-27301
248,35,53570,27000,405445,435245,-29800
249,27,53743,28500,405945,436245,-30300
250,54,54001,47000,408445,438745,-30300
252,76,54304,9500,407945,439745,-31800
252,76,54304,77500,410945,442245,-31300
254,84,54709,58500,417445,443245,-25800
254,84,54709,71500,418445,445245,-26800
258,49,55082,36500,414945,446246,-31301
256,21,55012,20500,299626,447245,-147619
258,49,55082,53500,415945,449745,-33800
258,49,55082,38500,420945,450745,-29800
260,49,55235,55000,422945,452246,-29301
260,49,55235,44000,416945,453745,-36800
262,68,55688,95000,428445,455246,-26801
262,68,55688,78500,427445,457746,-30301
263,50,55747,85000,426445,459245,-32800
264,71,55805,60500,427945,462245,-34300
265,46,56314,38000,431945,463245,-31300
266,49,56357,69500,432945,464246,-31301
267,50,56389,40000,430945,464746,-33801
268,94,56601,77000,435945,468246,-32301
270,52,57027,44000,437445,469246,-31801
270,52,57027,55500,437445,471246,-33801
271,21,57148,20500,312836,471746,-158910
272,22,57296,11000,438445,472246,-33801
273,19,57610,24500,439445,472746,-33301
275,10,58093,44500,442445,473745,-31300
277,54,58378,10000,323626,474245,-150619
278,74,58503,34500,441945,474745,-32800
278,74,58503,42000,446945,476746,-29801
278,74,58503,76000,446445,478746,-32301
280,59,58764,37500,448945,480245,-31300
280,59,58764,69000,445945,482245,-36300
282,21,58878,18500,443945,336696,107249
283,87,59300,25500,448945,482246,-33301
284,99,59409,78500,454945,485745,-30800
284,99,59409,99000,456445,489245,-32800
285,77,59597,83500,457445,491246,-33801
287,91,60330,17500,462445,491745,-29300
287,91,60330,70000,462945,494746,-31801
288,52,60436,31000,466445,496245,-29800
289,45,60893,52500,467445,497745,-30300
290,67,60981,88500,467945,499245,-31300
291,99,61030,104500,467945,500745,-32800
294,50,61566,55500,466945,501746,-34801
293,35,61553,37500,267335,502746,-235411
295,73,61655,45000,270335,504246,-233911
296,59,61675,66500,271336,507745,-236409
296,59,61675,59000,272336,509245,-236909
298,19,62167,97500,273336,510746,-237410
298,19,62167,14000,259215,511246,-252031
300,64,62755,11500,274836,511746,-236910
300,64,62755,66500,278836,512746,-233910
302,75,63265,49000,279336,513745,-234409
302,75,63265,67000,281336,515746,-234410
303,63,63691,61500,285336,517746,-232410
304,19,63856,9500,283335,518245,-234910
306,95,64233,80000,290836,521245,-230409
306,95,64233,87000,289336,523746,-234410
307,68,64521,49000,291336,524745,-233409
308,67,64643,73500,292336,526745,-234409
309,13,64769,6500,292836,527245,-234409
310,47,64894,43500,293836,528245,-234409
312,80,65589,43500,297336,529245,-231909
313,41,65598,75000,299336,532245,-232909
314,91,65700,35500,299835,533245,-233410
314,91,65700,80000,300335,537745,-237410
315,27,65920,33500,301835,538745,-236910
316,92,66108,86000,303835,540245,-236410
317,79,66326,89500,304335,542745,-238410
318,45,66496,47500,303836,544745,-240909
319,87,67107,83500,309836,547246,-237410
320,54,67371,57000,310835,549246,-238411
321,90,67439,75000,314835,552746,-237911
322,95,67530,92500,312335,556245,-243910
323,85,67782,72500,320836,558245,-237409
325,95,67894,60000,320835,559746,-238911
325,95,67894,97000,322835,563745,-240910
326,71,68089,75500,324336,565245,-240909
327,95,68249,117500,325336,569245,-243909
328,46,68308,23000,318826,569746,-250920
329,51,68489,45500,325836,570746,-244910
330,50,68496,45000,324835,572745,-247910
331,97,69456,93500,330836,575245,-244409
332,99,69586,109500,333335,577745,-244410
334,16,69811,18500,328836,578245,-249409
335,56,70333,13000,333336,578246,-244910
336,78,70505,58000,336336,580245,-243909
336,78,70505,103500,339335,581246,-241911
338,22,70752,34000,338835,582245,-243410
339,71,70831,21000,341336,583246,-241910
339,71,70831,70000,343835,586245,-242410
340,17,70890,23500,340336,586745,-246409
341,96,71007,78000,345336,589246,-243910
342,82,71295,81000,347336,590746,-243410
343,93,71567,71500,347836,593745,-245909
344,88,72879,79000,352215,595746,-243531
345,65,73281,82500,354326,597246,-242920
347,22,73820,18000,353836,597746,-243910
347,22,73820,15500,357715,598746,-241031
350,67,74011,70500,359215,600745,-241530
350,67,74011,38000,359326,601246,-241920
350,67,74011,72500,358826,604746,-245920
352,93,74345,17000,357215,605745,-248530
352,93,74345,96000,360326,607746,-247420
353,41,74967,40500,361826,608745,-246919
355,69,75494,24500,362836,608746,-245910
355,69,75494,64000,364335,611745,-247410
357,99,75853,22500,366836,612245,-245409
357,99,75853,109000,367836,615746,-247910
358,38,75958,49000,367715,616745,-249030
359,87,76356,113500,370326,618746,-248420
360,63,77039,56500,373826,620745,-246919
361,75,77374,72500,376715,622746,-246031
362,29,77730,19500,377715,623745,-246030
363,37,77959,43500,378326,624246,-245920
365,71,78615,84500,385215,626745,-241530
365,71,78615,70000,384215,628746,-244531
366,87,79078,78500,389326,630746,-241420
367,98,79412,89000,391326,632746,-241420
370,35,79767,28000,392826,633746,-240920
369,71,79657,65500,393826,635745,-241919
370,35,79767,42000,392215,636246,-244031
371,58,80067,54000,399715,636746,-237031
372,22,80209,21000,399835,637246,-237411
374,93,80244,24000,397335,638246,-240911
375,66,80305,121500,402326,640746,-238420
375,66,80305,62500,404326,642746,-238420
378,78,80581,28500,400336,643746,-243410
378,78,80581,12000,406715,644245,-237530
378,78,80581,83000,404336,646746,-242410
380,99,80916,27500,403836,648246,-244410
382,40,80966,74500,411715,651745,-240030
383,91,81068,72500,410326,654245,-243919
383,91,81068,65000,411826,654746,-242920
383,91,81068,114500,412715,657746,-245031
384,88,81585,84000,417715,661246,-243531
385,33,81600,41500,416336,662245,-245909
386,81,82007,90500,422326,664746,-242420
387,68,82020,74000,421326,666246,-244920
388,19,82072,34500,422715,666745,-244030
389,47,82303,63500,425326,667746,-242420
390,51,82544,55500,424215,669246,-245031
391,81,82569,65500,428215,672245,-244030
392,18,82570,24000,429215,672745,-243530
393,69,83088,79500,433336,673745,-240409
394,69,83088,79500,433835,674746,-240911
395,78,83130,99000,434335,677245,-242910
396,26,83207,18000,434826,677746,-242920
398,91,83382,10000,435715,678245,-242530
398,91,83382,80000,437715,681246,-243531
399,21,83661,20500,436836,681745,-244909
400,79,84006,104500,438715,683745,-245030
401,44,84690,37000,441215,684246,-243031
403,64,85218,16500,441826,684745,-242919
403,64,85218,56500,444835,686245,-241410
404,74,85346,77000,445215,687746,-242531
405,75,85850,87500,448835,690246,-241411
406,50,85906,50000,450336,691246,-240910
407,59,86238,39500,451215,692245,-241030
410,52,86629,26000,454836,692746,-237910
410,52,86629,14000,454336,693245,-238909
412,60,86909,60500,456335,694745,-238410
412,60,86909,23000,454335,695245,-240910
412,60,86909,44000,457335,695745,-238410
414,33,87403,86000,465835,696745,-230910
415,34,87464,41500,458336,697745,-239409
416,78,87567,27000,462836,698746,-235910
416,78,87567,53500,466336,701245,-234909
418,53,87615,28500,466835,702246,-235411
418,53,87615,31000,465335,703746,-238411
420,72,88499,13500,469215,704246,-235031
420,72,88499,85500,472215,706745,-234530
422,74,88573,22000,470335,707245,-236910
422,74,88573,76500,473826,708746,-234920
424,90,88728,37000,475335,710246,-234911
424,90,88728,74500,474335,712745,-238410
425,10,88931,5000,473336,476985,-3649
427,52,89241,11500,476336,477485,-1149
427,52,89241,50500,477836,713746,-235910
428,66,89506,78000,479826,715245,-235419
429,20,89646,20000,479835,715246,-235411
430,74,90015,82000,485336,717245,-231909
432,87,90146,10500,480215,718245,-238030
432,87,90146,83000,487826,720745,-232919
433,38,90184,34000,488326,721745,-233419
435,83,90372,41000,488215,722746,-234531
435,83,90372,111000,488715,724246,-235531
436,38,90697,39000,489715,725245,-235530
437,43,91091,56500,491326,726246,-234920
438,45,91231,52500,490715,726746,-236031
439,51,91666,50500,492835,729245,-236410
440,62,91988,46000,494835,730245,-235410
442,16,92575,68000,497715,731746,-234031
443,98,92826,28000,497835,732245,-234410
443,98,92826,73500,501336,734746,-233410
447,65,93122,9000,499826,735745,-235919
446,80,93091,48000,503335,737745,-234410
446,80,93091,74500,505335,740246,-234911
447,65,93122,52000,505336,743745,-238409
448,84,93799,102000,510835,746746,-235911
449,61,93852,70500,510215,748245,-238030
450,52,93958,36000,510715,750245,-239530
451,48,94266,59000,512715,751245,-238530
453,53,94806,17000,514835,751246,-236411
456,54,94956,46500,518836,753245,-234409
456,54,94956,31500,518835,753746,-234911
456,54,94956,21500,520836,755246,-234410
456,54,94956,55500,518715,756745,-238030
457,94,95218,82000,524336,759245,-234909
458,54,95309,42000,524835,761246,-236411
459,34,95468,42000,526835,761746,-234911
460,68,95530,74000,529335,763245,-233910
461,23,95680,11500,524326,532985,-8659
462,80,95688,75000,532335,766246,-233911
464,96,96173,8500,524715,534486,-9771
466,94,96215,73000,539835,768746,-228911
466,94,96215,69500,538335,772245,-233910
466,94,96215,86000,539336,774245,-234909
467,56,96425,68000,540336,775245,-234909
468,73,96595,91500,541835,777246,-235411
469,31,96906,15500,542835,778746,-235911
470,68,97337,59000,545835,781245,-235410
471,43,97449,56500,544836,782746,-237910
472,64,97868,57000,549336,785745,-236409
473,46,97931,43000,548335,786746,-238411
475,87,98387,31500,547335,787245,-239910
475,87,98387,128000,552835,788746,-235911
476,100,98503,115000,553836,792746,-238910
477,42,98558,41000,554336,793745,-239409
478,36,99281,23000,555336,794245,-238909
480,34,99728,11500,555335,794745,-239410
481,89,99758,42000,561835,795746,-233911
481,89,99758,89000,561335,799245,-237910
483,77,100229,69000,563835,802245,-238410
483,77,100229,63000,564335,803745,-239410
487,95,100694,6500,561215,571486,-10271
487,95,100694,58500,564836,805746,-240910
487,95,100694,14500,568336,806746,-238410
487,95,100694,106000,567336,809246,-241910
488,55,100962,57500,569835,810745,-240910
489,90,101151,100000,572336,813745,-241409
490,24,101179,27000,571335,814246,-242911
491,69,101422,59500,574836,816746,-241910
493,94,101834,7500,571835,817746,-245911
493,94,101834,111500,576336,820245,-243909
494,69,101843,69500,576835,821746,-244911
495,26,102095,33000,575835,822746,-246911
497,73,103355,13000,582836,823245,-240409
497,73,103355,66000,583836,825245,-241409
499,42,103581,48000,584336,826745,-242409
500,18,103683,46000,581336,828745,-247409
500,18,103683,13500,584835,594985,-10150
501,54,103846,47000,585835,829246,-243411
502,63,105287,56500,591335,831245,-239910
503,59,105304,74500,590836,833246,-242410
504,22,105626,16000,591336,834245,-242909
505,45,105959,27500,591836,836245,-244409
507,51,106548,28000,593835,837245,-243410
508,100,106867,50500,595335,838745,-243410
508,100,106867,104500,597835,841745,-243910
509,44,106911,52000,596836,843745,-246909
510,74,107503,82000,606335,845245,-238910
513,97,107769,55500,606835,847246,-240411
513,97,107769,63500,607335,849246,-241911
513,97,107769,97500,607835,851746,-243911
514,54,108827,72000,608835,854245,-245410
515,80,109906,65000,610336,857246,-246910
516,13,110012,6500,612336,857746,-245410
517,91,110369,70500,614836,860246,-245410
518,38,110443,19000,616336,861745,-245409
520,87,110678,30500,616335,862246,-245911
520,87,110678,68000,617835,865745,-247910
522,81,111287,101000,623336,866745,-243409
522,81,111287,85000,623835,867246,-243411
523,78,111588,124000,626836,595765,31071
524,79,112064,74500,631836,597765,34071
525,88,112260,69000,633835,600265,33570
526,25,112658,27500,633836,601016,32820
527,66,113195,63000,637336,602765,34571
528,60,113420,70000,636336,604516,31820
529,58,113795,49000,641835,605765,36070
532,40,114098,35500,642836,607016,35820
531,63,114071,81500,642835,608265,34570
532,40,114098,34500,642335,609516,32819
533,61,114692,85500,643835,611265,32570
534,54,114954,57000,645335,612516,32819
535,87,114963,113500,644335,613765,30570
536,98,115000,79000,645336,616516,28820
537,23,115313,16500,643826,617265,26561
538,23,115498,16500,647715,617516,30199
539,84,115566,72000,648215,619516,28699
540,36,115632,18000,649215,620265,28950
541,99,115668,94500,650326,622765,27561
543,87,115914,24500,652215,623516,28699
543,87,115914,98000,650715,625765,24950
544,64,115951,72000,652826,626765,26061
545,67,116044,83500,653826,629016,24810
546,80,116273,75000,653715,630765,22950
547,86,116787,83000,654715,632516,22199
548,94,117318,77000,653306,635016,18290
549,97,117709,103500,655805,636765,19040
550,63,117731,56500,656305,638765,17540
551,25,118207,12500,657805,639516,18289
552,80,118744,75000,659456,641265,18191
553,62,118827,46000,660956,643765,17191
555,69,119538,12500,664246,644265,19981
556,17,119566,49500,665746,645516,20230
556,17,119566,8000,668956,646016,22940
557,73,119711,66500,669246,648016,21230
559,61,119804,84000,671456,649765,21691
559,61,119804,50000,671956,650765,21191
560,83,120160,91500,676746,653016,23730
561,35,120193,37500,673456,655016,18440
562,89,120499,134500,677956,658265,19691
563,38,120562,29000,678746,659265,19481
564,46,120691,48000,679746,660516,19230
565,39,120724,29500,680246,662016,18230
566,96,120967,123000,681956,664016,17940
567,20,121431,20000,683456,664265,19191
568,90,121485,105000,684305,666265,18040
569,66,121605,68000,685805,668016,17789
571,53,122255,15000,684806,668516,16290
571,53,122255,46000,692246,670265,21981
572,93,122322,131500,691805,672016,19789
573,15,122648,12500,699746,673016,26730
574,54,122694,57000,698956,674016,24940
575,86,122736,113000,700956,676265,24691
576,45,122810,47500,700246,677516,22730
577,85,122942,72500,703305,680016,23289
579,79,123012,71500,703805,683516,20289
579,79,123012,69000,702305,686016,16289
582,82,123358,28500,703956,686516,17440
582,82,123358,32000,704806,687516,17290
582,82,123358,55000,705456,689516,15940
583,25,124241,32500,712305,690265,22040
585,66,124552,58500,715305,692265,23040
585,66,124552,67500,713806,693516,20290
586,85,124773,92500,719305,696016,23289
587,14,124853,17000,713805,582675,131130
589,21,124896,98000,719306,697765,21541
589,21,124896,20000,715246,698265,16981
591,59,125186,33500,721805,699765,22040
591,59,125186,54000,722305,701516,20789
592,46,125668,48000,724805,702765,22040
594,63,126017,19000,726806,704016,22790
594,63,126017,56000,726805,705265,21540
596,52,126413,21000,726305,706016,20289
596,52,126413,45500,727306,707016,20290
597,21,126861,25500,729305,708016,21289
598,97,126995,93500,732805,711016,21789
599,43,127116,26500,733805,711765,22040
600,81,127696,80500,735806,714516,21290
601,94,128192,102000,738306,715765,22541
602,35,128642,27500,740805,717765,23040
603,31,128702,20500,739806,718016,21790
604,38,129189,54000,743306,718765,24541
605,62,129499,51000,745805,720516,25289
606,15,129602,7500,741956,721016,20940
607,74,129748,72000,747805,723765,24040
608,91,129936,100500,748805,728765,20040
610,45,130171,10500,748305,729016,19289
610,45,130171,57000,749306,730016,19290
611,26,130330,28000,750806,730516,20290
614,95,131126,97000,754746,733265,21481
614,95,131126,17000,752805,733516,19289
614,95,131126,111500,755456,736516,18940
615,72,131209,81000,757456,737265,20191
616,63,131284,51500,757246,740016,17230
618,30,131631,10500,684975,688496,-3521
618,30,131631,24500,761456,740765,20691
619,45,131846,42500,760456,742016,18440
621,100,132023,91000,760956,744765,16191
621,100,132023,89500,760746,749016,11730
623,80,132431,17500,687975,697996,-10021
623,80,132431,89500,691475,751016,-59541
624,11,132797,15500,693975,751265,-57290
625,75,132846,72500,695975,754016,-58041
626,91,133002,110500,700475,756265,-55790
627,96,133346,98000,705975,759516,-53541
628,72,133375,66000,707475,761516,-54041
630,72,133640,10500,703475,762016,-58541
632,43,133702,61000,709975,763516,-53541
632,43,133702,12000,701475,764265,-62790
634,71,133812,46000,710475,764765,-54290
633,64,133770,47000,709475,767765,-58290
634,71,133812,75000,710475,769265,-58790
635,45,133860,52500,711475,770516,-59041
636,82,134548,76000,716975,773016,-56041
638,56,134771,65000,717475,774016,-56541
638,56,134771,42500,716975,776516,-59541
641,58,135077,36000,718975,777265,-58290
641,58,135077,26500,717475,778516,-61041
641,58,135077,43000,719975,780516,-60541
642,57,135500,58500,720975,782516,-61541
643,36,135517,43000,720475,783516,-63041
644,55,136462,62500,723975,784516,-60541
645,61,136707,55500,725975,785765,-59790
647,64,137049,24500,726475,786516,-60041
647,64,137049,71500,730475,788265,-57790
648,51,137178,50500,730975,789265,-58290
649,59,137223,44500,731475,792016,-60541
650,41,137569,40500,732975,793016,-60041
651,94,137921,97000,735475,796516,-61041
653,73,138256,8500,672316,797016,-124700
653,73,138256,91000,738975,799516,-60541
654,39,138440,39500,734475,800765,-66290
658,86,138943,68000,744975,801765,-56790
658,86,138943,85500,745975,802765,-56790
658,86,138943,60500,742975,806016,-63041
658,86,138943,101500,746975,807765,-60790
659,16,139236,28000,746475,749496,-3021
660,86,139516,98000,753475,811016,-57541
661,99,139568,74500,752975,815265,-62290
662,92,139947,101000,755475,816765,-61290
663,85,140046,82500,756475,820016,-63541
665,98,140729,22500,758975,820765,-61790
666,12,140800,89000,760475,822516,-62041
667,56,141224,16000,678626,822765,-144139
667,56,141224,62500,761975,824516,-62541
669,31,141712,10500,762475,825265,-62790
670,33,141775,40500,764975,825765,-60790
670,33,141775,41000,764475,827265,-62790
673,57,142170,17000,769975,827516,-57541
673,57,142170,93500,773475,829016,-55541
673,57,142170,77500,773475,831265,-57790
675,76,142369,47500,773975,832765,-58790
675,76,142369,97500,776975,834765,-57790
677,79,142555,28500,778475,835765,-57290
677,79,142555,79000,777475,836765,-59290
678,64,142694,72000,777975,838516,-60541
679,36,143998,28000,780975,839016,-58041
680,55,144194,47500,781975,839516,-57541
682,54,145469,17500,782475,777635,4840
682,54,145469,46500,785475,779996,5479
683,28,145748,14000,788475,780135,8340
685,66,146033,27000,789475,735664,53811
685,66,146033,77500,792475,782135,10340
687,55,146207,19500,794475,782496,11979
688,26,146268,62500,791475,783135,8340
688,26,146268,27500,794975,783996,10979
689,100,146302,110000,795975,786496,9479
691,11,146547,39500,794475,786635,7840
692,73,146733,5500,729446,786996,-57550
694,27,147104,66500,797975,789996,7979
693,32,147091,36000,800475,747165,53310
696,17,147454,28500,798475,790135,8340
695,40,147151,30000,800475,791135,9340
696,17,147454,18000,798975,791635,7340
697,68,147988,54000,805475,793996,11479
698,75,148063,92500,804975,794635,10340
699,74,148326,72000,809975,798135,11840
700,17,148372,23500,740946,798496,-57550
701,87,148765,58500,813475,801635,11840
702,74,148999,92000,815475,803135,12340
704,76,149442,63500,816975,804496,12479
704,76,149442,107500,817975,805635,12340
705,84,149519,77000,821475,808496,12979
706,96,149652,98000,822475,811496,10979
709,23,150446,31500,818975,812496,6479
709,23,150446,6000,821975,812996,8979
709,23,150446,10500,822975,813496,9479
710,36,151388,33000,828475,814496,13979
711,85,151444,77500,829975,817135,12840
712,75,151525,62500,830975,819635,11340
713,51,151971,60500,831475,821635,9840
714,76,152056,73000,832475,823635,8840
715,67,152594,53500,836975,825496,11479
716,95,152709,97500,839475,827635,11840
717,37,153188,23500,840475,828635,11840
720,67,154205,24000,839975,828996,10979
719,78,154148,64000,844475,830635,13840
720,67,154205,53000,845475,832996,12479
721,36,154954,48000,845975,834135,11840
723,77,155286,10500,769316,834496,-65180
723,77,155286,93000,853975,836135,17840
725,97,155508,51000,855475,837635,17840
725,97,155508,78000,856975,841135,15840
726,85,155823,57500,861975,843635,18340
727,71,155864,50500,864475,845996,18479
729,100,156074,67000,866975,846635,20340
729,100,156074,84500,868475,850135,18340
730,33,156239,21500,867475,850635,16840
731,99,156332,89500,870975,854496,16479
733,87,156457,81500,872475,856635,15840
733,87,156457,93000,872975,859135,13840
734,14,156547,22000,868975,859496,9479
735,15,156649,7500,869975,859996,9979
736,42,157104,31000,877475,861135,16340
737,43,157313,36500,878475,862135,16340
738,87,157340,73500,879475,863635,15840
740,98,158080,10000,802816,863996,-61180
740,98,158080,83500,884975,867496,17479
741,99,158163,109500,883475,870635,12840
742,90,158477,100000,886975,873135,13840
743,88,158868,84000,889975,875996,13979
744,12,158994,11000,889475,876135,13340
747,35,159577,76000,892475,877635,14840
746,74,159485,77000,892975,880135,12840
747,35,159577,27000,892975,880996,11979
748,32,160412,36000,894475,882135,12340
749,82,160678,91000,895975,884635,11340
750,13,160973,6500,897475,826175,71300
751,87,161320,103500,904475,887635,16840
752,44,161477,37000,903975,888996,14979
754,65,161623,69500,906975,891135,15840
754,65,161623,42000,906475,893635,12840
755,91,162143,95500,909975,896496,13479
756,49,162152,49500,909975,897135,12840
758,72,162977,30500,915475,897996,17479
758,72,162977,80500,914475,899996,14479
759,72,163003,101000,915975,902135,13840
760,69,163154,79500,916975,903135,13840
762,63,163495,70500,918475,904135,14340
762,63,163495,61000,919475,905635,13840
763,49,164237,49500,919975,905996,13979
764,63,164698,51500,923475,907996,15479
766,34,165013,34000,923975,908635,15340
766,34,165013,31500,924975,910496,14479
767,58,165265,64000,926975,913135,13840
769,83,165665,21500,929975,913635,16340
769,83,165665,91000,932475,917135,15340
771,78,165865,104000,935475,919635,15840
771,78,165865,78500,935975,921135,14840
772,95,166072,102500,938975,923135,15840
774,65,166226,20500,939475,924135,15340
775,88,166415,72500,940475,926996,13479
775,88,166415,108500,940975,928996,11979
776,50,166529,30000,938975,930496,8479
777,23,166615,26500,940975,931135,9840
778,40,167227,35000,944975,932496,12479
779,66,167294,93000,945475,935135,10340
780,62,167468,66000,945975,936635,9340
781,89,167663,84500,949975,938996,10979
783,14,167713,23500,948975,902165,46810
783,14,167713,6500,950475,876416,74059
784,53,168087,41500,954975,939996,14979
785,68,168533,84000,956475,941135,15340
787,66,168639,57500,961475,943135,18340
787,66,168639,67500,958475,944635,13840
789,65,168997,30000,962475,945496,16979
791,19,169297,67500,962475,946635,15840
790,23,169106,16500,961975,912165,49810
792,45,170056,19500,960975,946996,13979
792,45,170056,42000,883316,948635,-65319
793,48,170442,54000,885816,949996,-64180
794,70,170570,70000,887816,951496,-63680
795,47,170589,43500,887446,952135,-64689
796,76,170681,68000,889316,923664,-34348
798,61,170967,70500,888446,925164,-36718
798,61,170967,50000,888946,927165,-38219
799,56,170970,58000,891446,927665,-36219
800,86,171420,108000,893816,930664,-36848
801,97,171540,113500,894816,932665,-37849
802,27,171664,23500,894446,934164,-39718
803,96,172521,103000,903946,936164,-32218
804,94,172529,92000,904316,938664,-34348
806,54,172907,42000,905446,941664,-36218
806,54,172907,36500,909816,942165,-32349
807,78,172946,74000,910446,943165,-32719
808,57,173086,68500,908316,944664,-36348
809,76,173386,78000,915316,947664,-32348
810,62,173435,61000,917946,949164,-31218
811,69,173561,74500,917816,952165,-34349
812,95,173580,72500,920446,955164,-34718
813,72,173658,66000,920946,957164,-36218
814,96,174008,83000,923946,959664,-35718
815,19,174196,9500,923446,960164,-36718
816,69,174427,54500,925316,962665,-37349
817,46,174538,53000,927816,964665,-36849
818,15,174824,7500,925946,965664,-39718
820,99,175088,50500,933316,966165,-32849
820,99,175088,109000,935946,969665,-33719
821,37,175306,18500,936946,971164,-34218
822,64,175321,87000,931816,974664,-42848
823,59,175554,59500,937946,975664,-37718
825,21,175664,15500,934316,976165,-41849
825,21,175664,25000,932446,976664,-44218
826,35,176041,47500,940446,977164,-36718
827,45,176204,37500,940946,977665,-36719
828,27,176461,28500,941816,979164,-37348
829,84,176762,112000,942446,982164,-39718
830,53,176903,31500,943446,984164,-40718
831,76,176904,73000,943816,985164,-41348
832,15,177158,7500,936126,985165,-49039
834,77,177739,23000,943946,950916,-6970
834,77,177739,75500,945316,986665,-41349
835,19,177884,14500,938626,987165,-48539
837,49,178678,17000,947816,988164,-40348
837,49,178678,66500,950446,990165,-39719
838,79,178898,76500,952946,992664,-39718
839,87,178965,79000,953446,994165,-40719
840,36,179093,30000,954816,995165,-40349
841,47,179368,38000,954316,996164,-41848
842,55,179718,58500,956816,998165,-41349
844,69,180498,31500,960816,999664,-38848
844,69,180498,54000,963946,999665,-35719
846,80,180738,28000,965316,964916,400
846,80,180738,66500,964816,966675,-1859
848,68,181109,22500,961946,967175,-5229
848,68,181109,77000,966446,968675,-2229
849,61,181547,53000,969316,970175,-859
850,87,181984,92000,972946,972175,771
851,33,182024,39000,970946,973416,-2470
853,78,182347,57500,970816,974175,-3359
853,78,182347,57500,974446,976416,-1970
854,10,183130,9500,972966,976916,-3950
855,95,183246,90000,979316,979416,-100
857,55,183429,33000,980316,980916,-600
857,55,183429,59500,979946,982675,-2729
858,11,183593,15000,971126,982916,-11790
859,51,183824,57500,981316,983416,-2100
860,86,184125,93500,981946,986416,-4470
861,18,184224,8500,982446,986675,-4229
862,76,185045,89000,988816,988416,400
863,60,185270,72500,989816,989416,400
866,22,185486,25500,989446,989916,-470
867,61,185625,39000,991316,991175,141
868,42,185781,13000,990816,991675,-859
867,61,185625,62000,992946,993175,-229
869,30,185996,43000,994946,993916,1030
870,35,186147,34500,997816,994675,3141
870,35,186147,30000,998446,995175,3271
872,82,186608,43500,999446,996916,2530
873,63,186670,79000,999946,999675,271
873,63,186670,57000,999816,999916,-100
874,73,187035,54500,999466,994306,5160
876,68,187128,70500,998626,996306,2320
876,68,187128,82500,998966,997806,1160
878,35,187410,21000,999126,998806,320
882,68,187854,17000,999626,999806,-180
880,86,187583,44500,999966,999806,160
882,68,187854,74000,909055,863676,45379
882,68,187854,23500,908554,864176,44378
883,79,189215,38500,908054,866176,41878
883,79,189215,92000,911555,868176,43379
885,57,189993,26000,912555,870176,42379
890,60,190645,38500,919054,871676,47378
889,100,190567,42000,922555,873676,48879
893,46,191019,96000,930554,877676,52878
892,81,190766,27000,920554,878676,41878
891,81,190744,83500,933554,880676,52878
892,81,190766,56500,934555,882676,51879
893,46,191019,72000,935054,886176,48878
894,64,191020,79500,937054,888676,48378
897,78,191271,52500,938555,890176,48379
901,86,192001,35000,940054,892176,47878
900,44,191832,51000,935055,893676,41379
901,86,192001,26000,939554,894676,44878
901,86,192001,55000,942555,897176,45379
903,56,192273,41000,944055,898176,45879
905,95,192738,79500,945054,900176,44878
902,74,192165,72000,948055,901176,46879
903,56,192273,72500,951054,904176,46878
902,74,192165,71000,952555,905676,46879
910,72,193750,38000,953054,907676,45378
911,31,194618,27500,946554,770096,176458
913,65,194764,88000,957055,910176,46879
916,100,195043,100000,957555,913176,44379
917,52,195193,81500,959554,916176,43378
920,93,195897,31500,960555,917176,43379
920,93,195897,38000,961055,917676,43379
922,39,196157,50000,962554,920176,42378
923,79,196267,18500,966055,922176,43879
920,93,195897,14000,964554,781485,183069
919,51,195781,46500,969055,924176,44879
925,71,196335,27000,966555,924676,41879
924,41,196307,11000,969054,785596,183458
921,77,196049,90000,971554,927676,43878
924,41,196307,61500,970555,928676,41879
925,71,196335,21000,970055,929176,40879
930,45,197538,61000,977554,931176,46378
934,80,197793,83500,979054,932676,46378
934,80,197793,69500,981055,934176,46879
932,64,197741,27500,981555,935176,46379
936,70,198244,89500,983555,936176,47379
936,70,198244,21500,984054,938176,45878
935,37,198082,47500,983054,940176,42878
936,70,198244,34500,982554,941176,41378
938,91,198672,70000,989555,942676,46879
938,91,198672,14500,988055,942676,45379
939,24,198863,62500,993555,945176,48379
945,97,199458,26500,993054,947176,45878
946,43,199526,8000,986555,948176,38379
946,43,199526,66000,995554,949676,45878
950,100,201799,44500,995555,950676,44879
950,100,201799,90000,996055,952176,43879
950,100,201799,26500,996054,954176,41878
951,55,201967,55500,998055,954676,43379
950,100,201799,10000,998054,955176,42878
951,55,201967,62500,999054,956176,42878
957,57,203604,18500,999555,957176,42379
959,75,204473,42000,997554,959176,38378
959,75,204473,58000,999554,961176,38378
963,72,205875,21000,779446,962176,-182730
964,85,205888,38000,780715,964176,-183461
964,85,205888,8000,780946,964676,-183730
966,72,206168,72000,780446,967176,-186730
964,85,205888,48000,781446,969676,-188230
963,72,205875,65500,783946,971676,-187730
963,72,205875,30000,785715,971676,-185961
973,82,206733,91500,788446,973676,-185230
968,91,206465,65000,791715,976676,-184961
973,82,206733,50000,792446,979176,-186730
969,76,206477,67500,793215,980176,-186961
969,76,206477,14000,794215,981176,-186961
972,73,206650,20000,794446,982176,-187730
975,98,207122,29000,794715,982676,-187961
974,35,207026,20500,795215,983676,-188461
974,35,207026,42500,795715,985676,-189961
976,93,207562,8500,768005,986676,-218671
979,64,208541,68500,797446,988176,-190730
980,43,208687,60000,802215,991176,-188961
979,64,208541,29500,803215,992176,-188961
983,90,209289,66000,805715,993176,-187461
980,43,208687,44500,811715,994676,-182961
984,88,209523,52500,811215,996676,-185461
984,88,209523,37000,807446,997176,-189730
985,45,209853,65500,815946,998676,-182730
986,85,210833,30500,818715,999676,-180961
987,92,211020,66000,819715,868985,-49270
986,85,210833,38500,819946,870096,-50150
991,94,212491,20000,819215,870485,-51270
991,94,212491,7500,820215,870985,-50770
996,76,213358,61500,821715,874096,-52381
1000,79,214226,31000,820946,877485,-56539
1000,79,214226,40500,823215,878485,-55270
1000,79,214226,69000,825946,880596,-54650
1003,96,215112,61500,827215,881985,-54770
1007,32,216012,58000,827946,885096,-57150
1009,59,216129,28500,829446,885985,-56539
1011,92,216521,28000,830715,887096,-56381
1013,87,216578,41000,830215,888985,-58770
1009,59,216129,7500,831215,889096,-57881
1013,87,216578,7500,833715,889596,-55881
1012,69,216526,69500,836446,892096,-55650
1017,41,217835,66000,838215,894596,-56381
1020,83,218372,34000,838946,895596,-56650
1021,59,219202,74000,843946,897985,-54039
1022,99,219594,60500,845946,900985,-55039
1027,30,220321,28500,846215,901985,-55770
1028,94,220746,24500,845715,902596,-56881
1030,89,221036,47500,847215,903596,-56381
1031,95,221105,55000,854215,906485,-52270
1029,63,220907,37000,854446,907096,-52650
1028,94,220746,46500,858446,908985,-50539
1030,89,221036,84500,860946,911596,-50650
1029,63,220907,3000,862946,820866,42080
1031,95,221105,64500,864215,914596,-50381
1030,89,221036,39000,867446,916096,-48650
1032,68,221302,26000,867715,916485,-48770
1033,91,221306,32500,862715,918596,-55881
1029,63,220907,35500,868946,920096,-51150
1029,63,220907,55000,870446,922096,-51650
1031,95,221105,44000,874715,925485,-50770
1031,95,221105,42500,876446,926985,-50539
1028,94,220746,27000,875446,927096,-51650
1032,68,221302,22000,876946,928096,-51150
1030,89,221036,54500,880446,931096,-50650
1028,94,220746,26000,884946,932485,-47539
1028,94,220746,41000,885946,933596,-47650
1030,89,221036,31000,885215,934985,-49770
1028,94,220746,27000,889715,935985,-46270
1028,94,220746,51500,890946,938596,-47650
1033,91,221306,46000,889215,941096,-51881
1031,95,221105,84000,892446,943485,-51039
1029,63,220907,22500,892215,805556,86659
1033,91,221306,31000,892946,945096,-52150
1033,91,221306,28000,893215,946485,-53270
1033,91,221306,41500,894946,948485,-53539
1031,95,221105,40000,898715,950985,-52270
1031,95,221105,22000,899215,952485,-53270
1032,68,221302,44500,899715,953985,-54270
1030,89,221036,46500,903946,956096,-52150
1030,89,221036,76000,906215,959485,-53270
1028,94,220746,57000,906946,960985,-54039
1030,89,221036,41500,909715,962485,-52770
1034,87,221627,32500,911446,964485,-53039
1031,95,221105,44000,907715,966985,-59270
1033,91,221306,28500,912215,968485,-56270
1033,91,221306,85500,918446,971485,-53039
1032,68,221302,39000,920446,972596,-52150
1031,95,221105,69500,921715,975485,-53770
1031,95,221105,87500,922946,977985,-55039
1033,91,221306,60500,924215,979096,-54881
1034,87,221627,72000,924446,982985,-58539
1034,87,221627,52500,926715,986596,-59881
1036,57,222088,61500,928215,988985,-60770
1036,57,222088,50500,927715,990985,-63270
1037,57,222470,58500,929946,991985,-62039
1038,95,222936,98000,934215,995096,-60881
1040,90,223466,16000,933715,996985,-63270
1040,90,223466,64000,938715,999985,-61270
1041,41,223550,20000,939715,791093,148622
1042,55,223605,47500,939946,837346,102600
1043,98,224180,74500,945446,838556,106890
1044,55,224480,42000,947446,838945,108501
1045,50,224709,40500,947946,834526,113420
1046,68,225120,39000,950946,836656,114290
1048,55,225651,27500,952215,837915,114300
1048,55,225651,36500,953215,842846,110369
1049,26,226147,23000,954215,843445,110770
1050,30,226427,25000,955715,844056,111659
1051,74,226443,54500,959446,844056,115390
1052,99,226764,57000,960215,844445,115770
1053,72,226892,55000,958946,848346,110600
1054,98,227039,113500,962215,848945,113270
1055,68,227055,79000,963446,849556,113890
1058,33,227540,10000,966715,843365,123350
1057,27,227525,40500,965946,849556,116390
1059,83,227747,25500,892956,843595,49361
1059,83,227747,106000,967946,848366,119580
1061,66,228153,42500,969215,849945,119270
1061,66,228153,43000,970715,846206,124509
1063,72,228437,12500,969446,827093,142353
1063,72,228437,45000,971946,848596,123350
1064,33,228794,31000,975215,849095,126120
1066,93,228933,38000,978215,854445,123770
1066,93,228933,52000,976215,855056,121159
1067,92,229076,72500,980715,854096,126619
1069,91,229288,11500,980446,837593,142853
1069,91,229288,63500,981715,855056,126659
1071,52,230344,40000,986215,855445,130770
1071,52,230344,32000,984946,842375,142571
1073,21,231045,42500,985946,853666,132280
1073,21,231045,23000,986946,859346,127600
1075,89,232124,19000,989446,854595,134851
1076,25,232146,63000,991715,854526,137189
1076,25,232146,22000,990446,853866,136580
1077,26,232861,28500,998715,854656,144059
1080,72,232957,37500,995215,858656,136559
1079,21,232932,27000,920456,856155,64301
1080,72,232957,75500,996946,860556,136390
1082,82,233169,47000,999715,860945,138770
1082,82,233169,60000,998946,860026,138920
1083,60,233303,27000,998215,859596,138619
1084,89,233319,84500,999215,864846,134369
1085,99,233571,75500,999946,865445,134501
1086,45,233656,32000,931456,865415,66041
1087,18,233909,15500,850036,865526,-15490
1088,33,233943,23500,934956,865096,69860
1090,48,234158,26000,933956,866056,67900
1090,48,234158,21000,935456,867155,68301
1091,27,234616,23000,938956,869656,69300
1093,77,234838,38000,941456,870915,70541
1093,77,234838,63000,944456,871026,73430
1094,38,235054,56500,945856,871016,74840
1095,75,235119,73000,949956,875156,74800
1096,34,235176,30000,946356,875666,70690
1097,99,235406,79000,951856,877375,74481
1099,39,235488,87500,952956,881375,71581
1099,39,235488,30000,952456,882516,69940
1100,53,235806,31500,954356,883016,71340
1101,34,236177,34000,956356,884375,71981
1102,46,236195,37500,957356,885516,71840
1104,82,236789,32500,958856,886516,72340
1104,82,236789,46500,959956,888375,71581
1105,34,237186,32500,961356,889875,71481
1106,100,237744,62000,962856,891516,71340
1108,100,238203,19500,968356,892875,75481
1108,100,238203,86500,968456,894016,74440
1109,50,238394,37500,966956,895516,71440
1110,72,238535,43000,969956,896516,73440
1112,74,238730,12500,967956,887656,80300
1112,74,238730,46000,970456,898375,72081
1114,63,239389,3500,788181,898516,-110335
1114,63,239389,62000,971956,899516,72440
1115,51,240388,45000,973456,900875,72581
1117,49,241023,9000,975356,901875,73481
1117,49,241023,53500,975956,904375,71581
1119,50,241454,23500,876126,904516,-28390
1120,66,241541,33500,979356,905375,73981
1120,66,241541,45000,978956,907516,71440
1121,88,242258,75500,984856,910016,74840
1122,89,242331,55000,983456,911516,71940
1123,70,242345,19000,986356,911875,74481
1124,71,242375,36000,985456,913375,72081
1125,44,242698,34500,986856,914375,72481
1127,84,243060,41000,992456,915516,76940
1127,84,243060,65000,992856,917516,75340
1128,99,243138,49000,994856,919016,75840
1129,94,243439,56500,999356,921875,77481
1130,26,243536,21500,997356,922016,75340
1131,75,243731,75500,998456,923875,74581
1132,53,243789,55000,998856,925516,73340
1133,84,243816,94000,999856,929016,70840
1134,91,243872,78000,999956,931516,68440
1136,100,243963,3000,997856,931875,65981
1136,100,243963,62500,998956,935016,63940
1137,11,244041,17500,867266,935375,-68109
1138,71,244706,40500,904476,936516,-32040
1139,40,244962,32500,904606,937016,-32410
1140,14,245012,9500,877036,937875,-60839
1142,60,246141,62500,895156,939375,-44219
1142,60,246141,38000,904865,940516,-35651
1144,57,246408,18500,910106,942016,-31910
1144,57,246408,53500,910365,944016,-33651
1145,50,246492,35500,915476,945016,-29540
1146,96,246493,77500,914366,947875,-33509
1147,21,246666,20500,914166,939856,-25690
1149,99,247682,3000,844681,948375,-103694
1153,33,247789,63000,915606,952016,-36410
1155,21,247806,44500,920976,953375,-32399
1154,62,247802,12500,919866,953516,-33650
1156,20,247830,20500,900005,953875,-53870
1155,21,247806,29000,894506,955016,-60510
1154,62,247802,45500,903876,957016,-53140
1156,20,247830,17500,915865,958016,-42151
1157,45,248077,30500,919666,958375,-38709
1157,45,248077,33000,908906,959516,-50610
1158,76,248437,72000,921365,961375,-40010
1159,27,248620,15500,904036,961516,-57480
1160,14,248791,20500,921106,961875,-40769
1161,62,249057,38500,904126,964375,-60249
1162,24,249507,14000,908846,965875,-57029
1163,18,249977,2500,578335,966016,-387681
1164,11,250172,2500,857675,953356,-95681
1165,51,250561,42500,911656,967875,-56219
1166,33,250669,19000,909376,968516,-59140
1167,89,250805,95000,926476,970875,-44399
1168,80,251401,60500,930666,972875,-42209
1169,65,251475,45500,915036,974016,-58980
1170,36,251621,38500,925366,974516,-49150
1171,12,251722,3000,867175,975016,-107841
1172,42,251781,18000,926606,975875,-49269
1175,73,252071,3000,865175,859807,5368
1174,19,252067,4000,870181,976016,-105835
1175,73,252071,48000,930866,977875,-47009
1176,24,252167,14000,914396,978016,-63620
1179,88,253116,9500,916036,978375,-62339
1179,88,253116,17000,914346,978875,-64529
1181,77,253268,59500,932106,980516,-48410
1180,14,253218,19500,932365,981375,-49010
1181,77,253268,48500,919896,985016,-65120
1182,13,253503,1000,881675,985516,-103841
1183,14,254147,12500,936166,985875,-49709
1184,51,254583,52000,936366,987875,-51509
1185,35,254748,21500,937476,988016,-50540
1186,45,254925,27500,920536,989516,-68980
1187,53,255533,26000,925406,991016,-65610
1188,15,255775,13000,937606,991375,-53769
1189,46,256094,30000,926036,992375,-66339
1190,71,256359,58500,942976,995016,-52040
1191,65,256505,51500,941866,996016,-54150
1192,83,256551,40000,931376,998516,-67140
1193,48,257162,36500,920626,999875,-79249
1194,69,257203,39500,943365,989855,-46490
1195,39,257385,34500,925346,991355,-66009
1196,93,257762,50000,943106,992856,-49750
1197,27,258151,30000,948476,993355,-44879
1199,20,258228,43500,947366,993856,-46490
1199,20,258228,8500,905995,994355,-88360
1201,98,259163,9000,927036,890214,36822
1201,98,259163,71500,948606,997356,-48750
1202,49,259369,24500,931395,998855,-67460
1203,94,259510,42000,948865,999856,-50991
1205,44,260179,8000,911266,931506,-20240
1206,98,260487,28000,952666,933016,19650
1206,98,260487,47000,954106,960655,-6549
1207,37,261078,42500,936416,964415,-27999
1208,76,261209,52500,937036,964656,-27620
1209,60,261288,17000,941906,957656,-15750
1210,85,261416,69500,954365,966155,-11790
1212,77,261592,27000,958366,966526,-8160
1212,77,261592,78000,942536,970156,-27620
1213,51,261736,43500,963666,958865,4801
1214,51,261908,37500,959865,948556,11309
1215,50,262091,39500,959476,963156,-3680
1216,25,262436,21000,948036,971655,-23619
1219,56,262655,27500,963866,972026,-8160
1219,56,262655,25500,964976,963837,1139
1220,65,262776,25000,969166,952846,16320
1220,65,262776,45000,965106,963866,1240
1221,76,262944,69000,970476,975526,-5050
1223,98,263539,45000,970606,975656,-5050
1223,98,263539,62000,949505,977526,-28021
1224,82,263544,58500,974666,981156,-6490
1225,45,263656,37500,947895,969865,-21970
1226,86,263846,54000,974866,983026,-8160
1228,71,264197,8500,944681,974837,-30156
1228,71,264197,42500,952896,974866,-21970
1229,14,264464,13500,944675,949746,-5071
1230,90,265340,42000,954536,950705,3831
1231,100,265379,49000,952675,986415,-33740
1232,92,265708,88000,976365,988526,-12161
1233,48,265764,23500,980166,991915,-11749
1234,82,266386,56000,959036,980366,-21330
1236,30,267062,11500,958181,980865,-22684
1236,30,267062,22000,980366,992026,-11660
1238,88,267408,29000,963906,985666,-21760
1238,88,267408,52000,981606,992156,-10550
1239,58,269075,68000,985666,993655,-7989
1240,50,269517,74000,987365,997526,-10161
1241,65,269671,39000,970584,997656,-27072
1243,80,269759,49500,991166,999526,-8360
1243,80,269759,41000,987106,991366,-4260
1244,54,270035,39000,991366,965445,25921
1245,85,270058,85500,992476,969945,22531
1246,57,270127,42500,972585,991865,-19280
1248,51,270522,9500,992865,968106,24759
1248,51,270522,42000,996866,970556,26310
1249,56,270695,55500,992606,996666,-4060
1250,100,271071,45000,997976,996837,1139
1252,31,271708,25500,988585,975635,12950
1253,69,271800,16000,984584,976135,8449
1253,69,271800,69500,998365,996866,1499
1256,89,272104,3500,992085,978635,13450
1256,89,272104,90500,996084,997365,-1281
1256,89,272104,44000,995084,983635,11449
1257,94,272212,46500,997085,987106,9979
1258,66,272523,30500,998584,990106,8478
1259,61,273007,21500,999584,990606,8978
1260,32,273517,27500,999585,990635,8950
1261,60,273908,62500,969416,992635,-23219
1262,67,274215,40000,986536,994635,-8099
1264,77,274272,51000,986536,996635,-10099
1264,77,274272,58000,991876,998106,-6230
1265,40,274377,26500,982505,999635,-17130
1266,86,274931,63000,992036,992095,-59
1267,42,275225,31500,992036,991346,690
1268,63,275586,46000,996906,977246,19660
1269,19,275708,2000,737835,770278,-32443
1272,87,276531,40500,997376,953546,43830
1272,87,276531,34000,991895,994705,-2810
1272,87,276531,49000,997536,994706,2830
1274,30,276716,99500,997536,997096,440
1274,30,276716,21000,997536,959046,38490
1276,42,277316,7500,942486,997595,-55109
1276,42,277316,26500,982816,986506,-3690
1277,83,277745,32000,993506,986616,6890
1279,23,278418,31000,997395,992556,4839
1280,58,278426,2000,753858,755882,-2024
1280,58,278426,27500,986126,996846,-10720
1281,73,278550,36000,996896,998056,-1160
1282,81,278743,49500,998536,998445,91
1283,20,278799,9500,982986,993516,-10530
1284,51,279622,22500,988546,964546,24000
1285,82,279784,37000,999005,993746,5259
1286,63,279924,34000,999006,997506,1500
1287,94,280218,44500,993766,973176,20590
1288,70,280305,24500,992046,958456,33590
1289,58,280705,18500,993766,997616,-3850
1290,22,280813,4000,775858,803675,-27817
1292,50,281018,10000,988496,959106,29390
1292,50,281018,18000,993986,806278,187708
1293,77,281188,29000,993995,999016,-5021
1294,49,281195,5500,778335,809778,-31443
1295,30,281392,4000,779335,811175,-31840
1296,76,281665,42000,999266,999246,20
1300,99,282036,20500,999486,963934,35552
1299,76,282023,32000,999496,978676,20820
1301,59,282088,13500,958986,966066,-7080
1300,99,282036,44000,999316,981046,18270
1301,59,282088,39500,999495,984176,15319
1302,29,282130,8500,992126,823278,168848
1303,67,282514,26000,997536,986546,10990
1304,40,282723,9500,964645,970366,-5721
1306,56,283440,1500,796858,826175,-29317
1306,56,283440,5500,797358,826778,-29420
1308,87,284161,13500,999546,959045,40501
1308,87,284161,26500,999656,974934,24722
1309,99,284212,33000,986886,991416,-4530
1310,95,284389,11000,805835,992046,-186211
1312,15,284951,2000,803858,835675,-31817
1313,90,284951,2500,797160,835778,-38618
1313,90,284951,35500,987036,980434,6602
1314,62,285714,15500,992536,992156,380
1316,40,285979,2000,810858,841278,-30420
1318,58,286088,9500,992386,842278,150108
1319,62,286189,23000,992536,995176,-2640
1320,87,286361,13500,975486,846675,128811
1320,87,286361,18500,992536,997546,-5010
1320,87,286361,16000,996156,981366,14790
1321,17,286566,7000,997886,997546,340
1322,44,286786,4000,824160,982566,-158406
1328,34,286995,12500,979256,997656,-18400
1325,75,286954,21500,998036,970166,27870
1325,75,286954,10000,835335,985956,-150621
1329,70,287018,10500,834835,859278,-24443
1327,96,286982,17000,980985,986606,-5621
1328,34,286995,4500,839335,988066,-148731
1330,29,287114,13000,998036,975376,22660
1330,29,287114,8000,975645,863778,111867
1331,94,287138,11500,840858,865278,-24420
1335,16,287427,7500,998036,854382,143654
1333,100,287336,13500,842358,991456,-149098
1334,16,287422,1500,841335,856382,-15047
1336,100,287565,4000,844335,870175,-25840
1336,100,287565,24500,981145,992106,-10961
1337,41,288157,5500,844858,873675,-28817
1338,91,289082,18500,985986,993566,-7580
1340,91,289391,18500,986645,997606,-10961
1341,42,289510,14500,986486,997866,-11380
1341,42,289510,5000,853335,881675,-28340
1342,38,289964,9500,990256,981166,9090
1345,91,290721,1500,853835,875133,-21298
1346,94,290762,16000,991985,986376,5609
1347,76,290764,11000,863335,887278,-23943
1346,94,290762,11500,864335,999066,-134731
1347,76,290764,11000,991486,986376,5110
1348,54,291182,34500,997645,892175,105470
1350,96,291363,2000,864160,886882,-22722
1350,96,291363,23500,997485,986545,10940
1351,66,291419,7500,870335,897675,-27340
1353,13,291958,1500,869660,898278,-28618
1354,78,292121,1000,869335,891633,-22298
1354,78,292121,8000,874133,986666,-112533
1355,85,292160,11500,877358,902778,-25420
1357,85,292507,9000,880835,991876,-111041
1357,85,292507,11000,881858,906778,-24920
1359,29,292997,3000,882335,992045,-109710
1360,41,293023,3500,885335,992166,-106831
1362,70,293160,5500,885358,910675,-25317
1363,50,293210,3000,884835,997376,-112541
1362,70,293160,8000,890358,912778,-22420
1364,55,293381,4000,887858,913778,-25920
1364,55,293381,6000,890858,997376,-106518
1365,38,293449,5000,891858,915175,-23317
1367,76,293840,3500,891358,915778,-24420
1368,45,293919,7000,892633,916778,-24145
1368,45,293919,4000,893358,997376,-104018
1369,79,294338,14500,900633,997666,-97033
1370,45,294480,5500,900660,921278,-20618
1372,76,294660,2500,898633,921778,-23145
1374,87,294732,15500,904358,923778,-19420
1374,87,294732,5000,902358,924778,-22420
1374,87,294732,15500,904335,926778,-22443
1376,68,295130,5500,907358,927278,-19920
1376,68,295130,10000,907133,928778,-21645
1378,89,295294,5000,909335,929778,-20443
1378,89,295294,17500,910835,931882,-21047
1379,70,295590,10500,911358,934778,-23420
1381,53,295781,12000,912335,937278,-24943
1381,53,295781,6500,911858,938675,-26817
1382,89,296690,13000,918660,942133,-23473
1383,67,296793,13000,920133,943882,-23749
1384,91,297075,16500,925835,946633,-20798
1385,62,297086,11000,925858,947882,-22024
1387,18,297109,12000,924858,948882,-24024
1388,48,297337,3000,922633,947778,-25145
1389,47,297483,8000,926835,950133,-23298
1389,47,297483,8500,927335,950382,-23047
1392,72,298353,2000,929358,950882,-21524
1393,84,298488,3000,935358,951633,-16275
1392,72,298353,11500,937335,953633,-16298
1393,84,298488,13500,936835,956778,-19943
1394,82,298889,11500,939358,959278,-19920
1396,87,298916,9000,941335,961175,-19840
1396,87,298916,14000,942660,963675,-21015
1397,61,299120,9000,944335,964278,-19943
1400,51,299467,6500,945160,965675,-20515
1399,80,299416,15000,949858,967778,-17920
1401,81,299586,12500,949660,969633,-19973
1401,81,299586,13500,951835,972882,-21047
1402,90,299694,11500,952358,974675,-22317
1404,31,299886,10000,954835,976882,-22047
1405,81,300055,6000,955335,977633,-22298
1405,81,300055,13500,957335,979882,-22547
1407,57,300295,5500,957358,980882,-23524
1407,57,300295,8500,957835,982133,-24298
1408,25,300510,3500,957133,982882,-25749
1409,22,300817,5500,960835,983382,-22547
1410,43,300928,9000,963358,985278,-21920
1411,47,301156,8500,964358,986175,-21817
1414,63,301466,2500,965358,986675,-21317
1415,38,301477,1500,964835,986778,-21943
1414,63,301466,11000,968358,990175,-21817
1415,38,301477,6000,968335,991175,-22840
1416,100,302145,17000,973335,994278,-20943
1417,64,302278,11000,971133,996175,-25042
1419,63,302515,4500,975358,996278,-20920
1419,63,302515,12000,975858,997778,-21920
1420,45,302925,10500,978335,999675,-21340
1421,31,303070,7000,977858,999778,-21920
1422,100,303423,16000,981335,999882,-18547
1424,25,303558,7000,981358,966756,14602
1424,25,303558,3500,980133,967261,12872
1425,47,304379,9000,985660,969261,16399
1426,81,304396,9500,987858,972261,15597
1427,48,304693,7000,990660,974256,16404
1428,98,304919,17000,994633,977256,17377
1429,100,305034,20000,995133,980261,14872
1430,81,305347,16000,996133,983261,12872
1431,44,305991,9500,998660,984761,13899
1432,74,306450,7500,999160,986261,12899
1433,87,306499,12000,999835,989256,10579
1434,92,306609,9500,999858,993261,6597
1435,53,307344,2000,575241,994256,-419015
1436,58,307564,3500,576741,996256,-419515
1438,87,308188,3000,578741,997261,-418520
1438,87,308188,4500,579839,999761,-419922
1439,84,308798,5000,583741,507863,75878
1440,90,309038,4500,585741,508363,77378
1442,86,309255,2000,583839,508878,74961
1444,44,309674,2000,588339,507878,80461
1446,41,309758,5500,593241,509363,83878
1445,83,309706,2000,594339,509378,84961
1445,83,309706,6000,594839,508378,86461
1447,87,310108,2500,592839,505863,86976
1447,87,310108,2500,598839,505878,92961
1448,78,310200,4500,599339,506363,92976
1450,60,310323,1500,600839,506378,94461
1450,60,310323,3000,600339,510863,89476
1451,73,310436,1000,595839,510878,84961
1452,32,310718,2000,601741,506863,94878
1453,49,310845,2000,602741,511363,91378
1454,58,311031,4000,605241,513363,91878
1455,43,311316,1500,604339,513378,90961
1456,66,311586,4500,609241,506878,102363
1459,20,312153,500,605839,511378,94461
1459,20,312153,2000,612339,509863,102476
1460,98,312226,1000,612741,509878,102863
1460,98,312226,7500,613339,511863,101476
1461,71,312706,3500,615339,507363,107976
1462,19,312778,1000,617339,514863,102476
1463,91,312892,6000,620339,513863,106476
1464,17,312906,2000,618241,507378,110863
1465,20,313302,1500,622339,511878,110461
1466,93,313503,9000,626741,514878,111863
1467,70,313665,2000,628839,508863,119976
1468,27,313849,2000,628339,513878,114461
1469,86,314065,3500,632839,515363,117476
1472,79,314280,500,625339,515378,109961
1472,79,314280,3000,633339,512363,120976
1472,79,314280,6000,634741,517863,116878
1473,31,314342,3000,631339,515863,115476
1474,26,314393,1000,634339,512378,121961
1475,45,314673,500,633741,512863,120878
1477,32,315172,3000,636339,512878,123461
1478,68,315451,1000,638339,514363,123976
1478,68,315451,5000,641241,510363,130878
1480,98,315816,500,637741,510378,127363
1480,98,315816,6000,646741,515878,130863
1481,23,315820,2000,647339,516363,130976
1482,27,316079,2500,647741,516378,131363
1485,51,316452,1000,645741,516863,128878
1485,51,316452,3000,649741,517878,131863
1486,80,316497,2000,651741,518378,133363
1486,80,316497,4500,652741,518863,133878
1487,89,316615,6000,653339,518878,134461
1489,96,317250,500,651839,519363,132476
1489,96,317250,8500,658839,522363,136476
1490,52,317339,3500,659241,523878,135363
1491,11,317895,500,659339,524363,134976
1492,48,318272,3000,661839,524863,136976
1493,41,318474,1500,661339,525863,135476
1495,33,318813,2500,663741,526363,137378
1496,76,319142,1500,663839,526378,137461
1496,76,319142,3500,670339,528863,141476
1501,78,319606,2500,671339,529863,141476
1498,34,319273,2500,671241,530878,140363
1500,69,319606,1000,666839,531863,134976
1502,89,319702,2500,673839,533378,140461
1502,89,319702,6000,676741,534878,141863
1502,89,319702,4000,676241,538363,137878
1504,30,319818,3500,677839,539378,138461
1504,30,319818,1500,678241,539878,138363
1506,34,320297,1500,678741,540863,137878
1506,34,320297,1000,678339,541878,136461
1507,35,320488,1500,679241,542363,136878
1509,70,321376,2500,682241,543378,138863
1509,70,321376,2500,683241,544378,138863
1511,62,321655,3500,684741,546863,137878
1511,62,321655,3000,686339,547878,138461
1513,55,322241,1500,688241,548863,139378
1513,55,322241,2000,687241,550363,136878
1514,35,322419,4500,695839,551378,144461
1515,79,322514,4000,694241,554878,139363
1516,69,322706,3000,699339,556878,142461
1519,100,322948,2000,696339,558878,137461
1519,100,322948,2000,695741,558863,136878
1519,100,322948,7500,704241,560863,143378
1520,63,323087,2000,704839,562378,142461
1521,61,323095,3000,707241,563378,143863
1522,83,323200,7000,707839,565363,142476
1523,50,323520,2000,705741,566378,139363
1525,88,323630,4500,712339,569363,142976
1525,88,323630,4000,711839,572863,138976
1526,77,323891,4000,713339,575863,137476
1527,95,324145,5000,715741,577378,138363
1528,63,324516,4500,720839,579363,141476
1529,40,324634,3500,722339,580363,141976
1530,79,324785,5000,722741,582363,140378
1531,27,324812,2000,721339,583378,137961
1532,87,324862,3000,723339,585378,137961
1534,93,325506,1000,723839,585863,137976
1534,93,325506,4000,725339,588863,136476
1536,16,326358,1000,725839,588878,136961
1537,64,326551,1000,727839,589363,138476
1537,64,326551,2500,729241,590863,138378
1538,37,326792,3500,730839,591878,138961
1540,94,326905,1500,732741,592363,140378
1540,94,326905,3000,733241,594363,138878
1545,100,327676,3500,735241,594863,140378
1544,51,327664,1000,734241,596363,137878
1545,100,327676,500,731741,596378,135363
1544,51,327664,3500,740339,597378,142961
1545,100,327676,6500,740839,599863,140976
1547,25,328317,3500,746339,600863,145476
1549,47,328357,1000,743839,605863,137976
1550,83,328427,3000,747339,603363,143976
1550,83,328427,4000,747741,605878,141863
1550,83,328427,5000,748741,608878,139863
1551,57,328611,3000,749741,610863,138878
1553,81,329282,6500,753339,613878,139461
1553,81,329282,2500,753839,616363,137476
1555,19,329644,1000,753741,616863,136878
1557,73,330149,500,754241,616878,137363
1557,73,330149,1000,754839,617863,136976
1557,73,330149,5000,758839,618878,139961
1559,56,330422,1000,758241,619878,138363
1561,66,330622,2500,759839,620378,139461
1561,66,330622,500,756741,620878,135863
1563,59,330876,4500,764339,621863,142476
1563,59,330876,3500,767241,623363,143878
1563,59,330876,3500,768741,625363,143378
1564,12,330988,500,761839,625878,135961
1566,43,331365,6500,772741,629378,143363
1566,43,331365,2500,774241,630878,143363
1567,78,331374,4000,773839,632878,140961
1568,89,331545,7000,775241,636363,138878
1569,42,332400,1000,776741,637363,139378
1571,88,332878,500,775741,637378,138363
1571,88,332878,4500,780839,639363,141476
1572,53,333221,1000,783241,641363,141878
1573,80,333231,1500,778339,642863,135476
1575,32,333422,3000,783839,645863,137976
1577,60,333539,2500,782741,646363,136378
1577,60,333539,1500,785741,646378,139363
1577,60,333539,3500,786839,646878,139961
1579,22,333705,500,782339,647363,134976
1580,38,334067,500,784241,647878,136363
1581,49,334078,3000,789339,650363,138976
1581,49,334078,2500,789839,650378,139461
1582,83,334216,4000,790241,652363,137878
1583,15,334556,1000,790339,652863,137476
1585,68,335197,2000,792241,652878,139363
1585,68,335197,3000,793839,654863,138976
1586,35,335282,500,791839,655378,136461
1589,54,335849,1500,794741,655878,138863
1589,54,335849,1000,795741,656878,138863
1589,54,335849,3000,796241,657863,138378
1590,80,336570,5500,799839,661363,138476
1592,25,336785,1500,800339,661378,138961
1592,25,336785,1500,801339,662363,138976
1594,92,337303,1500,800741,662863,137878
1594,92,337303,5000,806241,664863,141378
1595,20,337384,1000,804839,665363,139476
1596,36,337788,1000,805241,666363,138878
1598,92,337915,4500,811741,668863,142878
1598,92,337915,6500,811339,671878,139461
1600,81,338376,1000,809241,672363,136878
1600,81,338376,4500,812839,674363,138476
1601,41,338880,2000,814339,676363,137976
1602,70,339078,2500,816839,678363,138476
1603,88,339562,9000,822339,680863,141476
1604,38,339649,4000,823741,683863,139878
1606,78,339888,1000,819741,683878,135863
1606,78,339888,3500,824741,683378,141363
1607,85,339989,2000,825241,685863,139378
1608,51,340232,2500,826839,687863,138976
1609,33,340482,2000,827339,688863,138476
1610,41,340529,1000,826241,689363,136878
1611,24,341217,3000,831241,689878,141363
1614,72,341561,2500,830339,691363,138976
1614,72,341561,1000,829241,691378,137863
1614,72,341561,4000,832741,693363,139378
1615,45,342518,1500,833741,693863,139878
1616,27,342809,500,833339,694378,138961
1617,93,343299,4000,836839,695863,140976
1619,73,343554,1500,837741,696363,141378
1619,73,343554,2000,837839,697863,139976
1620,57,343904,2500,839839,698863,140976
1621,46,344246,2500,841241,700363,140878
1622,66,344618,4500,842241,702363,139878
1623,44,345421,3500,844339,702878,141461
1625,98,345923,1000,844241,703363,140878
1625,98,345923,3500,847839,705363,142476
1626,58,346319,3000,849241,706878,142363
1627,31,346541,2500,850741,708378,142363
1628,43,346713,2000,851741,709378,142363
1629,58,346811,4000,851839,710378,141461
1631,18,347697,1500,852741,710878,141863
1634,54,348580,500,852839,711863,140976
1635,90,348658,1500,853839,712378,141461
1635,90,348658,500,853741,712863,140878
1635,90,348658,500,854241,713378,140863
1635,90,348658,3500,856839,715863,140976
1637,91,349225,2500,862241,716863,145378
1638,68,349230,5000,863241,719378,143863
1639,72,349460,3000,863741,721363,142378
1639,72,349460,5000,864839,723378,141461
1641,81,349874,500,861839,724378,137461
1641,81,349874,5000,871839,728363,143476
1642,54,350123,3000,875339,730863,144476
1643,49,350322,3500,874839,731878,142961
1644,99,350330,7000,878339,734878,143461
1646,40,350404,3000,878741,736863,141878
1646,40,350404,3500,879339,738363,140976
1647,79,350488,3500,879241,739878,139363
1649,54,350928,3000,881339,741863,139476
1650,51,351081,2500,882241,742863,139378
1651,31,351263,1500,880839,743878,136961
1651,31,351263,2000,883339,744863,138476
1652,13,351838,2500,884339,745363,138976
1654,69,352276,1000,884241,745378,138863
1654,69,352276,2500,885839,745878,139961
1656,85,352539,1000,886839,746378,140461
1657,60,352941,2500,887839,748363,139476
1657,60,352941,3000,889339,749878,139461
1658,26,353263,1500,889839,750363,139476
1659,46,353532,1500,890339,751863,138476
1660,48,354176,500,890741,752363,138378
1661,55,355440,4500,895241,753878,141363
1662,56,355622,3000,897339,755878,141461
1663,60,355845,2500,897241,757363,139878
1664,98,355944,6500,900241,758878,141363
1665,58,356415,1500,901839,761363,140476
1666,61,356567,1500,905339,762863,142476
1667,38,356605,3000,903339,763363,139976
1668,69,356874,4000,904839,765363,139476
1669,91,357187,6500,907741,769863,137878
1670,14,357421,2500,909741,769878,139863
1672,57,358004,500,908241,770363,137878
1672,57,358004,5000,913241,772378,140863
1673,49,358088,2500,912241,773878,138363
1674,60,358564,5000,916839,776863,139976
1675,73,358770,5000,917741,778863,138878
1676,43,359225,2500,919741,779878,139863
1678,93,359798,1000,919241,780863,138378
1678,93,359798,3500,923339,782863,140476
1679,93,360165,4000,925339,784378,140961
1680,71,360329,4000,925241,786378,138863
1681,67,360417,2000,925839,787363,138476
1683,85,361713,1500,929741,787878,141863
1683,85,361713,5500,931339,789878,141461
1686,26,362030,2500,929241,790878,138363
1686,26,362030,2000,932241,791863,140378
1687,56,362409,500,931241,792863,138378
1688,22,362474,2000,933741,794363,139378
1689,54,362723,1500,935241,794878,140363
1689,54,362723,3500,937741,796863,140878
1690,58,363069,3000,939839,799363,140476
1691,33,363156,2500,939241,800878,138363
1692,19,363322,1500,942839,801378,141461
1693,73,363425,6000,943741,802878,140863
1695,40,363754,2500,945839,805378,140461
1695,40,363754,1000,942741,806878,135863
1697,41,364203,5000,947741,808863,138878
1697,41,364203,2500,947339,809878,137461
1698,11,364435,500,946241,811863,134378
1700,81,364938,3000,952741,811378,141363
1700,81,364938,7000,954741,814378,140363
1701,85,365225,3500,955741,817378,138363
1702,79,365252,4500,957839,819363,138476
1703,47,365742,2500,959339,819863,139476
1704,23,365763,2500,959741,820863,138878
1705,39,366071,3000,960741,821863,138878
1706,73,366892,2500,963241,823363,139878
1708,50,367225,2000,964241,823878,140363
1708,50,367225,3000,966241,825863,140378
1709,73,367437,2500,966741,827363,139378
1710,64,367749,4000,970339,829363,140976
1711,13,367943,1000,970241,829863,140378
1712,96,368263,10000,977741,833363,144378
1713,88,368368,5000,978339,838363,139976
1714,82,368803,6500,980839,839878,140961
1715,84,368928,4000,981741,841863,139878
1716,49,368992,2000,981839,843378,138461
1717,59,369882,3000,984741,844863,139878
1718,20,369926,500,982339,845378,136961
1719,79,370174,2000,984339,846878,137461
1720,20,370893,1500,986241,847878,138363
1722,47,371403,3500,991241,849363,141878
1722,47,371403,4000,993339,851363,141976
1723,99,371662,6500,997839,853878,143961
1724,63,371733,6000,998839,855878,142961
1725,62,371910,3000,999339,858363,140976
1727,50,372316,1500,998339,860363,137976
1727,50,372316,1500,998741,861863,136878
1728,71,372457,2000,999741,864363,135378
1729,49,372476,1000,999839,865878,133961
1883,100,405737,500,645945,867878,-221933
1883,100,405737,500,645946,870378,-224432
1884,44,406192,500,646445,873378,-226933
1883,100,405737,500,646446,873363,-226917
1883,100,405737,500,646945,874363,-227418
1883,100,405737,500,646946,876878,-229932
1883,100,405737,500,647445,878363,-230918
1883,100,405737,500,647446,880378,-232932
1883,100,405737,500,647945,880878,-232933
1884,44,406192,500,647946,882378,-234432
1884,44,406192,500,648445,885378,-236933
1885,95,407007,500,648446,887378,-238932
1885,95,407007,500,648945,888363,-239418
1885,95,407007,500,648946,890863,-241917
1885,95,407007,500,649445,892863,-243418
1885,95,407007,500,649446,893363,-243917
1885,95,407007,500,649945,894363,-244418
1885,95,407007,500,649946,895878,-245932
1886,14,407106,500,650445,901363,-250918
1885,95,407007,500,650446,900878,-250432
1885,95,407007,500,650945,902863,-251918
1885,95,407007,500,650946,904863,-253917
1888,88,407790,500,651445,905863,-254418
1888,88,407790,500,651446,908363,-256917
1887,26,407726,500,651945,908863,-256918
1890,83,408240,500,651946,909878,-257932
1888,88,407790,500,652445,911363,-258918
1891,92,408242,500,652446,913878,-261432
1889,87,408198,500,652945,916378,-263433
1889,87,408198,500,652946,918363,-265417
1890,83,408240,500,653445,918878,-265433
1891,92,408242,500,653446,922363,-268917
1890,83,408240,500,653945,924878,-270933
1889,87,408198,500,653946,925378,-271432
1891,92,408242,500,654445,927878,-273433
1891,92,408242,500,654446,930363,-275917
1890,83,408240,500,654945,931878,-276933
1891,92,408242,500,654946,932863,-277917
1891,92,408242,500,655445,935363,-279918
1888,88,407790,500,655446,937363,-281917
1888,88,407790,500,655945,937863,-281918
1891,92,408242,500,655946,938878,-282932
1890,83,408240,500,656445,938863,-282418
1889,87,408198,500,656446,941878,-285432
1892,11,408629,500,656945,944863,-287918
1891,92,408242,500,656946,945378,-288432
1892,11,408629,500,657445,945863,-288418
1889,87,408198,500,657446,947878,-290432
1891,92,408242,500,657945,949878,-291933
1889,87,408198,500,657946,951363,-293417
1890,83,408240,500,658445,953363,-294918
1889,87,408198,500,658446,956363,-297917
1890,83,408240,500,658945,957363,-298418
1890,83,408240,500,658946,958378,-299432
1891,92,408242,500,659445,961378,-301933
1891,92,408242,500,659446,963363,-303917
1893,53,409308,500,659945,964878,-304933
1892,11,408629,500,659946,965878,-305932
1894,82,409391,500,660445,967863,-307418
1893,53,409308,500,660446,967878,-307432
1894,82,409391,500,660945,969863,-308918
1893,53,409308,500,660946,971378,-310432
1893,53,409308,500,661445,973878,-312433
1893,53,409308,500,661446,974878,-313432
1894,82,409391,500,661945,975863,-313918
1894,82,409391,500,661946,976863,-314917
1896,44,409954,500,662445,978863,-316418
1896,44,409954,500,662446,979878,-317432
1893,53,409308,500,662945,981363,-318418
1893,53,409308,500,662946,982378,-319432
1897,51,409987,500,663445,983378,-319933
1894,82,409391,500,663446,986363,-322917
1893,53,409308,500,663945,986378,-322433
1894,82,409391,500,663946,988378,-324432
1893,53,409308,500,664445,989378,-324933
1894,82,409391,500,664446,991863,-327417
1897,51,409987,500,664945,993363,-328418
1895,25,409866,500,664946,994363,-329417
1897,51,409987,500,665445,994378,-328933
1896,44,409954,500,665446,997363,-331917
1897,51,409987,500,665945,997378,-331433
1897,51,409987,500,665946,995363,-329417
1897,51,409987,500,666445,996878,-330433
1896,44,409954,500,666446,999378,-332932
1899,83,410373,500,666945,999878,-332933
1899,83,410373,500,666946,952807,-285861
1897,51,409987,500,667445,953807,-286362
1899,83,410373,500,667446,953214,-285768
1899,83,410373,500,667945,953307,-285362
1898,33,410094,500,667946,955307,-287361
1898,33,410094,500,668445,954214,-285769
1895,25,409866,500,668446,953714,-285268
1898,33,410094,500,668945,956214,-287269
1897,51,409987,500,668946,956807,-287861
1898,33,410094,500,669445,952714,-283269
1895,25,409866,500,669446,954307,-284861
1898,33,410094,500,669945,956714,-286769
1901,27,410814,500,669946,957214,-287268
1896,44,409954,500,670445,954714,-284269
1898,33,410094,500,670446,954807,-284361
1899,83,410373,500,670945,955714,-284769
1899,83,410373,500,670946,957307,-286361
1902,70,410875,500,671445,955214,-283769
1899,83,410373,500,671446,958307,-286861
1901,27,410814,500,671945,957714,-285769
1899,83,410373,500,671946,957807,-285861
1899,83,410373,500,672445,955807,-283362
1899,83,410373,500,672446,958714,-286268
1903,95,410898,500,672945,958214,-285269
1900,26,410739,500,672946,960307,-287361
1901,27,410814,500,673445,958807,-285362
1899,83,410373,500,673446,956307,-282861
1902,70,410875,500,673945,959214,-285269
1902,70,410875,500,673946,959307,-285361
1903,95,410898,500,674445,959714,-285269
1903,95,410898,500,674446,960714,-286268
1903,95,410898,500,674945,960807,-285862
1902,70,410875,500,674946,961214,-286268
1904,96,411032,500,675445,959807,-284362
1903,95,410898,500,675446,960214,-284768
1902,70,410875,500,675945,961307,-285362
1901,27,410814,500,675946,961714,-285768
1904,96,411032,500,676445,961807,-285362
1903,95,410898,500,676446,962214,-285768
1904,96,411032,500,676945,964714,-287769
1902,70,410875,500,676946,962307,-285361
1904,96,411032,500,677445,963807,-286362
1903,95,410898,500,677446,962714,-285268
1903,95,410898,500,677945,962807,-284862
1904,96,411032,500,677946,963214,-285268
1907,80,411391,500,678445,963307,-284862
1903,95,410898,500,678446,966307,-287861
1907,80,411391,500,678945,965214,-286269
1907,80,411391,500,678946,964214,-285268
1900,26,410739,500,679445,969307,-289862
1903,95,410898,500,679446,964807,-285361
1903,95,410898,500,679945,969714,-289769
1907,80,411391,500,679946,969807,-289861
1903,95,410898,500,680445,964307,-283862
1904,96,411032,500,680446,965307,-284861
1907,80,411391,500,680945,971807,-290862
1905,24,411059,500,680946,966807,-285861
1904,96,411032,500,681445,963714,-282269
1908,38,411430,500,681446,970214,-288768
1903,95,410898,500,681945,970307,-288362
1906,28,411100,500,681946,967214,-285268
1909,65,411630,500,682445,970714,-288269
1904,96,411032,500,682446,965714,-283268
1904,96,411032,500,682945,972214,-289269
1907,80,411391,500,682946,970807,-287861
1909,65,411630,500,683445,967307,-283862
1903,95,410898,500,683446,967714,-284268
1911,73,411687,500,683945,972307,-288362
1908,38,411430,500,683946,967807,-283861
1907,80,411391,500,684445,966714,-282269
1903,95,410898,500,684446,968214,-283768
1910,100,411631,500,684945,965807,-280862
1907,80,411391,500,684946,968307,-283361
1913,51,411802,500,685445,971214,-285769
1909,65,411630,500,685446,968714,-283268
1911,73,411687,500,685945,971307,-285362
1904,96,411032,500,685946,966214,-280268
1910,100,411631,500,686445,968807,-282362
1907,80,411391,500,686446,972714,-286268
1913,51,411802,500,686945,969214,-282269
1910,100,411631,500,686946,972807,-285861
1907,80,411391,500,687445,971714,-284269
1907,80,411391,500,687446,973214,-285768
1907,80,411391,500,687945,973714,-285769
1908,38,411430,500,687946,973307,-285361
1908,38,411430,500,688445,973807,-285362
1909,65,411630,500,688446,974214,-285768
1911,73,411687,500,688945,974807,-285862
1912,19,411700,500,688946,975714,-286768
1907,80,411391,500,689445,975214,-285769
1914,54,412044,500,689446,977714,-288268
1908,38,411430,500,689945,974307,-284362
1909,65,411630,2000,692446,974714,-282268
1911,73,411687,2000,693446,977807,-284361
1915,57,412165,500,690945,978214,-287269
1913,51,411802,1500,695946,975807,-279861
1911,73,411687,3000,695445,976214,-280769
1915,57,412165,500,693445,978307,-284862
1916,48,412333,1500,695446,976307,-280861
1914,54,412044,4500,698446,978714,-280268
1915,57,412165,5000,700946,981214,-280268
1916,48,412333,3500,701445,976714,-275269
1917,37,412363,4500,700446,976807,-276361
1918,51,412535,4500,699446,975307,-275861
1919,18,412627,1000,698945,978807,-279862
1922,96,413099,4500,703446,979214,-275768
1921,22,412945,2500,701945,979307,-277362
1923,56,413207,9500,706946,977214,-270268
1925,37,413424,5500,708446,979714,-271268
1926,75,413567,3500,709945,979807,-269862
1927,64,413606,6000,713946,981307,-267361
1926,75,413567,11000,715945,981807,-265862
1929,84,413849,7000,716445,982214,-265769
1928,57,413614,7000,715946,977307,-261361
1929,84,413849,8000,718445,981714,-263269
1930,23,414056,3000,719446,980214,-260768
1931,78,414325,9500,722945,980307,-257362
1932,47,414453,5000,722445,980714,-258269
1934,60,414924,4000,728946,982307,-253361
1935,96,415047,6500,732445,980807,-248362
1936,96,415110,10500,735446,982714,-247268
1937,87,415219,12500,735945,982807,-246862
1938,78,415302,9500,736446,983214,-246768
1938,78,415302,11500,737945,983307,-245362
1939,97,415328,11500,737946,983714,-245768
1942,90,416276,2500,745945,983807,-237862
1942,90,416276,4500,746945,984214,-237269
1942,90,416276,7500,744945,984307,-239362
1943,60,416293,8000,747446,990807,-243361
1944,86,416537,9000,746946,989214,-242268
1946,38,417042,1500,745946,989307,-243361
1946,38,417042,4000,748445,991214,-242769
1947,79,417778,10000,751445,991307,-239862
1949,93,418200,2000,751446,991714,-240268
1949,93,418200,12000,754446,986307,-231861
1950,86,418832,9000,757446,991807,-234361
1951,13,418908,2500,757946,986714,-228768
1952,40,419075,4000,758445,988214,-229769
1953,10,419249,1000,756446,986807,-230361
1954,63,419873,9000,762446,989714,-227268
1955,84,420267,10500,766945,989807,-222862
1956,75,420281,6500,766446,984714,-218268
1957,67,420676,7000,768445,992214,-223769
1959,75,420980,1500,764445,984807,-220362
1959,75,420980,13000,770945,985214,-214269
1960,33,421123,4500,769446,992307,-222861
1961,29,421596,3000,771445,992714,-221269
1964,71,421797,4500,778446,985307,-206861
1964,71,421797,4000,778945,988307,-209362
1964,71,421797,8000,777445,985714,-208269
1966,47,422024,3500,776945,987214,-210269
1966,47,422024,4500,779945,987307,-207362
1967,86,422460,9000,785445,985807,-200362
1968,22,422478,3500,786946,993807,-206861
1970,94,422742,10500,785946,992807,-206861
1970,94,422742,9000,788445,986214,-197769
1971,76,422843,4500,786446,987714,-201268
1973,89,423009,4500,789446,994214,-204768
1973,89,423009,10000,791445,988714,-197269
1975,85,423370,1500,787446,990214,-202768
1975,85,423370,5000,791946,993214,-201268
1976,71,423650,8500,793945,988807,-194862
1977,20,423740,3000,793446,994307,-200861
1979,69,423964,2500,793445,987807,-194362
1979,69,423964,7000,795446,990307,-194861
1980,77,424650,5500,799945,993307,-193362
1981,89,424684,7500,799446,995807,-196361
1982,96,425110,9000,802446,990714,-188268
1983,17,425270,3500,804446,993714,-189268
1984,97,425479,9500,804946,994714,-189768
1985,65,426315,5000,811946,994807,-182861
1986,85,426438,10000,814445,996807,-182362
1988,95,426641,3000,807446,995214,-187768
1988,95,426641,11500,817946,997214,-179268
1989,41,426719,4000,814945,995307,-180362
1991,99,426961,2500,809446,995714,-186268
1991,99,426961,15500,821946,996214,-174268
1992,95,427287,12500,828445,997307,-168862
1993,63,427328,5000,828945,996307,-167362
1994,33,427430,5500,825946,999714,-173768
1996,35,427546,3500,831445,997714,-166269
1997,81,427607,4000,830446,999807,-169361
1997,81,427607,14000,832945,998714,-165769
1999,46,428070,3500,835946,997807,-161861
1999,46,428070,8000,835945,998214,-162269
2000,78,428152,8000,836945,998307,-161362
2002,19,428793,3000,836445,996714,-160269
2002,19,428793,2000,837445,998807,-161362
2003,38,429200,6500,839946,999307,-159361
2004,61,429491,5000,841446,999214,-157768
2006,97,429894,4500,844446,930181,-85735
2006,97,429894,12000,847945,933681,-85736
2007,59,430027,6000,847446,934655,-87209
2008,77,430222,6000,847946,937181,-89235
2009,76,430459,9000,850946,940655,-89709
2010,27,430771,3000,852446,940681,-88235
2012,86,431111,3000,849446,942155,-92709
2012,86,431111,12000,854445,943181,-88736
2013,46,431379,3500,854945,943681,-88736
2014,45,431902,5000,856945,945181,-88236
2015,87,432176,10500,860445,947181,-86736
2016,81,432650,9500,863446,949681,-86235
2017,88,432657,6500,861445,953181,-91736
2018,55,432826,4000,863445,954655,-91210
2024,74,433541,2000,863945,955155,-91210
2023,35,433395,2000,863946,955181,-91235
2024,74,433541,2000,865445,955681,-90236
2023,35,433395,3500,869445,957655,-88210
2024,74,433541,2000,868946,957681,-88735
2025,89,433623,6000,870446,960181,-89735
2026,68,433880,7500,873446,963181,-89735
2026,68,433880,8000,876445,966155,-89710
2028,58,434012,3000,871946,969655,-97709
2031,28,434162,4000,875446,971181,-95735
2031,28,434162,2500,874445,969681,-95236
2031,28,434162,11500,877446,971655,-94209
2031,28,434162,3000,876946,973181,-96235
2032,55,434668,3500,879446,975155,-95709
2033,43,434897,4500,881945,976181,-94236
2034,83,435064,8000,882445,978155,-95710
2035,24,435288,3500,885445,981181,-95736
2038,64,435369,1500,879445,979181,-99736
2037,70,435368,7500,886446,981655,-95209
2039,18,435403,7000,886946,982181,-95235
2040,97,435723,3500,886945,983181,-96236
2041,46,435743,10000,889946,986655,-96709
2042,18,436139,5000,888945,988655,-99710
2042,18,436139,3500,889945,989181,-99236
2043,34,436621,4500,894945,990181,-95236
2045,75,436762,3500,892445,992155,-99710
2045,75,436762,10500,895946,993155,-97209
2046,38,437204,4500,894445,994155,-99710
2047,43,437475,7500,898445,995155,-96710
2048,81,437502,11000,900445,996681,-96236
2049,99,438218,12500,902946,999681,-96735
2050,63,438572,7500,905445,868018,37427
2051,59,438902,5000,905946,868335,37611
2052,41,439193,5500,907446,868518,38928
2053,28,439259,2500,907945,868835,39110
2055,99,440280,4000,911445,869018,42427
2055,99,440280,9000,912946,869335,43611
2056,76,440398,10000,914946,869518,45428
2057,42,441008,6000,920945,869835,51110
2059,69,441189,6000,918946,870018,48928
2059,69,441189,9000,922445,870335,52110
2060,28,441517,3500,923446,871018,52428
2062,64,441627,6000,924945,870518,54427
2062,64,441627,7500,926446,870835,55611
2063,91,441906,9000,929945,871335,58610
2066,97,442086,6000,927445,871518,55927
2066,97,442086,4500,929946,871835,58111
2067,32,442105,11000,931946,872835,59111
2067,32,442105,1500,924446,872018,52428
2068,60,442444,7500,932945,873018,59927
2069,42,442721,5500,933445,873335,60110
2071,97,443588,10000,940945,873518,67427
2071,97,443588,11500,941445,872335,69110
2072,84,443928,12000,943445,875335,68110
2073,51,444177,8000,944946,872518,72428
2075,91,444939,3000,944446,875518,68928
2076,52,444966,10500,949945,877018,72927
2076,52,444966,4500,949446,874018,75428
2077,76,445082,9000,950446,877335,73111
2078,69,445500,4500,952446,878335,74111
2080,90,445943,3500,951946,878518,73428
2080,90,445943,11500,954946,874335,80611
2081,87,446402,7500,959446,878835,80611
2084,88,446772,2500,957946,879018,78928
2084,88,446772,2500,961946,874518,87428
2084,88,446772,6000,960445,874835,85610
2085,97,446928,14500,965445,875835,89610
2086,71,447109,9500,966446,876018,90428
2087,31,447184,5000,967945,876335,91610
2088,40,447381,3500,967446,879335,88111
2089,88,447842,9500,970946,879518,91428
2090,78,448133,9000,973945,873835,100110
2091,99,448180,11000,974945,876518,98427
2092,13,448239,1000,973445,877518,95927
2094,83,448939,5000,979445,875018,104427
2094,83,448939,8500,978946,879835,99111
2095,89,449234,8500,982446,876835,105611
2096,41,449274,5500,982445,880018,102427
2098,65,449758,3000,983445,880335,103110
2098,65,449758,6000,984446,881018,103428
2099,89,450046,8500,986445,877835,108610
2100,79,450744,13500,992945,878018,114927
2101,99,451003,8500,993946,881335,112611
2102,62,451108,8500,993945,880518,113427
2103,38,451322,4500,994446,885335,109111
2104,28,452254,1500,995445,884335,111110
2105,77,452403,8500,999946,881518,118428
2106,50,452492,6000,997445,881835,115610
2108,74,452842,5000,999445,885835,113610
2396,98,521148,3500,968155,882018,86137
2396,98,521148,6000,971411,880835,90576
2396,98,521148,1000,968655,886018,82637
2396,98,521148,4500,974411,882335,92076
2395,58,521132,1000,973411,882518,90893
2396,98,521148,4000,975411,884518,90893
2397,23,521159,2000,977411,882835,94576
2398,65,521735,2500,977155,883018,94137
2398,65,521735,1500,979655,887018,92637
2398,65,521735,2500,979155,883335,95820
2399,57,521835,3500,980911,883518,97393
2399,57,521835,2000,981655,887335,94320
2398,65,521735,500,649261,886335,-237074
2398,65,521735,3000,982155,884835,97320
2398,65,521735,2000,982911,883835,99076
2399,57,521835,2000,986155,888518,97637
2398,65,521735,5000,986911,886518,100393
2402,97,522576,2500,986411,888835,97576
2399,57,521835,1500,987411,887518,99893
2403,36,522719,1500,987911,887835,100076
2402,97,522576,4500,991911,885018,106893
2402,97,522576,5000,994411,884018,110393
2402,97,522576,5500,996411,885518,110893
2402,97,522576,5500,997911,890835,107076
2402,97,522576,1000,996911,889018,107893
2401,25,522567,3000,999155,891018,108137
2404,33,523006,1000,999411,891335,108076
2405,41,523095,500,652804,886835,-234031
2400,12,522383,2000,999655,891518,108137
2402,97,522576,500,653304,888018,-234714
2403,36,522719,1000,999911,889335,110576
2401,25,522567,500,653804,889518,-235714
2402,97,522576,500,654261,891835,-237574
2402,97,522576,500,654304,892018,-237714
2405,41,523095,500,654761,892335,-237574
2402,97,522576,500,654804,888335,-233531
2405,41,523095,500,655261,889835,-234574
2407,89,523715,500,655304,890018,-234714
2407,89,523715,500,655761,890335,-234574
2404,33,523006,500,655804,890518,-234714
2408,34,523846,500,656261,894018,-237757
2407,89,523715,500,656304,892518,-236214
2407,89,523715,500,656761,894335,-237574
2406,79,523665,500,656804,892835,-236031
2405,41,523095,500,657261,894518,-237257
2406,79,523665,500,657304,893518,-236214
2407,89,523715,500,657761,893018,-235257
2408,34,523846,500,657804,893335,-235531
2407,89,523715,500,658261,893835,-235574
2408,34,523846,500,658304,894835,-236531
2409,78,524090,500,658761,895018,-236257
2406,79,523665,500,658804,895335,-236531
2410,99,524099,500,659261,895518,-236257
2409,78,524090,500,659304,895835,-236531
2408,34,523846,500,659761,896018,-236257
2407,89,523715,2000,754416,896335,-141919
2409,78,524090,500,660261,896835,-236574
2409,78,524090,4500,757916,897018,-139102
2409,78,524090,2500,758415,897335,-138920
2406,79,523665,3500,758916,899518,-140602
2412,51,524302,5500,763415,897518,-134103
2409,78,524090,1000,762916,897835,-134919
2410,99,524099,2500,764416,896518,-132102
2409,78,524090,1500,762915,898018,-135103
2409,78,524090,6000,768415,898335,-129920
2412,51,524302,2500,770915,898518,-127603
2407,89,523715,7500,776416,898835,-122419
2411,95,524278,6500,776916,899835,-122919
2406,79,523665,3500,775916,899018,-123102
2410,99,524099,4000,777415,900018,-122603
2412,51,524302,5000,778415,899335,-120920
2406,79,523665,2000,779916,900335,-120419
2410,99,524099,3500,782915,900518,-117603
2412,51,524302,4500,782416,900835,-118419
2409,78,524090,2500,784415,901018,-116603
2411,95,524278,500,664804,901335,-236531
2407,89,523715,6000,790916,901518,-110602
2410,99,524099,8500,791916,901835,-109919
2409,78,524090,2500,789915,902018,-112103
2410,99,524099,5000,794916,902335,-107419
2408,34,523846,3000,795415,903335,-107920
2409,78,524090,2500,795915,905018,-109103
2412,51,524302,1500,796416,903518,-107102
2410,99,524099,2000,798915,902518,-103603
2411,95,524278,6500,800416,902835,-102419
2410,99,524099,2500,805915,903835,-97920
2410,99,524099,6000,813415,903018,-89603
2411,95,524278,7000,819416,904018,-84602
2409,78,524090,3000,818916,906835,-87919
2409,78,524090,3500,815415,907018,-91603
2413,48,524837,6000,820916,907335,-86419
2410,99,524099,8000,821415,907518,-86103
2411,95,524278,5000,820915,905335,-84420
2410,99,524099,3000,821416,904335,-82919
2410,99,524099,3000,820416,907835,-87419
2410,99,524099,1500,820415,905518,-85103
2409,78,524090,5500,825415,904518,-79103
2411,95,524278,3000,826915,904835,-77920
2411,95,524278,4000,828915,905835,-76920
2411,95,524278,4000,832916,906018,-73102
2411,95,524278,5000,838415,906335,-67920
2414,43,525068,2000,837915,908018,-70103
2411,95,524278,3500,841415,909518,-68103
2412,51,524302,5000,841416,908335,-66919
2412,51,524302,1000,838915,908518,-69603
2412,51,524302,6500,845416,906518,-61102
2413,48,524837,7000,844915,908835,-63920
2414,43,525068,4500,845415,909018,-63603
2416,92,525383,4000,848416,909835,-61419
2416,92,525383,1000,841915,910018,-68103
2414,43,525068,4000,849416,909335,-59919
2416,92,525383,3500,848915,910335,-61420
2413,48,524837,500,674261,910518,-236257
2413,48,524837,1500,849916,910835,-60919
2414,43,525068,3000,850916,911018,-60102
2416,92,525383,4000,857416,911335,-53919
2414,43,525068,3000,858415,911518,-53103
2413,48,524837,1500,858416,911835,-53419
2416,92,525383,4500,856416,912018,-55602
2416,92,525383,2500,859416,912335,-52919
2416,92,525383,3000,860915,912518,-51603
2416,92,525383,3500,861915,912835,-50920
2417,82,525538,1500,862916,913335,-50419
2417,82,525538,3500,861416,913518,-52102
2415,31,525288,4000,864915,913835,-48920
2417,82,525538,3000,865415,916335,-50920
2418,92,525758,2500,871916,914018,-42102
2418,92,525758,4500,870915,913018,-42103
2419,27,525874,9500,873415,914335,-40920
2416,92,525383,7000,874915,916518,-41603
2418,92,525758,12500,880415,919518,-39103
2417,82,525538,8000,881916,919835,-37919
2415,31,525288,12500,881915,916835,-34920
2417,82,525538,7500,882916,920018,-37102
2420,65,525934,10000,886415,914518,-28103
2416,92,525383,1500,886416,914835,-28419
2418,92,525758,9000,890416,920335,-29919
2418,92,525758,1500,778675,917018,-138343
2415,31,525288,1500,889915,917335,-27420
2418,92,525758,10500,891416,917518,-26102
2416,92,525383,9000,897415,915018,-17603
2418,92,525758,6500,901915,917835,-15920
2418,92,525758,9000,902416,920518,-18102
2417,82,525538,10500,906915,918018,-11103
2418,92,525758,1500,798675,918335,-119660
2420,65,525934,9000,908415,918518,-10103
2419,27,525874,14500,909915,915335,-5420
2418,92,525758,7000,910415,915518,-5103
2421,82,526194,7500,911415,915835,-4420
2421,82,526194,12500,911916,922518,-10602
2417,82,525538,6000,912916,920835,-7919
2420,65,525934,6000,913916,918835,-4919
2420,65,525934,9500,916415,916018,397
2421,82,526194,5500,919915,919018,897
2418,92,525758,4000,923915,921018,2897
2422,17,526283,4000,924415,921335,3080
2423,55,526325,11000,920916,922835,-1919
2419,27,525874,2500,916416,921518,-5102
2420,65,525934,6000,926416,923018,3398
2421,82,526194,10500,928916,919335,9581
2421,82,526194,11000,929915,923335,6580
2419,27,525874,8500,932416,921835,10581
2423,55,526325,10000,934416,922018,12398
2420,65,525934,6000,937415,922335,15080
2423,55,526325,3500,937416,924018,13398
2421,82,526194,1500,935915,923518,12397
2423,55,526325,3500,937916,926018,11898
2421,82,526194,3000,938416,924335,14081
2423,55,526325,10000,944415,924518,19897
2423,55,526325,1000,939416,924835,14581
2421,82,526194,4000,944416,926335,18081
2423,55,526325,7500,945916,925018,20898
2421,82,526194,5000,943916,926518,17398
2422,17,526283,9000,945915,925335,20580
2423,55,526325,4500,946916,923835,23081
2422,17,526283,3000,947915,925518,22397
2424,25,526795,1500,838323,927518,-89195
2427,28,528065,3500,947416,926835,20581
2428,25,528233,4500,948415,927835,20580
2428,25,528233,8500,951915,928018,23897
2429,81,528334,4500,952915,925835,27080
2429,81,528334,4000,954915,928335,26580
2429,81,528334,5500,955415,927018,28397
2429,81,528334,7500,956916,928518,28398
2429,81,528334,1500,959416,928835,30581
2426,15,527906,10500,961416,927335,34081
2426,15,527906,12000,964415,929018,35397
2429,81,528334,8500,963916,929335,34581
2427,28,528065,5500,963915,929518,34397
2429,81,528334,3500,961916,930335,31581
2427,28,528065,5500,964915,930518,34397
2429,81,528334,2500,966915,929835,37080
2429,81,528334,10500,970915,930835,40080
2431,53,529191,12500,971916,931018,40898
2432,100,529228,4000,971416,931335,40081
2431,53,529191,2500,972916,932518,40398
2434,53,529283,5500,973915,932835,41080
2433,66,529273,11500,976916,930018,46898
2434,53,529283,7500,986916,931518,55398
2431,53,529191,6500,987415,931835,55580
2433,66,529273,15500,989415,932335,57080
2434,53,529283,15000,988915,932018,56897
2434,53,529283,4000,989416,933018,56398
2433,66,529273,2500,989916,933335,56581
2432,100,529228,8500,995415,933518,61897
2434,53,529283,9000,996915,933835,63080
2434,53,529283,13500,997916,934018,63898
2434,53,529283,4000,999415,934335,65080
2431,53,529191,3000,999916,934518,65398
2434,53,529283,6500,999416,934835,64581
2432,100,529228,1500,894675,935018,-40343
2432,100,529228,6000,897675,935335,-37660
2432,100,529228,6000,899175,935518,-36343
2433,66,529273,4500,900175,935835,-35660
2431,53,529191,4000,905323,936018,-30695
2432,100,529228,3000,905823,936335,-30512
2432,100,529228,7500,911175,938335,-27160
2433,66,529273,2000,903675,936518,-32843
2434,53,529283,5500,910175,936835,-26660
2433,66,529273,1500,907175,938835,-31660
2434,53,529283,3000,912675,939018,-26343
2434,53,529283,4500,915323,937018,-21695
2433,66,529273,4000,917175,942835,-25660
2432,100,529228,3500,918823,943018,-24195
2432,100,529228,2000,921323,939335,-18012
2434,53,529283,2000,919823,939518,-19695
2433,66,529273,5000,921823,937335,-15512
2435,88,530122,3000,922175,937518,-15343
2435,88,530122,3000,924175,939835,-15660
2435,88,530122,5000,927323,940018,-12695
2436,76,530143,2500,928323,938518,-10195
2435,88,530122,5000,928675,940335,-11660
2435,88,530122,2500,931323,944335,-13012
2435,88,530122,2500,932323,944518,-12195
2435,88,530122,5500,937175,946835,-9660
2436,76,530143,5000,937323,947018,-9695
2435,88,530122,4500,938823,940518,-1695
2436,76,530143,500,705304,944835,-239531
2435,88,530122,2500,938175,940835,-2660
2436,76,530143,2500,939323,941018,-1695
2435,88,530122,1000,939675,941335,-1660
2435,88,530122,1000,942823,937835,4988
2435,88,530122,5500,946675,945018,1657
2439,54,530517,2000,943175,938018,5157
2435,88,530122,4500,947175,947335,-160
2439,54,530517,5000,948323,947518,805
2435,88,530122,1500,945323,941518,3805
2435,88,530122,6000,959675,945335,14340
2439,54,530517,1000,959175,941835,17340
2436,76,530143,3500,961323,943335,17988
2435,88,530122,1500,958675,945518,13157
2436,76,530143,7000,963175,943518,19657
2436,76,530143,7500,956175,943835,12340
2439,54,530517,4500,963323,945835,17488
2439,54,530517,3500,964675,942018,22657
2438,36,530415,3000,966823,947835,18988
2436,76,530143,6500,970175,942335,27840
2435,88,530122,2000,969323,944018,25305
2436,76,530143,6000,971175,942518,28657
2439,54,530517,2000,972323,946018,26305
2437,29,530325,4500,978175,948018,30157
2439,54,530517,2500,978823,946335,32488
2437,29,530325,4500,981675,946518,35157
2440,27,531390,2500,980323,948335,31988
2440,27,531390,4500,981823,948518,33305
2442,39,531521,1000,976823,948835,27988
2442,39,531521,4500,982323,949018,33305
2443,86,531563,2500,985823,949335,36488
2441,50,531448,7500,989675,951335,38340
2441,50,531448,1000,984175,949518,34657
2442,39,531521,3000,991323,949835,41488
2442,39,531521,5500,993323,952335,40988
2443,86,531563,5500,994175,952518,41657
2443,86,531563,2500,995175,950018,45157
2442,39,531521,3000,997323,952835,44488
2440,27,531390,6000,999323,950335,48988
2443,86,531563,2000,999175,953018,46157
2443,86,531563,3000,999823,953335,46488
2441,50,531448,500,715761,950518,-234757
2441,50,531448,500,715804,953518,-237714
2443,86,531563,500,716261,953835,-237574
2445,46,532138,500,716304,950835,-234531
2443,86,531563,500,716761,951018,-234257
2443,86,531563,500,716804,951518,-234714
2445,46,532138,500,717261,954018,-236757
2443,86,531563,500,717304,954335,-237031
2443,86,531563,500,717761,951835,-234074
2443,86,531563,500,717804,954518,-236714
2444,19,531643,500,718261,954835,-236574
2443,86,531563,500,718304,955018,-236714
2445,46,532138,500,718761,955335,-236574
2445,46,532138,500,718804,955518,-236714
2446,54,533020,500,719261,952018,-232757
2447,61,533292,500,719304,957335,-238031
2447,61,533292,500,719761,955835,-236074
2447,61,533292,500,719804,956335,-236531
2447,61,533292,500,720261,956018,-235757
2447,61,533292,500,720304,958335,-238031
2448,63,533748,500,720761,956518,-235757
2447,61,533292,500,720804,958518,-237714
2448,63,533748,500,721261,958835,-237574
2449,58,533749,500,721304,959018,-237714
2447,61,533292,500,721761,957518,-235757
2447,61,533292,500,721804,957835,-236031
2449,58,533749,500,722261,959335,-237074
2448,63,533748,500,722304,960018,-237714
2450,47,534139,500,722761,956835,-234074
2451,100,534267,500,722804,957018,-234214
2451,100,534267,500,723261,961018,-237757
2451,100,534267,500,723304,960335,-237031
2448,63,533748,500,723761,958018,-234257
2450,47,534139,500,723804,961335,-237531
2452,59,534350,500,724261,960518,-236257
2452,59,534350,500,724304,961518,-237214
2449,58,533749,500,724761,961835,-237074
2450,47,534139,500,724804,959518,-234714
2449,58,533749,500,725261,960835,-235574
2452,59,534350,500,725304,962018,-236714
2451,100,534267,500,725761,962835,-237074
2448,63,533748,500,725804,959835,-234031
2452,59,534350,500,726261,962335,-236074
2453,88,534574,500,726304,966335,-240031
2451,100,534267,500,726761,964518,-237757
2450,47,534139,500,726804,963518,-236714
2453,88,534574,500,727261,963835,-236574
2451,100,534267,500,727304,964835,-237531
2451,100,534267,500,727761,962518,-234757
2451,100,534267,500,727804,966518,-238714
2451,100,534267,500,728261,966835,-238574
2451,100,534267,500,728304,964018,-235714
2450,47,534139,500,728761,965018,-236257
2454,84,534814,500,728804,967018,-238214
2451,100,534267,500,729261,967335,-238074
2453,88,534574,500,729304,964335,-235031
2452,59,534350,500,729761,967518,-237757
2450,47,534139,500,729804,967835,-238031
2453,88,534574,500,730261,968018,-237757
2454,84,534814,500,730304,968835,-238531
2453,88,534574,500,730761,963018,-232257
2454,84,534814,500,730804,969018,-238214
2451,100,534267,500,731261,968335,-237074
2451,100,534267,500,731304,965335,-234031
2454,84,534814,500,731761,963335,-231574
2454,84,534814,500,731804,965518,-233714
2452,59,534350,1000,732761,965835,-233074
2454,84,534814,4000,735804,966018,-230214
2454,84,534814,2500,737261,969335,-232074
2456,26,535305,2000,737304,968518,-231214
2456,26,535305,1500,737804,969518,-231714
2457,50,535389,500,736804,969835,-233031
2458,39,535794,2500,741304,970018,-228714
2459,82,535940,5000,742304,970335,-228031
2460,24,536019,1500,745261,970518,-225257
2462,19,536233,2000,744304,970835,-226531
2463,69,536457,500,741804,971018,-229214
2463,69,536457,3500,749261,971335,-222074
2464,81,536682,5500,750304,972335,-222031
2465,60,536742,6000,752804,971518,-218714
2466,20,536994,1000,751761,972518,-220757
2467,37,537377,3500,756261,976518,-220257
2468,92,537383,5500,756761,974335,-217574
2469,20,537450,1500,757761,972835,-215074
2470,13,537979,1000,759761,973018,-213257
2471,79,538133,4500,761304,974518,-213214
2473,31,538359,4000,762304,977835,-215531
2473,31,538359,1000,761804,976018,-214214
2474,37,538858,2500,763804,976835,-213031
2476,15,539043,1000,763761,974835,-211074
2477,21,539176,2500,764804,978518,-213714
2477,21,539176,500,765261,979518,-214257
2479,75,539801,4500,769261,979835,-210574
2479,75,539801,4500,769761,977018,-207257
2481,47,540642,1000,771261,971835,-200574
2481,47,540642,4000,774304,980018,-205714
2482,17,540676,2500,772804,975018,-202214
2483,86,541244,4000,778304,981518,-203214
2484,79,541298,4500,778761,975335,-196574
2487,40,541894,1000,777761,977335,-199574
2489,50,542085,1000,780304,975518,-195214
2488,69,541903,2500,781761,973335,-191574
2488,69,541903,2500,782761,978018,-195257
2489,50,542085,3500,782804,980335,-197531
2490,94,542919,3500,790304,972018,-181714
2491,79,542975,4500,791804,973518,-181714
2492,50,543045,2000,787804,978835,-191031
2493,63,543059,3500,791304,981835,-190531
2495,62,543440,2500,796804,973835,-177031
2495,62,543440,6000,797761,977518,-179757
2496,64,543466,4000,797804,978335,-180531
2498,65,543941,1500,794804,979018,-184214
2498,65,543941,5000,799304,980518,-181214
2499,43,544467,1000,799804,974018,-174214
2500,45,544758,2000,801261,980835,-179574
2502,23,545223,1500,801804,975835,-174031
2503,93,545500,1500,807261,979335,-172074
2504,92,545534,3000,810761,985835,-175074
2504,92,545534,7000,811304,976335,-165031
2506,87,545699,2500,805261,984018,-178757
2506,87,545699,5000,811804,984335,-172531
2507,81,546261,6000,817804,986018,-168214
2508,70,546394,5000,819761,982018,-162257
2510,60,546439,1500,814304,981018,-166714
2510,60,546439,2000,818804,984518,-165714
2512,83,546913,1000,816261,982335,-166074
2512,83,546913,5000,825761,986335,-160574
2513,60,547202,3500,826761,981335,-154574
2514,93,547272,5500,827261,982518,-155257
2515,79,547594,5500,828304,982835,-154531
2516,28,548744,2000,830804,984835,-154031
2518,41,549221,7500,834261,983018,-148757
2518,41,549221,1500,833804,985018,-151214
2519,13,549398,1000,834304,985335,-151031
2520,85,549995,3500,836261,986835,-150574
2521,50,550671,3500,839761,983335,-143574
2522,67,550775,3500,839804,983518,-143714
2523,83,551138,2500,841304,983835,-142531
2524,52,551581,3000,842304,986518,-144214
2525,12,553072,1500,844304,985518,-141214
2526,74,553347,4000,845304,987018,-141714
2527,78,553818,3500,849761,989593,-139832
2529,88,554129,4500,852304,991160,-138856
2529,88,554129,4500,852261,994160,-141899
2530,23,554138,1500,851304,995093,-143789
2531,17,554629,1000,852761,995160,-142399
2532,77,554998,2500,856261,998160,-141899
2533,49,555111,2500,855304,999160,-143856
2534,79,555564,3500,857761,999660,-141899
2535,87,556024,3000,860761,988018,-127257
2537,83,556259,1500,860261,989335,-129074
2537,83,556259,3500,860804,993335,-132531
2538,67,557009,3500,863761,989518,-125757
2540,33,557486,1500,869761,993518,-123757
2540,33,557486,3500,872304,993835,-121531
2542,48,557813,7500,874761,991018,-116257
2542,48,557813,3500,874304,991335,-117031
2544,71,557915,5500,875804,989835,-114031
2544,71,557915,3500,875304,991518,-116214
2545,15,557919,1500,871261,991835,-120574
2546,73,558995,2000,877304,990018,-112714
2549,87,559457,500,876761,990335,-113574
2549,87,559457,1500,879804,994018,-114214
2549,87,559457,5000,882261,994335,-112074
2550,25,559802,2000,883804,996518,-112714
2551,79,559899,2500,883761,994518,-110757
2552,32,560222,2000,886304,994835,-108531
2553,91,560299,6000,889304,990518,-101214
2554,44,560360,2500,890804,995018,-104214
2555,86,560600,5000,889804,995335,-105531
2557,57,561133,1000,896804,995518,-98714
2558,41,561157,4500,896761,998518,-101757
2558,41,561157,2500,897261,992018,-94757
2559,40,561210,4500,897804,998835,-101031
2561,23,561768,2000,898761,999018,-100257
2561,23,561768,2000,898304,999335,-101031
2563,74,562946,500,898804,999518,-100714
2563,74,562946,2500,900761,995835,-95074
2564,23,563471,1000,900261,992335,-92074
2565,81,563627,5000,908304,992518,-84214
2566,77,563764,5500,911304,992835,-81531
2568,57,563821,2000,912304,996835,-84531
2569,45,563822,3000,914261,999835,-85574
2572,31,564117,3500,913761,996018,-82257
2571,72,564004,1000,911804,993018,-81214
2571,72,564004,3500,914761,997018,-82257
2572,31,564117,1000,914804,997335,-82531
2573,75,564416,3000,916804,996335,-79531
2574,62,564568,3500,917304,997518,-80214
2575,20,564575,1500,916261,997835,-81574
2576,19,564881,1000,916304,998018,-81714
2577,53,564930,1500,918304,998335,-80031
